x,y,ACCOMMODATION UNITS (ROOMS APARTMENTS CAMPING SITES) - TOTAL,A_AUSTRIAN TOURISTS,A_DOMESTIC TOURISTS - TOTAL,A_FOREIGN TOURISTS - TOTAL,A_GERMAN TOURISTS,A_ITALIAN TOURISTS,A_SLOVENIAN TOURISTS,ESTABLISHMENTS - TOTAL,NUMBER OF PERMANENT BEDS,N_AUSTRIAN TOURISTS,N_DOMESTIC TOURISTS - TOTAL,N_FOREIGN TOURISTS - TOTAL,N_GERMAN TOURISTS,N_ITALIAN TOURISTS,N_SLOVENIAN TOURISTS,TOTAL ARRIVALS,TOTAL NIGHTS
75,119,2129,950,143,10056,1325,669,5238,171,7091,5073,557,64143,11760,3709,32398,10199,64700
75,120,6645,67181,24262,310766,52591,41625,65328,798,17204,308711,72174,1648422,402881,162922,258628,335028,1720596
75,121,2288,15036,5186,106624,16874,11035,37691,300,6656,65718,16732,551354,112968,41219,190190,111810,568086
76,116,11969,94472,43458,531134,123590,70756,43499,2055,31516,508894,124996,3212598,1067473,340072,160726,574592,3337594
76,117,12937,54988,11443,419502,118956,45561,66027,551,36454,364334,46185,3203797,1157488,246789,355980,430945,3249982
76,118,10700,102073,33151,459198,107326,58260,40342,1902,26552,470928,87061,2533998,775224,227505,154709,492349,2621059
76,119,10918,74897,10587,312567,74926,28452,67679,886,30912,398761,32751,1854864,581294,132810,321264,323154,1887615
76,120,684,2118,1458,17279,3898,5950,969,251,1623,9823,3369,83894,33696,16510,2410,18737,87263
76,121,472,192,88,1626,333,397,182,21,1380,810,234,7824,2774,1315,531,1714,8058
77,115,150,338,99,3286,1433,295,269,70,435,2380,540,26556,14412,1834,1466,3385,27096
77,116,1757,5796,1929,46276,12767,7798,11587,134,5045,34745,6002,292592,109256,38624,69208,48205,298594
77,117,831,1251,655,11503,4197,1540,248,341,2021,7805,2327,79678,37783,7513,797,12158,82005
77,118,916,1388,462,11048,5034,652,299,355,2227,9197,1435,88822,48416,2952,1009,11510,90257
77,119,672,305,242,3112,1252,181,115,285,1646,2011,596,22250,10944,505,233,3354,22846
77,120,267,789,437,4447,1154,509,313,94,662,3134,1743,22659,9305,1209,818,4884,24402
78,113,124,361,21,2926,1248,333,178,49,349,2380,55,23871,12663,2106,1243,2947,23926
78,114,11701,34430,41203,427384,91082,48024,31250,3167,32037,177163,111020,2357836,666670,232332,157947,468587,2468856
78,115,5049,9937,9523,159298,47772,16494,26525,1268,14749,65947,52422,1187398,430068,104801,154908,168821,1239820
78,116,838,1392,284,11702,7118,221,160,289,1835,10355,1069,109026,73049,1498,670,11986,110095
78,117,555,559,241,6905,3676,205,105,213,1280,4588,1045,61961,37332,1003,644,7146,63006
78,118,421,728,622,7521,3889,287,84,170,1109,5351,1678,64365,38697,1038,259,8143,66043
78,119,899,469,314,5053,1650,342,213,109,2073,1503,711,18711,8239,517,408,5367,19422
78,120,110,108,71,626,189,14,58,40,236,345,119,3529,1672,18,87,697,3648
78,121,1,0,0,0,0,0,0,1,4,0,0,0,0,0,0,0,0
79,113,5272,33221,5051,181571,36335,28303,33032,691,14445,184043,20209,1101537,276297,147272,177194,186622,1121746
79,114,4623,16111,3011,113171,44279,13944,6251,1284,12905,110554,14203,875538,416760,90021,33046,116182,889741
79,115,1183,1598,3645,21722,8324,1637,2656,385,3114,10093,20729,169746,83569,9854,15899,25367,190475
79,116,600,1295,504,11050,6536,351,171,253,1383,8783,1227,98634,66686,1911,613,11554,99861
79,117,272,271,74,2642,1373,127,79,110,680,1935,346,22717,13397,607,201,2716,23063
79,118,194,284,2523,3647,1222,521,145,83,463,1262,5424,21042,10573,1371,245,6170,26466
79,119,59,73,104,812,160,84,22,32,149,193,178,1969,620,130,46,916,2147
79,120,247,705,1763,6269,876,589,338,91,519,2018,3542,19799,4355,1067,451,8032,23341
79,121,1,0,0,0,0,0,0,1,2,0,0,0,0,0,0,0,0
80,115,483,578,54,5303,2989,443,55,140,1252,4104,302,47526,30323,2948,366,5357,47828
80,116,3897,29381,7269,156049,43546,13089,13678,514,9539,152037,21285,990613,349491,60129,50976,163318,1011898
80,117,1942,9139,2442,60938,22615,5472,2254,843,5061,48791,8712,426198,207793,26618,9438,63380,434910
80,118,220,301,93,2560,1179,125,63,99,543,1928,571,21804,12324,600,201,2653,22375
80,119,57,0,0,0,0,0,0,22,132,0,0,0,0,0,0,0,0
80,120,26,49,56,506,27,187,41,14,63,217,153,1574,137,361,86,562,1727
80,121,3,0,0,0,0,0,0,1,6,0,0,0,0,0,0,0,0
81,112,70,0,0,0,0,0,0,34,190,0,0,0,0,0,0,0,0
81,117,132,372,187,3115,1423,339,75,65,341,1939,555,20361,11828,935,386,3302,20916
81,118,1167,10178,1781,49266,10551,6586,4408,336,2857,45661,5902,236813,68019,27551,18264,51047,242715
81,119,4511,42489,28884,235396,41091,23076,16518,958,10584,167462,75749,893174,218890,72426,46428,264280,968923
81,120,2128,28497,38933,179291,19072,20451,12091,508,4594,96364,84744,552606,95566,50145,25767,218224,637350
81,121,33,0,0,0,0,0,0,15,81,0,0,0,0,0,0,0,0
82,110,58,493,225,1196,127,114,220,36,177,4445,1290,9835,1204,867,1528,1421,11125
82,111,4,44,0,169,41,9,27,3,15,314,0,1582,516,56,265,169,1582
82,112,530,1308,392,14642,5470,1511,2975,36,1588,9075,2404,101991,40919,10651,24425,15034,104395
82,113,45,169,25,834,174,226,47,28,137,1393,142,6417,1624,1761,313,859,6559
82,114,870,493,213,4447,496,1072,1841,163,2522,4089,1537,35518,4591,8017,14659,4660,37055
82,115,2590,9380,4327,84315,23568,17244,17460,391,7153,65185,23977,616147,219806,105340,130852,88642,640124
82,117,83,0,0,0,0,0,0,13,235,0,0,0,0,0,0,0,0
82,119,1100,4144,18811,87801,9587,14908,2026,388,2711,8285,34809,189727,23110,29126,5203,106612,224536
82,120,570,1118,3555,21443,4100,4962,488,370,1568,4509,11159,94869,30794,13937,1422,24998,106028
82,121,3,0,0,0,0,0,0,2,6,0,0,0,0,0,0,0,0
83,110,970,6654,11271,28780,5823,5622,3617,159,2463,36329,62064,171766,44455,29838,18553,40051,233830
83,111,4613,23282,26846,143932,35407,21929,28422,778,12022,145747,114855,1026607,302149,141143,199375,170778,1141462
83,112,1721,1977,1334,40447,6858,3657,22872,153,5307,13855,7178,311920,58818,26403,181806,41781,319098
83,113,35,89,12,698,92,252,33,22,98,538,74,4831,747,1738,352,710,4905
83,114,27,58,81,689,52,297,66,17,63,330,362,3285,289,1531,346,770,3647
83,115,25,74,46,687,153,210,33,18,64,542,247,4557,1408,1111,192,733,4804
83,116,475,1080,580,13445,3539,2229,1818,209,1402,6773,2868,86608,31719,12549,9090,14025,89476
83,117,3785,14951,12088,102410,27762,12013,11703,1378,10140,78186,50257,631355,216261,71568,59102,114498,681612
83,118,2604,11074,10079,113698,34053,6849,23069,466,6627,57045,44771,633010,232647,32977,113711,123777,677781
83,119,1390,1850,11115,50602,5615,3898,11820,281,3475,7148,33881,188554,28785,9614,48635,61717,222435
83,120,154,220,1942,2440,547,665,100,58,421,596,4405,8396,3039,1511,439,4382,12801
83,121,10,0,0,0,0,0,0,1,35,0,0,0,0,0,0,0,0
83,123,7,0,0,0,0,0,0,3,20,0,0,0,0,0,0,0,0
84,108,9,17,31,85,6,17,31,5,26,171,242,831,31,160,401,116,1073
84,109,13,19,34,152,17,44,44,9,44,152,211,1031,96,283,309,186,1242
84,110,28,0,0,0,0,0,0,15,88,0,0,0,0,0,0,0,0
84,116,6417,29280,9900,213563,57284,26938,34110,1323,17815,152506,44714,1223167,399214,137267,188181,223463,1267881
84,117,1901,5202,1858,51639,16156,5036,7093,735,5420,30505,7830,345266,144910,28425,35913,53497,353096
84,118,5327,24011,26143,162799,40729,6491,15462,1545,13441,113569,124461,958624,319103,29643,71671,188942,1083085
84,119,276,264,1291,4024,1081,447,185,130,684,1372,3601,20250,9041,1469,538,5315,23851
84,120,26,10,756,662,117,85,13,12,62,14,1698,1531,361,135,29,1418,3229
84,121,17,0,0,0,0,0,0,13,45,0,0,0,0,0,0,0,0
84,122,46,0,251,45,2,6,9,17,157,0,605,97,3,14,20,296,702
84,123,4,0,0,0,0,0,0,3,12,0,0,0,0,0,0,0,0
85,109,168,387,1003,2008,217,291,651,106,496,4174,7823,18480,2158,2375,6470,3011,26303
85,112,376,1312,2337,10048,1380,1399,1731,91,958,7394,8136,62427,11324,9253,10625,12385,70563
85,113,3895,14597,9817,96834,32206,11668,8211,901,10336,84261,42848,653334,263312,75747,53063,106651,696182
85,114,4755,17659,5052,124012,45895,6902,8672,923,13874,121281,30633,974810,434622,50026,63333,129064,1005443
85,115,917,2995,442,16512,3042,1482,933,220,2487,17378,2267,106783,23998,8152,5241,16954,109050
85,116,3401,26191,8241,148899,31590,16416,18425,769,9272,137173,31125,870152,228433,89486,86733,157140,901277
85,117,2127,3710,12609,45688,9953,2283,3003,679,6424,17147,56577,300120,86849,12951,13133,58297,356697
85,118,4490,15555,30175,151525,37378,6648,21690,1310,12677,66695,139669,816596,255621,25334,98928,181700,956265
85,119,164,126,5062,4793,405,316,130,58,401,327,12605,12314,2651,663,289,9855,24919
85,120,131,131,3672,4858,327,459,148,49,362,271,7826,7684,693,635,288,8530,15510
85,121,13,0,0,0,0,0,0,7,34,0,0,0,0,0,0,0,0
85,122,1,0,0,0,0,0,0,1,6,0,0,0,0,0,0,0,0
86,106,84,426,548,4296,1461,583,677,27,258,2338,3416,27537,9128,3770,5833,4844,30953
86,107,23,37,44,304,29,25,131,16,73,358,348,2863,260,348,1378,348,3211
86,108,41,27,64,415,46,60,168,23,130,210,531,3620,463,508,1674,479,4151
86,109,25,13,42,151,8,26,69,16,71,175,474,1584,36,319,656,193,2058
86,111,5505,9415,4038,108527,24483,24641,5724,1389,15603,42958,18913,616288,145105,153152,36245,112565,635201
86,112,248,20,21,680,30,13,82,66,668,146,227,5331,327,112,768,701,5558
86,113,1604,4219,1711,30321,12509,2825,2802,642,4707,29976,11237,257656,130737,22041,20855,32032,268893
86,114,150,419,79,2409,430,219,110,81,480,2823,330,16649,3427,1565,694,2488,16979
86,115,454,973,654,17421,5149,1144,647,141,1345,4094,1557,77684,27829,4390,3006,18075,79241
86,116,1287,2948,1212,49876,12031,5125,1129,579,3740,10581,3905,220409,73424,17885,4556,51088,224314
86,117,1419,2422,1447,37602,11531,3352,2712,274,4089,12268,5867,196997,69938,13473,12249,39049,202864
86,118,16,0,0,0,0,0,0,7,33,0,0,0,0,0,0,0,0
86,119,62,9,802,236,22,24,46,22,159,20,1860,877,188,47,86,1038,2737
86,120,94,85,1974,3139,223,576,44,30,224,140,4461,3864,348,694,100,5113,8325
86,121,60,0,100,60,11,4,0,29,166,0,328,437,75,19,0,160,765
86,122,5,0,0,0,0,0,0,2,10,0,0,0,0,0,0,0,0
87,106,351,1153,2509,7126,1421,735,1816,73,887,7803,16363,48784,11461,4919,12268,9635,65147
87,107,47,50,69,461,42,32,189,26,142,580,606,4614,655,242,1902,530,5220
87,110,2281,823,1280,19575,1932,2172,3878,351,6669,5993,9380,160052,19116,17437,32576,20855,169432
87,111,1361,1691,1654,26859,2850,3938,7392,500,3765,8023,10538,164632,19690,22936,55616,28513,175170
87,112,38,76,10,916,273,52,35,14,116,472,61,7400,2908,383,420,926,7461
87,113,2,0,0,0,0,0,0,2,4,0,0,0,0,0,0,0,0
87,115,34,30,10,998,286,65,23,15,109,176,18,6313,2694,399,103,1008,6331
87,116,23,3,4,129,83,7,6,12,59,21,8,1011,697,32,36,133,1019
87,117,1,0,0,0,0,0,0,1,6,0,0,0,0,0,0,0,0
87,118,2,0,0,0,0,0,0,1,6,0,0,0,0,0,0,0,0
87,119,28,3,145,85,29,34,4,12,62,8,531,472,304,67,21,230,1003
87,120,39,0,0,0,0,0,0,11,173,0,0,0,0,0,0,0,0
87,121,22,0,0,0,0,0,0,11,53,0,0,0,0,0,0,0,0
88,105,16,4,13,107,9,16,45,9,46,36,130,1116,109,206,506,120,1246
88,106,75,50,119,743,74,102,175,44,242,425,761,6018,717,677,1529,862,6779
88,107,582,412,1582,8869,793,485,3933,174,1801,3235,13108,77601,7316,5159,36209,10451,90709
88,108,3381,2978,10012,66403,11431,832,9907,1540,10149,22675,67063,524093,116273,6623,76628,76415,591156
88,109,976,1024,2205,19808,2122,1090,3984,294,2816,7557,15815,149136,19266,6462,31209,22013,164951
88,110,2077,3918,4988,51265,4886,8342,5080,663,5695,22734,27982,338985,39215,52703,30505,56253,366967
88,111,1203,1277,370,14013,4211,807,2103,351,3252,9711,2411,112921,40913,5398,15882,14383,115332
88,114,101,46,1589,1956,211,194,133,18,244,87,2924,3067,396,272,213,3545,5991
88,115,14,0,0,0,0,0,0,3,32,0,0,0,0,0,0,0,0
88,116,25,0,0,0,0,0,0,4,32,0,0,0,0,0,0,0,0
88,119,16,0,0,0,0,0,0,8,53,0,0,0,0,0,0,0,0
88,120,6,0,0,0,0,0,0,4,18,0,0,0,0,0,0,0,0
88,121,17,0,0,0,0,0,0,6,39,0,0,0,0,0,0,0,0
89,104,295,367,1075,5113,826,1003,742,150,883,3097,6393,36304,7629,6969,5803,6188,42697
89,105,265,427,575,4997,671,350,1948,97,717,3287,3445,42421,6349,2342,16156,5572,45866
89,106,5542,17569,49133,324464,33809,19620,14281,2421,14966,82567,134788,1027075,174464,56482,78650,373597,1161863
89,107,2508,19084,15055,117595,22300,4204,6939,596,6572,103204,52242,582808,151042,19730,35030,132650,635050
89,108,6899,14841,18439,171708,48844,4697,10678,1361,20530,111119,114329,1402907,486411,33877,77106,190147,1517236
89,109,277,259,575,6007,565,227,1045,82,777,2001,4161,43432,5708,1647,8301,6582,47593
89,110,106,138,34,1353,456,59,93,41,290,983,202,9896,4168,366,632,1387,10098
89,111,14,22,942,656,154,50,36,4,75,40,1773,1397,299,90,72,1598,3170
89,112,15,0,0,0,0,0,0,5,30,0,0,0,0,0,0,0,0
89,113,1,0,0,0,0,0,0,1,3,0,0,0,0,0,0,0,0
89,114,9,0,0,0,0,0,0,5,30,0,0,0,0,0,0,0,0
89,115,222,290,1426,35525,1021,1251,154,42,501,367,1970,38358,1468,1783,174,36951,40328
89,116,3,0,0,0,0,0,0,1,5,0,0,0,0,0,0,0,0
89,118,51,0,0,0,0,0,0,12,124,0,0,0,0,0,0,0,0
89,119,130,160,1598,6160,359,509,33,37,361,295,2519,7407,540,703,38,7758,9926
89,120,1,0,0,0,0,0,0,1,4,0,0,0,0,0,0,0,0
89,121,18,0,0,0,0,0,0,9,51,0,0,0,0,0,0,0,0
89,122,2,0,0,0,0,0,0,1,6,0,0,0,0,0,0,0,0
89,123,5,0,0,0,0,0,0,2,10,0,0,0,0,0,0,0,0
89,124,2,0,0,0,0,0,0,1,4,0,0,0,0,0,0,0,0
90,103,78,57,83,801,104,167,291,38,199,517,930,7310,834,1408,3165,884,8240
90,105,824,822,1929,12828,1658,389,5892,298,2314,7560,15384,111872,17975,3557,49512,14757,127256
90,106,3110,3886,9429,71266,10959,2628,8264,1253,8708,23186,52132,451528,94103,12385,62168,80695,503660
90,107,187,178,436,6211,948,522,79,113,565,917,1445,24471,5941,1644,272,6647,25916
90,108,842,1264,1685,15862,4939,469,2516,348,2419,9259,11535,128793,47365,3486,19728,17547,140328
90,109,520,511,464,11326,2762,588,2733,94,1463,2949,3261,71071,16694,2719,22152,11790,74332
90,111,214,43,1658,3103,225,1493,125,26,442,104,4282,4695,338,1758,433,4761,8977
90,112,40,39,425,737,92,147,24,13,91,57,1171,1624,139,331,31,1162,2795
90,113,5,0,0,0,0,0,0,2,10,0,0,0,0,0,0,0,0
90,114,66,126,160,1941,359,255,12,21,149,686,316,4913,811,693,48,2101,5229
90,115,17,2,2,395,28,44,3,6,43,4,2,650,44,59,30,397,652
90,117,21,3,25,256,50,36,0,11,57,11,65,832,296,67,0,281,897
90,119,7,0,0,0,0,0,0,3,26,0,0,0,0,0,0,0,0
90,120,55,0,0,0,0,0,0,12,123,0,0,0,0,0,0,0,0
90,121,85,0,0,0,0,0,0,20,205,0,0,0,0,0,0,0,0
90,122,77,0,0,0,0,0,0,6,204,0,0,0,0,0,0,0,0
90,123,34,0,0,0,0,0,0,11,75,0,0,0,0,0,0,0,0
90,124,6,0,0,0,0,0,0,2,28,0,0,0,0,0,0,0,0
90,125,5,0,0,0,0,0,0,2,16,0,0,0,0,0,0,0,0
91,102,3,0,0,0,0,0,0,1,6,0,0,0,0,0,0,0,0
91,104,1723,4729,10434,54699,6014,2462,9570,374,4438,22051,44506,265883,34654,8428,70936,65133,310389
91,105,5931,6242,30457,134110,14285,2576,33103,1318,16317,42754,176855,960954,126391,17024,253391,164567,1137809
91,106,186,172,65,1748,699,48,31,59,450,1102,415,14140,6967,337,220,1813,14555
91,107,55,61,15,612,198,27,5,30,180,426,43,4738,2046,151,21,627,4781
91,108,2551,4971,5528,74022,17114,2276,5835,620,6743,26028,25849,419222,107374,8677,31384,79550,445071
91,109,129,142,111,2454,811,66,170,15,387,688,491,11389,3972,173,1016,2565,11880
91,112,8,0,0,0,0,0,0,2,17,0,0,0,0,0,0,0,0
91,115,34,0,0,0,0,0,0,10,68,0,0,0,0,0,0,0,0
91,116,27,15,73,1967,171,203,19,16,84,27,162,3446,343,344,21,2040,3608
91,118,91,32,132,1975,91,85,5,15,194,50,217,3163,149,270,5,2107,3380
91,119,2506,0,0,0,0,0,0,4,5015,0,0,0,0,0,0,0,0
91,121,179,0,0,0,0,0,0,23,469,0,0,0,0,0,0,0,0
91,122,350,468,2120,10968,1206,356,201,44,867,567,4211,14553,1831,498,356,13088,18764
91,123,9,0,0,0,0,0,0,3,20,0,0,0,0,0,0,0,0
91,124,17,0,0,0,0,0,0,2,38,0,0,0,0,0,0,0,0
91,125,10,0,0,0,0,0,0,3,42,0,0,0,0,0,0,0,0
91,126,17,0,0,0,0,0,0,1,34,0,0,0,0,0,0,0,0
92,104,3725,5548,7950,69995,13899,2599,15203,637,10454,42189,58442,537922,122946,18903,113139,77945,596364
92,105,128,92,440,1380,401,82,59,41,313,535,2635,10679,4245,410,414,1820,13314
92,106,39,0,0,0,0,0,0,10,83,0,0,0,0,0,0,0,0
92,107,350,488,793,7088,2280,190,649,142,1014,2582,4432,42363,17714,713,3591,7881,46795
92,108,574,432,574,7819,2822,110,683,249,1679,3213,3644,64972,29738,684,5092,8393,68616
92,109,1,0,0,0,0,0,0,1,6,0,0,0,0,0,0,0,0
92,110,4,0,0,0,0,0,0,2,8,0,0,0,0,0,0,0,0
92,111,32,0,0,0,0,0,0,1,64,0,0,0,0,0,0,0,0
92,112,2,0,0,0,0,0,0,1,4,0,0,0,0,0,0,0,0
92,113,3,0,0,0,0,0,0,1,6,0,0,0,0,0,0,0,0
92,114,12,0,0,0,0,0,0,4,29,0,0,0,0,0,0,0,0
92,115,1030,5001,6094,173208,11082,10217,1204,193,2306,8258,8869,232210,19477,15025,1405,179302,241079
92,116,1611,3409,2933,101865,14350,8836,560,262,4305,6045,4647,172290,28273,15406,824,104798,176937
92,117,80,209,350,8468,707,766,58,28,201,347,644,13235,1366,1257,91,8818,13879
92,118,179,273,1409,15699,664,786,96,86,488,471,2134,22665,1174,1218,128,17108,24799
92,120,16,0,0,0,0,0,0,2,40,0,0,0,0,0,0,0,0
92,121,27,0,95,248,8,41,0,7,75,0,171,295,8,52,0,343,466
92,124,128,0,0,0,0,0,0,8,258,0,0,0,0,0,0,0,0
92,125,126,0,0,0,0,0,0,31,303,0,0,0,0,0,0,0,0
92,126,71,0,0,0,0,0,0,6,132,0,0,0,0,0,0,0,0
93,102,47,53,191,563,63,32,273,27,125,477,1474,5151,799,191,2578,754,6625
93,103,6936,10326,20911,118042,22787,6846,23191,1720,19530,83141,142758,910141,231727,49060,179897,138953,1052899
93,104,72,42,20,762,248,44,45,16,209,260,148,4745,1888,218,190,782,4893
93,105,29,0,0,0,0,0,0,10,60,0,0,0,0,0,0,0,0
93,106,20,0,0,0,0,0,0,7,42,0,0,0,0,0,0,0,0
93,107,540,512,1607,9533,2312,122,1850,290,1771,3510,10294,74003,22243,824,14388,11140,84297
93,108,6,0,0,0,0,0,0,3,13,0,0,0,0,0,0,0,0
93,109,20,0,0,0,0,0,0,4,77,0,0,0,0,0,0,0,0
93,110,12,0,0,0,0,0,0,6,32,0,0,0,0,0,0,0,0
93,111,5,0,0,0,0,0,0,2,10,0,0,0,0,0,0,0,0
93,113,13,0,0,0,0,0,0,4,31,0,0,0,0,0,0,0,0
93,114,694,465,562,20451,1532,2299,194,143,1728,813,902,32105,2833,3800,231,21013,33007
93,115,70,0,0,0,0,0,0,14,234,0,0,0,0,0,0,0,0
93,116,13,0,0,0,0,0,0,7,32,0,0,0,0,0,0,0,0
93,117,3,0,0,0,0,0,0,2,13,0,0,0,0,0,0,0,0
93,123,41,0,0,0,0,0,0,18,112,0,0,0,0,0,0,0,0
93,124,5,0,0,0,0,0,0,3,16,0,0,0,0,0,0,0,0
93,125,516,0,0,0,0,0,0,29,1130,0,0,0,0,0,0,0,0
93,126,90,90,632,2020,112,556,61,19,194,195,898,2927,233,651,76,2652,3825
93,127,6,0,0,0,0,0,0,3,14,0,0,0,0,0,0,0,0
94,102,272,269,953,2256,331,189,410,113,772,2170,8110,18768,2986,1755,3188,3209,26878
94,103,7630,14039,41762,199529,23527,4443,18774,2255,19725,78095,177250,1206592,184654,22157,113877,241291,1383842
94,104,26,0,0,0,0,0,0,13,73,0,0,0,0,0,0,0,0
94,105,3,0,0,0,0,0,0,1,7,0,0,0,0,0,0,0,0
94,108,22,0,0,0,0,0,0,4,68,0,0,0,0,0,0,0,0
94,109,30,7,119,373,41,76,16,14,73,13,484,748,80,266,20,492,1232
94,110,4,0,0,0,0,0,0,1,13,0,0,0,0,0,0,0,0
94,111,3,0,0,0,0,0,0,1,6,0,0,0,0,0,0,0,0
94,113,2,0,0,0,0,0,0,1,4,0,0,0,0,0,0,0,0
94,120,179,98,9627,7729,115,141,928,24,300,249,36577,13121,448,399,2473,17356,49698
94,121,2,0,0,0,0,0,0,1,4,0,0,0,0,0,0,0,0
94,122,2,0,0,0,0,0,0,2,3,0,0,0,0,0,0,0,0
94,124,2,0,0,0,0,0,0,1,3,0,0,0,0,0,0,0,0
94,125,986,854,7747,18316,1228,784,1072,135,2070,1506,14172,36913,2396,1528,1791,26063,51085
94,126,9536,26656,143622,841838,49516,48760,20250,1761,19824,44056,258122,1519858,94824,95774,32664,985460,1777980
94,127,379,0,0,0,0,0,0,15,672,0,0,0,0,0,0,0,0
95,101,966,693,551,12971,1689,399,484,229,2537,5108,3218,100010,15603,3024,3390,13522,103228
95,102,1402,1205,3982,31898,4235,1099,1843,549,3841,8394,21410,204478,35942,6444,12648,35880,225888
95,103,4418,14466,37210,204644,32520,8659,7333,925,10964,74820,111329,963232,208131,31360,35384,241854,1074561
95,104,82,149,142,4087,658,378,88,29,221,241,235,6748,1164,574,144,4229,6983
95,105,6,0,0,0,0,0,0,2,16,0,0,0,0,0,0,0,0
95,110,2,0,0,0,0,0,0,1,6,0,0,0,0,0,0,0,0
95,112,14,0,0,0,0,0,0,5,36,0,0,0,0,0,0,0,0
95,120,11,0,0,0,0,0,0,2,23,0,0,0,0,0,0,0,0
95,122,4,0,0,0,0,0,0,2,10,0,0,0,0,0,0,0,0
95,123,10,0,0,0,0,0,0,3,19,0,0,0,0,0,0,0,0
95,124,18,0,0,0,0,0,0,3,36,0,0,0,0,0,0,0,0
95,125,220,122,2149,9710,421,230,287,40,421,143,2845,13279,576,299,486,11859,16124
95,126,336,947,4857,7203,674,680,228,34,826,1717,7807,11757,1423,1298,342,12060,19564
96,100,2980,3416,4421,69147,8146,1087,3654,1199,9032,24490,30703,558431,78492,7461,29886,73568,589134
96,101,2799,5424,4608,73149,11882,2224,6272,916,8339,38550,32184,533860,93189,12652,54097,77757,566044
96,102,680,440,1163,13606,1937,402,1043,285,1964,3380,8492,108430,19034,2894,8526,14769,116922
96,103,170,500,1091,18957,2523,632,120,58,443,1165,1929,32773,7332,1044,265,20048,34702
96,104,54,14,55,312,75,28,0,19,137,36,69,942,319,85,0,367,1011
96,105,12,7,0,114,16,4,9,9,47,20,0,654,78,18,46,114,654
96,111,2,0,0,0,0,0,0,1,4,0,0,0,0,0,0,0,0
96,122,3,0,0,0,0,0,0,2,6,0,0,0,0,0,0,0,0
96,123,1,0,0,0,0,0,0,1,5,0,0,0,0,0,0,0,0
96,125,9,1,12,48,1,5,4,4,21,1,22,71,4,5,5,60,93
96,126,45,0,0,0,0,0,0,4,101,0,0,0,0,0,0,0,0
96,127,3,0,0,0,0,0,0,2,5,0,0,0,0,0,0,0,0
97,94,7,2,11,71,6,8,24,6,24,18,55,722,52,33,437,82,777
97,95,642,404,5577,11630,756,445,1764,189,1790,3195,30950,75363,5323,2895,12855,17207,106313
97,99,76,130,117,1043,147,27,130,36,195,1200,1003,9296,1317,277,1109,1160,10299
97,100,1874,1515,1436,37731,5714,567,2093,818,5690,12331,10066,325143,60087,4583,18409,39167,335209
97,101,15,0,0,0,0,0,0,8,41,0,0,0,0,0,0,0,0
97,102,11,0,0,0,0,0,0,5,28,0,0,0,0,0,0,0,0
97,103,12,0,0,0,0,0,0,5,32,0,0,0,0,0,0,0,0
97,104,43,16,156,251,26,31,4,18,103,39,402,1060,135,138,6,407,1462
97,105,1,0,0,0,0,0,0,1,6,0,0,0,0,0,0,0,0
97,106,32,0,0,0,0,0,0,5,69,0,0,0,0,0,0,0,0
97,121,2,0,0,0,0,0,0,1,4,0,0,0,0,0,0,0,0
97,122,146,30,290,234,26,41,46,23,300,45,624,518,52,110,111,524,1142
97,123,3,0,0,0,0,0,0,2,10,0,0,0,0,0,0,0,0
97,125,96,0,0,0,0,0,0,4,205,0,0,0,0,0,0,0,0
97,127,74,0,0,0,0,0,0,2,128,0,0,0,0,0,0,0,0
98,95,889,404,6389,18774,994,1115,2761,382,2300,2959,32495,104113,6222,7080,21337,25163,136608
98,99,190,291,459,3752,642,120,405,100,560,2579,3652,30118,5985,1171,3786,4211,33770
98,100,8581,10041,25176,312182,44627,9368,9594,2768,24162,62108,96724,1691300,336280,37387,63079,337358,1788024
98,101,67,17,16,659,184,5,7,38,224,140,113,5549,1958,26,47,675,5662
98,102,7,12,0,78,17,0,0,5,27,98,0,679,146,0,0,78,679
98,103,1,0,0,0,0,0,0,1,6,0,0,0,0,0,0,0,0
98,104,5,0,0,0,0,0,0,3,15,0,0,0,0,0,0,0,0
98,106,8,0,0,0,0,0,0,2,14,0,0,0,0,0,0,0,0
98,107,30,0,0,0,0,0,0,1,46,0,0,0,0,0,0,0,0
98,122,1,0,0,0,0,0,0,1,2,0,0,0,0,0,0,0,0
98,123,3,0,0,0,0,0,0,1,6,0,0,0,0,0,0,0,0
98,124,6,0,0,0,0,0,0,1,12,0,0,0,0,0,0,0,0
98,125,14,0,0,0,0,0,0,3,29,0,0,0,0,0,0,0,0
99,88,2,0,0,0,0,0,0,1,4,0,0,0,0,0,0,0,0
99,95,126,91,298,1909,154,123,445,44,377,853,3377,17164,1408,1314,4926,2207,20541
99,98,2,0,0,0,0,0,0,2,9,0,0,0,0,0,0,0,0
99,99,718,532,2306,10287,1364,375,2061,296,2271,4437,17204,89962,13691,3413,20232,12593,107166
99,100,1432,1253,1743,47109,4845,747,2165,535,4254,8708,8121,283284,39926,3202,16573,48852,291405
99,101,2429,2201,6410,71449,8202,1818,3454,1122,7296,12388,23346,420623,66876,7153,23451,77859,443969
99,102,14,0,0,84,24,0,0,7,38,0,0,776,239,0,0,84,776
99,105,4,0,0,0,0,0,0,2,18,0,0,0,0,0,0,0,0
99,106,9,0,0,0,0,0,0,5,27,0,0,0,0,0,0,0,0
99,119,35,0,0,0,0,0,0,5,70,0,0,0,0,0,0,0,0
99,121,3,0,0,0,0,0,0,1,6,0,0,0,0,0,0,0,0
99,123,22,0,0,0,0,0,0,2,46,0,0,0,0,0,0,0,0
99,124,19,0,0,0,0,0,0,2,37,0,0,0,0,0,0,0,0
99,125,16,0,0,0,0,0,0,5,33,0,0,0,0,0,0,0,0
99,126,2,0,0,0,0,0,0,1,4,0,0,0,0,0,0,0,0
99,127,1,0,0,0,0,0,0,1,3,0,0,0,0,0,0,0,0
100,97,3700,3005,6914,183687,7420,7022,4483,850,8869,17170,23593,636586,42320,33681,32235,190601,660179
100,98,563,813,1187,13175,1341,458,1170,181,1537,5467,6743,94859,12537,2765,9028,14362,101602
100,99,777,1079,1192,13886,1163,369,1014,312,2174,8600,8480,112195,10987,2845,10043,15078,120675
100,100,8718,8148,46530,594706,39407,21383,5827,4525,22119,27501,95158,1722910,153594,56388,17314,641236,1818068
100,101,888,461,9296,57626,2687,1667,769,498,2535,2183,18760,155581,17404,5354,1957,66922,174341
100,102,12,0,0,0,0,0,0,6,33,0,0,0,0,0,0,0,0
100,103,6,0,0,0,0,0,0,4,21,0,0,0,0,0,0,0,0
100,104,1,0,0,0,0,0,0,1,6,0,0,0,0,0,0,0,0
100,105,8,0,0,0,0,0,0,3,16,0,0,0,0,0,0,0,0
100,121,26,0,0,0,0,0,0,7,65,0,0,0,0,0,0,0,0
100,122,19,113,65,700,151,64,49,5,53,223,116,1255,314,97,111,765,1371
100,123,14,0,0,0,0,0,0,3,32,0,0,0,0,0,0,0,0
100,124,20,0,0,0,0,0,0,1,40,0,0,0,0,0,0,0,0
100,125,2,0,0,0,0,0,0,1,4,0,0,0,0,0,0,0,0
100,126,4,0,0,0,0,0,0,1,8,0,0,0,0,0,0,0,0
100,127,15,0,0,0,0,0,0,1,23,0,0,0,0,0,0,0,0
101,92,2,0,0,0,0,0,0,1,4,0,0,0,0,0,0,0,0
101,96,231,373,164,5649,1087,118,628,57,642,2807,1395,44634,8052,713,6017,5813,46029
101,97,1160,459,5666,29095,1478,1452,2622,273,2848,3386,32025,174734,11477,8454,18278,34761,206759
101,98,69,53,45,1123,153,61,139,28,186,391,405,8818,1537,419,1108,1168,9223
101,99,3046,3368,8960,91113,12244,2605,6640,919,8209,22729,45465,666976,108231,16506,49059,100073,712441
101,100,3581,3641,10944,128190,11457,2399,2678,1196,9588,19893,30335,685979,80419,10920,14303,139134,716314
101,101,319,49,88,2239,410,67,19,85,813,328,597,16091,4091,315,187,2327,16688
101,102,70,18,31,458,105,0,8,24,183,186,66,4099,1047,0,9,489,4165
101,103,104,69,3821,6930,843,117,128,22,204,124,7068,7785,961,288,268,10751,14853
101,104,11,0,0,0,0,0,0,3,26,0,0,0,0,0,0,0,0
101,120,5,0,0,0,0,0,0,1,15,0,0,0,0,0,0,0,0
101,121,11,0,0,0,0,0,0,4,28,0,0,0,0,0,0,0,0
101,122,61,0,0,0,0,0,0,5,127,0,0,0,0,0,0,0,0
101,123,4,0,0,0,0,0,0,1,9,0,0,0,0,0,0,0,0
101,127,202,100,1797,1347,203,137,121,22,581,172,3244,3351,505,311,230,3144,6595
102,94,46,64,36,580,111,12,104,23,122,757,387,5947,1439,112,1152,616,6334
102,95,955,963,3440,23659,2683,1006,2228,266,2264,7852,13063,139920,23161,5301,16917,27099,152983
102,96,621,554,471,12437,1315,389,2220,180,1841,4907,3888,108156,12456,2750,22849,12908,112044
102,97,2367,2489,5850,54462,6503,2750,7936,475,6092,20802,39116,386294,59331,18078,65055,60312,425410
102,98,2897,10470,6751,95226,11428,5673,4027,575,7146,75240,30161,591095,86687,31026,30087,101977,621256
102,99,198,122,508,3103,439,207,299,107,554,1011,3987,23077,4476,1343,2571,3611,27064
102,100,4822,4921,5713,123865,18225,1680,4925,1354,13450,29393,22868,786486,140533,7415,28288,129578,809354
102,101,23,0,0,0,0,0,0,10,67,0,0,0,0,0,0,0,0
102,102,115,17,12,162,81,0,0,25,256,98,48,1472,887,0,0,174,1520
102,120,12,0,0,0,0,0,0,1,27,0,0,0,0,0,0,0,0
102,121,7,0,0,0,0,0,0,2,18,0,0,0,0,0,0,0,0
102,122,2,0,0,0,0,0,0,1,3,0,0,0,0,0,0,0,0
102,124,45,0,0,0,0,0,0,2,58,0,0,0,0,0,0,0,0
102,127,8,0,0,0,0,0,0,1,15,0,0,0,0,0,0,0,0
103,94,65,30,47,778,40,21,217,25,212,157,438,7392,346,174,2500,825,7830
103,95,846,1107,1009,15696,2639,641,2162,323,2521,10687,7827,147678,30100,5689,22705,16705,155505
103,97,12,0,0,0,0,0,0,6,40,0,0,0,0,0,0,0,0
103,98,409,441,290,7915,902,341,360,166,1148,4251,2186,63790,8336,2389,2963,8205,65976
103,99,331,227,330,6362,643,142,390,137,982,1761,2449,54491,6392,1151,3590,6692,56940
103,100,1969,1404,1331,40944,6515,438,1946,535,5285,10321,8339,306610,56389,2960,13134,42275,314949
103,101,6,0,0,0,0,0,0,3,18,0,0,0,0,0,0,0,0
103,102,6,0,0,0,0,0,0,2,15,0,0,0,0,0,0,0,0
103,125,28,0,0,0,0,0,0,2,50,0,0,0,0,0,0,0,0
103,126,8,0,0,0,0,0,0,2,52,0,0,0,0,0,0,0,0
103,127,2,0,0,0,0,0,0,2,4,0,0,0,0,0,0,0,0
104,92,219,89,385,1483,138,188,415,41,537,837,2867,12702,1264,1569,4275,1868,15569
104,93,152,65,563,1607,114,178,262,54,353,494,3079,11193,722,1411,2207,2170,14272
104,94,406,534,879,10024,1805,550,857,154,1184,4189,5364,69363,15731,4031,7802,10903,74727
104,95,5,0,0,0,0,0,0,2,11,0,0,0,0,0,0,0,0
104,96,236,133,135,4321,302,125,479,88,663,1200,1117,35890,2824,631,4718,4456,37007
104,97,101,72,71,1337,127,68,427,32,274,704,583,11839,1125,636,4194,1408,12422
104,99,8413,6977,14114,235062,28032,2418,8915,1626,20511,43585,69812,1620619,197906,12785,64525,249176,1690431
104,100,38,15,9,386,113,15,6,20,116,88,37,2932,846,90,36,395,2969
104,101,25,0,0,0,0,0,0,14,86,0,0,0,0,0,0,0,0
104,102,7,0,0,0,0,0,0,2,14,0,0,0,0,0,0,0,0
104,120,9,0,0,0,0,0,0,1,15,0,0,0,0,0,0,0,0
104,121,8,0,0,0,0,0,0,1,16,0,0,0,0,0,0,0,0
104,122,42,0,0,0,0,0,0,8,109,0,0,0,0,0,0,0,0
104,123,9,0,0,0,0,0,0,1,22,0,0,0,0,0,0,0,0
104,124,230,200,8817,2544,241,126,464,15,425,396,39253,7321,661,281,1633,11361,46574
104,125,1,0,0,0,0,0,0,1,3,0,0,0,0,0,0,0,0
104,127,24,0,0,0,0,0,0,3,44,0,0,0,0,0,0,0,0
105,95,269,102,321,3512,374,192,845,107,754,989,2501,29574,3877,1429,8925,3833,32075
105,96,269,421,184,5879,1365,214,1405,54,662,4068,1404,52734,12227,1163,15291,6063,54138
105,97,66,14,18,871,17,14,237,24,207,154,136,8912,217,112,2760,889,9048
105,98,7073,8620,13347,221649,29722,3351,4784,1658,17389,50183,58468,1457104,216072,17950,30750,234996,1515572
105,99,5985,7302,10884,188647,19426,4824,5030,1464,14636,37038,49811,1195764,140509,25426,28203,199531,1245575
105,100,72,19,7,512,210,12,0,39,269,207,49,5095,2479,100,0,519,5144
105,101,7,0,0,0,0,0,0,4,26,0,0,0,0,0,0,0,0
105,121,5,0,0,0,0,0,0,1,10,0,0,0,0,0,0,0,0
105,126,21,0,0,0,0,0,0,2,39,0,0,0,0,0,0,0,0
105,127,43,33,932,244,41,7,24,7,82,48,2326,485,122,9,28,1176,2811
106,94,130,115,333,2621,266,172,354,58,326,986,2464,19106,2155,1031,3533,2954,21570
106,95,6262,4872,16147,159134,16334,4996,11254,1232,15436,33813,87818,966687,124951,26697,96330,175281,1054505
106,96,38,0,0,0,0,0,0,11,107,0,0,0,0,0,0,0,0
106,97,2541,3155,1609,65345,4402,749,1899,400,6372,14565,10587,472042,34149,4015,15761,66954,482629
106,98,2,0,0,0,0,0,0,2,10,0,0,0,0,0,0,0,0
106,99,12,0,0,0,0,0,0,10,39,0,0,0,0,0,0,0,0
106,100,230,49,837,1102,405,34,22,83,627,406,1393,9868,5092,68,35,1939,11261
106,101,15,0,0,0,0,0,0,6,38,0,0,0,0,0,0,0,0
106,120,85,84,1529,1636,279,207,67,6,208,114,3036,3143,458,358,194,3165,6179
106,124,4,0,0,0,0,0,0,4,20,0,0,0,0,0,0,0,0
106,125,6,0,0,0,0,0,0,1,12,0,0,0,0,0,0,0,0
107,95,843,565,1379,18619,2195,314,1208,190,1989,4212,7516,140849,18345,1721,9277,19998,148365
107,96,96,10,78,1898,81,22,20,30,234,133,306,13798,667,62,148,1976,14104
107,97,4787,1983,8443,132821,9435,1160,4661,848,11478,11268,36539,868940,60175,4661,24177,141264,905479
107,98,20,0,0,0,0,0,0,8,42,0,0,0,0,0,0,0,0
107,101,1,0,0,0,0,0,0,1,6,0,0,0,0,0,0,0,0
107,120,21,0,0,0,0,0,0,2,36,0,0,0,0,0,0,0,0
107,122,21,0,0,0,0,0,0,1,49,0,0,0,0,0,0,0,0
107,126,18,0,0,0,0,0,0,1,39,0,0,0,0,0,0,0,0
108,93,370,49,332,3893,191,229,156,66,804,285,1643,13592,966,824,1263,4225,15235
108,95,546,130,313,5437,253,63,175,171,1340,986,2570,42772,2451,451,1725,5750,45342
108,96,174,77,427,2444,463,135,161,62,446,297,1255,10698,2739,388,560,2871,11953
108,97,18,0,0,0,0,0,0,5,45,0,0,0,0,0,0,0,0
108,98,26,7,274,701,61,41,9,4,56,7,468,1431,216,53,15,975,1899
108,119,1,0,0,0,0,0,0,1,2,0,0,0,0,0,0,0,0
108,120,22,0,0,0,0,0,0,6,51,0,0,0,0,0,0,0,0
108,121,6,0,0,0,0,0,0,1,22,0,0,0,0,0,0,0,0
108,122,74,75,3226,1208,156,109,178,7,149,169,6503,3859,559,163,295,4434,10362
108,123,86,0,0,0,0,0,0,4,202,0,0,0,0,0,0,0,0
108,124,13,0,0,0,0,0,0,1,56,0,0,0,0,0,0,0,0
108,126,27,92,425,481,8,136,46,6,49,188,1594,1581,27,324,144,906,3175
108,127,6,0,0,0,0,0,0,1,34,0,0,0,0,0,0,0,0
109,93,144,52,266,1505,128,90,115,24,408,314,1722,6524,604,352,1038,1771,8246
109,94,317,134,352,5806,441,92,267,84,828,1051,2608,43394,3664,574,2181,6158,46002
109,95,959,340,575,17425,1197,357,395,251,2640,2293,3652,130715,10944,2190,3025,18000,134367
109,96,297,73,95,2823,398,14,299,84,819,618,568,23845,4219,71,2077,2918,24413
109,120,15,0,0,0,0,0,0,1,23,0,0,0,0,0,0,0,0
109,121,10,0,0,0,0,0,0,3,26,0,0,0,0,0,0,0,0
109,123,53,0,0,0,0,0,0,5,103,0,0,0,0,0,0,0,0
109,124,101,0,0,0,0,0,0,5,316,0,0,0,0,0,0,0,0
109,125,6,0,0,0,0,0,0,1,12,0,0,0,0,0,0,0,0
110,93,168,85,550,4206,321,316,143,81,443,585,2853,17891,2018,1361,1173,4756,20744
110,94,290,7,11,146,8,8,0,17,854,14,57,709,32,46,0,157,766
110,95,4,0,0,0,0,0,0,1,8,0,0,0,0,0,0,0,0
110,96,104,0,0,0,0,0,0,9,249,0,0,0,0,0,0,0,0
110,97,10,0,0,0,0,0,0,1,20,0,0,0,0,0,0,0,0
110,120,38,0,0,0,0,0,0,5,85,0,0,0,0,0,0,0,0
110,121,6,0,0,0,0,0,0,1,15,0,0,0,0,0,0,0,0
110,123,1,0,0,0,0,0,0,1,4,0,0,0,0,0,0,0,0
110,124,7,0,0,0,0,0,0,1,17,0,0,0,0,0,0,0,0
110,125,3,0,0,0,0,0,0,1,8,0,0,0,0,0,0,0,0
111,92,117,115,261,2520,199,238,287,35,278,1046,1532,15990,1323,1321,2610,2781,17522
111,93,13,0,0,0,0,0,0,5,36,0,0,0,0,0,0,0,0
111,94,207,236,1162,7519,643,580,237,87,478,681,3271,23103,2642,1547,810,8681,26374
111,95,6,0,0,0,0,0,0,2,12,0,0,0,0,0,0,0,0
111,120,273,480,7508,8887,1260,650,447,42,642,709,14886,16106,2188,837,753,16395,30992
111,123,65,86,2628,1246,104,84,157,6,109,99,4993,2833,271,169,216,3874,7826
111,124,16,0,0,0,0,0,0,3,35,0,0,0,0,0,0,0,0
111,127,36,48,403,291,27,89,22,5,62,76,593,791,38,391,24,694,1384
112,93,233,54,239,3838,302,68,42,48,516,358,1167,22910,2365,310,357,4077,24077
112,94,686,539,945,23347,3573,521,414,128,1640,3572,4031,119746,28298,2239,2280,24292,123777
112,120,23,0,0,0,0,0,0,4,60,0,0,0,0,0,0,0,0
112,126,3,0,0,0,0,0,0,1,5,0,0,0,0,0,0,0,0
113,92,247,68,53,6368,268,36,12,42,592,566,232,47495,2315,196,65,6421,47727
113,93,1124,1240,1961,67744,6608,2393,601,166,2905,5295,6853,301385,30646,7512,1892,69705,308238
113,122,26,0,0,0,0,0,0,3,52,0,0,0,0,0,0,0,0
113,124,5,0,0,0,0,0,0,1,13,0,0,0,0,0,0,0,0
113,125,3,0,0,0,0,0,0,1,6,0,0,0,0,0,0,0,0
113,126,55,0,0,0,0,0,0,9,126,0,0,0,0,0,0,0,0
113,127,6,0,0,0,0,0,0,1,12,0,0,0,0,0,0,0,0
114,92,10548,16935,51707,1004948,52262,27568,5574,3119,24424,66685,131031,3203418,194584,78908,14658,1056655,3334449
114,93,777,509,1087,20095,2441,1222,203,280,1883,3079,3610,96187,16745,4731,690,21182,99797
114,120,33,6,330,285,46,59,22,4,69,8,639,689,84,335,22,615,1328
114,122,91,255,4770,3025,324,166,223,12,183,479,10621,5345,850,330,284,7795,15966
114,124,2,0,0,0,0,0,0,2,7,0,0,0,0,0,0,0,0
114,125,147,0,0,0,0,0,0,12,295,0,0,0,0,0,0,0,0
114,126,3,0,0,0,0,0,0,1,7,0,0,0,0,0,0,0,0
114,127,71,127,2564,1613,120,152,421,8,175,172,3963,2341,271,174,456,4177,6304
115,91,50,20,28,1337,78,18,7,23,135,79,40,3546,331,33,8,1365,3586
115,92,4413,5172,13011,203922,17107,5921,1396,815,10133,26692,36292,981357,85423,20474,5324,216933,1017649
115,124,14,0,0,0,0,0,0,1,19,0,0,0,0,0,0,0,0
115,125,205,0,0,0,0,0,0,13,360,0,0,0,0,0,0,0,0
115,126,6,0,0,0,0,0,0,2,12,0,0,0,0,0,0,0,0
115,127,70,28,1511,2321,46,6,116,18,139,50,2880,2779,97,10,146,3832,5659
116,91,147,65,709,5246,325,135,71,68,359,315,1842,17631,1397,348,134,5955,19473
116,92,13,0,0,0,0,0,0,7,30,0,0,0,0,0,0,0,0
116,119,10,0,0,0,0,0,0,3,22,0,0,0,0,0,0,0,0
116,120,27,42,756,660,100,37,43,12,64,78,1454,1352,206,62,162,1416,2806
116,122,3,0,0,0,0,0,0,3,7,0,0,0,0,0,0,0,0
116,123,7,0,0,0,0,0,0,1,14,0,0,0,0,0,0,0,0
116,124,2,0,0,0,0,0,0,2,8,0,0,0,0,0,0,0,0
116,125,482,708,18917,11002,1182,591,891,107,1044,1423,33715,25298,3311,1985,1394,29919,59013
116,126,23,0,0,0,0,0,0,3,47,0,0,0,0,0,0,0,0
116,127,20,0,0,0,0,0,0,3,44,0,0,0,0,0,0,0,0
117,90,178,226,87,4555,930,201,180,59,433,1043,561,28597,4476,1105,1154,4642,29158
117,91,51,6,4,606,68,1,0,24,139,84,30,5006,615,3,0,610,5036
117,122,376,125,6516,2630,458,359,119,24,832,454,9341,4785,985,622,239,9146,14126
117,123,4,0,0,0,0,0,0,1,8,0,0,0,0,0,0,0,0
117,125,15,8,172,111,33,0,13,7,32,22,365,403,96,0,18,283,768
117,127,22,0,0,0,0,0,0,3,73,0,0,0,0,0,0,0,0
118,90,4,0,0,0,0,0,0,1,8,0,0,0,0,0,0,0,0
118,119,14,0,0,0,0,0,0,3,31,0,0,0,0,0,0,0,0
118,121,1,0,0,0,0,0,0,1,4,0,0,0,0,0,0,0,0
118,123,251,135,4537,1966,339,136,123,25,814,237,7836,4064,819,500,173,6503,11900
118,124,7,0,0,0,0,0,0,2,20,0,0,0,0,0,0,0,0
118,125,17,0,0,0,0,0,0,4,34,0,0,0,0,0,0,0,0
119,120,60,0,0,0,0,0,0,1,120,0,0,0,0,0,0,0,0
119,121,5,0,0,0,0,0,0,1,10,0,0,0,0,0,0,0,0
119,122,13,0,0,0,0,0,0,2,34,0,0,0,0,0,0,0,0
120,122,1,0,0,0,0,0,0,1,2,0,0,0,0,0,0,0,0
121,122,65,113,2740,918,146,36,81,8,126,161,3844,1228,234,41,83,3658,5072
