x,y,ACCOMMODATION UNITS (ROOMS APARTMENTS CAMPING SITES) - TOTAL,A_AUSTRIAN TOURISTS,A_DOMESTIC TOURISTS - TOTAL,A_FOREIGN TOURISTS - TOTAL,A_GERMAN TOURISTS,A_ITALIAN TOURISTS,A_SLOVENIAN TOURISTS,ESTABLISHMENTS - TOTAL,NUMBER OF PERMANENT BEDS,N_AUSTRIAN TOURISTS,N_DOMESTIC TOURISTS - TOTAL,N_FOREIGN TOURISTS - TOTAL,N_GERMAN TOURISTS,N_ITALIAN TOURISTS,N_SLOVENIAN TOURISTS,TOTAL ARRIVALS,TOTAL NIGHTS
22,114,454,2204,359,20190,1946,2274,8448,60,1391,10500,1191,111681,14947,8877,44284,20549,112872
23,110,23,483,31,1374,229,118,192,4,51,2393,121,7843,1761,664,993,1405,7964
23,111,2106,467,112,8682,1096,551,5046,167,7040,2680,436,56300,9999,3045,31405,8794,56736
23,112,699,2913,446,27106,5480,2969,8862,168,1960,14712,1582,146712,34352,15054,47852,27552,148294
23,113,5946,64268,23816,283660,47111,38656,56466,630,15244,293999,70592,1501710,368529,147868,210776,307476,1572302
23,114,1834,12832,4827,86434,14928,8761,29243,240,5265,55218,15541,439673,98021,32342,145906,91261,455214
24,107,6579,19935,7421,216503,56618,21529,34182,264,18505,133725,31243,1651280,550109,113550,177258,223924,1682523
24,108,7047,93529,30982,394646,85148,49910,36705,782,16055,422518,77268,2084776,577519,184038,140352,425628,2162044
24,109,2381,5542,962,35437,10967,4018,2288,536,6880,30971,4921,241720,94366,21380,9462,36399,246641
24,110,7185,45012,7623,191785,40085,15712,53758,585,20676,207974,21400,1033671,290263,64008,250888,199408,1055071
24,111,307,897,272,5195,1903,506,516,125,755,6107,1086,37470,17119,2730,2376,5467,38556
24,112,132,448,186,2865,953,390,186,61,319,3114,543,19839,8440,2106,651,3051,20382
24,113,155,325,184,2421,584,486,232,70,385,1758,743,13878,4547,2096,721,2605,14621
24,114,472,192,88,1626,333,397,182,21,1380,810,234,7824,2774,1315,531,1714,8058
25,105,11969,94472,43458,531134,123590,70756,43499,2055,31516,508894,124996,3212598,1067473,340072,160726,574592,3337594
25,106,57,212,33,1222,448,120,51,29,157,1428,180,9899,4609,781,493,1255,10079
25,107,6301,34841,3989,201777,61890,23912,31794,258,17792,229181,14762,1542618,602770,132458,178229,205766,1557380
25,108,504,943,417,10567,3817,1697,548,229,1470,5371,1526,72541,35009,8333,1861,10984,74067
25,109,768,2059,790,18548,7394,2635,801,355,2147,12068,3346,134961,68330,13754,3034,19338,138307
25,110,3403,28984,2686,115347,32821,12219,13399,167,9429,184660,10239,781525,272691,65987,67979,118033,791764
25,111,23,4,6,240,117,15,6,9,52,20,26,2198,1221,85,21,246,2224
25,112,122,836,718,3604,612,649,248,54,294,2713,1357,14046,3924,1749,448,4322,15403
25,113,275,509,370,8389,1749,4425,303,66,625,2238,726,36131,16785,10559,590,8759,36857
26,104,58,0,0,0,0,0,0,8,160,0,0,0,0,0,0,0,0
26,105,855,55,21,541,195,49,13,20,2543,325,40,3079,1540,187,37,562,3119
26,106,275,777,363,7196,2178,1282,157,115,715,4724,1502,45575,18850,5974,532,7559,47077
26,107,108,0,0,0,0,0,0,44,254,0,0,0,0,0,0,0,0
26,108,171,327,136,3104,1430,361,94,86,532,2172,403,24922,14156,1537,423,3240,25325
26,109,275,442,240,3570,1212,205,160,95,615,2559,632,24862,11230,848,383,3810,25494
26,110,344,63,23,428,244,30,26,153,879,429,81,3163,2210,118,50,451,3244
26,111,61,68,14,513,163,0,1,22,139,410,50,4108,1416,0,7,527,4158
26,112,142,524,339,2913,545,408,243,46,376,1732,1426,12859,3990,945,673,3252,14285
26,113,81,193,89,1276,479,101,68,30,188,920,252,7777,4164,264,137,1365,8029
27,102,5,0,0,0,0,0,0,2,16,0,0,0,0,0,0,0,0
27,103,145,338,99,3286,1433,295,269,68,419,2380,540,26556,14412,1834,1466,3385,27096
27,104,818,5688,1834,44905,12289,7574,11553,96,2285,34090,5809,284678,105344,37977,69140,46739,290487
27,105,26,53,74,830,283,175,21,10,57,330,153,4835,2372,460,31,904,4988
27,106,224,195,229,2169,989,183,56,90,512,1169,660,15905,9020,885,97,2398,16565
27,107,224,279,63,2138,1030,75,35,92,540,1912,165,18198,9913,654,168,2201,18363
27,108,335,514,78,3624,1932,59,26,125,773,3618,359,32142,18606,389,128,3702,32501
27,109,135,105,8,750,460,27,19,49,307,848,41,6896,4424,178,75,758,6937
27,110,117,93,15,797,427,23,2,50,289,722,68,6395,3694,160,26,812,6463
27,111,150,81,190,1374,418,128,86,60,339,450,397,8584,3624,227,150,1564,8981
27,112,36,72,9,258,130,0,2,15,82,482,65,2023,1151,0,8,267,2088
27,113,8,0,0,0,0,0,0,3,16,0,0,0,0,0,0,0,0
28,100,21,6,6,438,66,74,5,19,53,22,55,2431,458,417,22,444,2486
28,101,215,565,299,6223,1598,788,282,109,574,3864,1269,42524,14052,4790,1504,6522,43793
28,102,4413,8647,8853,144424,41721,15301,25172,933,12931,56619,49161,1066247,370935,96644,146423,153277,1115408
28,103,7,0,0,0,0,0,0,6,24,0,0,0,0,0,0,0,0
28,104,78,336,59,1908,1154,43,18,29,203,2393,180,17233,11599,336,31,1967,17413
28,105,106,171,71,1670,1008,36,30,43,241,1192,182,15081,10337,233,103,1741,15263
28,106,122,117,66,1670,813,99,47,53,280,930,277,13476,8118,505,315,1736,13753
28,107,168,198,80,2419,1206,28,8,61,375,1703,331,21905,11812,112,68,2499,22236
28,108,193,362,153,3710,2194,86,28,76,503,2877,663,34664,22695,358,132,3863,35327
28,109,60,119,219,1443,588,87,33,28,179,656,470,9372,5122,285,48,1662,9842
28,110,72,75,23,923,533,1,0,29,170,651,145,9217,5362,11,0,946,9362
28,111,801,394,291,4130,1117,341,213,70,1846,852,566,9494,2877,506,408,4421,10060
28,112,64,108,71,626,189,14,58,23,142,345,119,3529,1672,18,87,697,3648
29,99,124,361,21,2926,1248,333,178,49,349,2380,55,23871,12663,2106,1243,2947,23926
29,100,3448,8801,3933,90943,26938,8168,9505,860,9616,53530,14910,628005,232349,47500,63342,94876,642915
29,101,8017,25058,36965,329780,62480,38994,21458,2179,21794,119747,94786,1684876,419811,179625,93079,366745,1779662
29,102,306,634,299,7296,3302,671,155,161,858,4754,1076,59484,32250,4372,698,7595,60560
29,103,323,656,371,7578,2749,522,1198,168,936,4574,2185,61667,26883,3785,7787,7949,63852
29,104,427,649,54,5311,3401,64,80,128,891,4916,378,50821,35241,429,425,5365,51199
29,105,227,236,100,2813,1555,78,32,89,500,1854,329,25891,15872,500,111,2913,26220
29,106,172,182,39,1901,1177,31,8,58,414,1464,199,18514,12521,150,43,1940,18713
29,107,93,62,56,915,480,47,42,41,211,491,238,8066,4881,236,218,971,8304
29,108,101,179,40,1589,930,16,13,44,266,1521,180,15519,9422,114,54,1629,15699
29,109,67,68,210,779,177,98,10,22,161,297,365,4810,1458,281,25,989,5175
29,110,3,0,0,0,0,0,0,2,6,0,0,0,0,0,0,0,0
29,111,23,0,0,0,0,0,0,8,51,0,0,0,0,0,0,0,0
29,112,42,0,0,0,0,0,0,16,86,0,0,0,0,0,0,0,0
29,113,4,0,0,0,0,0,0,1,8,0,0,0,0,0,0,0,0
29,114,1,0,0,0,0,0,0,1,4,0,0,0,0,0,0,0,0
30,99,5272,33221,5051,181571,36335,28303,33032,691,14445,184043,20209,1101537,276297,147272,177194,186622,1121746
30,100,4430,15617,2936,109242,42303,13707,6187,1198,12435,106808,13684,841067,396384,88554,32707,112178,854751
30,101,146,402,40,2949,1509,179,14,64,356,3071,214,26130,15857,1055,67,2989,26344
30,102,132,231,30,2498,1288,199,29,67,336,1652,219,21337,12978,1174,85,2528,21556
30,103,159,200,50,2866,1706,175,30,69,372,1354,180,26259,18056,1035,101,2916,26439
30,104,183,421,155,3284,1766,165,37,72,428,2629,577,27490,17551,925,178,3439,28067
30,105,108,262,252,2061,1236,54,70,44,255,1744,387,19266,13075,316,190,2313,19653
30,106,126,213,60,1524,642,102,61,42,267,1427,224,11905,5891,467,163,1584,12129
30,107,51,13,2,619,443,11,0,21,157,101,10,6116,4486,82,0,621,6126
30,108,25,13,7,163,83,0,4,12,63,74,18,1257,861,0,8,170,1275
30,109,63,85,2368,1710,214,430,113,21,138,250,4958,6086,765,1043,167,4078,11044
30,110,12,0,0,0,0,0,0,5,27,0,0,0,0,0,0,0,0
30,111,9,0,0,0,0,0,0,5,19,0,0,0,0,0,0,0,0
30,112,26,0,0,0,0,0,0,14,55,0,0,0,0,0,0,0,0
30,113,142,705,1763,6194,838,589,338,34,292,2018,3542,19197,3991,1067,451,7957,22739
31,100,47,92,35,980,467,58,50,22,114,675,305,8341,4519,412,272,1015,8646
31,102,322,575,193,6023,3366,271,105,134,773,3962,1283,53374,34026,1769,521,6216,54657
31,103,570,592,3372,10335,1964,992,2492,115,1633,3125,19047,68776,18509,5876,15192,13707,87823
31,104,180,386,49,3280,2151,71,21,83,423,2996,102,31343,22069,407,105,3329,31445
31,105,129,226,48,2425,1383,61,43,54,277,1414,161,20535,13991,263,140,2473,20696
31,106,68,35,7,307,193,5,0,33,180,337,49,3112,2015,35,0,314,3161
31,107,27,10,5,192,95,9,18,14,76,70,63,1584,1005,23,38,197,1647
31,108,95,186,148,1774,925,91,28,45,235,938,448,13699,8947,328,70,1922,14147
31,109,11,0,0,0,0,0,0,5,27,0,0,0,0,0,0,0,0
31,110,21,0,0,0,0,0,0,9,59,0,0,0,0,0,0,0,0
31,111,17,73,104,812,160,84,22,13,44,193,178,1969,620,130,46,916,2147
31,112,64,0,0,75,38,0,0,37,138,0,0,602,364,0,0,75,602
31,113,15,0,0,0,0,0,0,6,34,0,0,0,0,0,0,0,0
31,114,1,0,0,0,0,0,0,1,2,0,0,0,0,0,0,0,0
32,102,2,0,0,0,0,0,0,1,6,0,0,0,0,0,0,0,0
32,103,398,452,17,4317,2549,363,42,99,1036,3268,106,39325,26181,2291,276,4334,39431
32,104,88,245,48,1490,789,44,10,46,224,1697,190,12543,7667,364,70,1538,12733
32,105,209,247,121,4065,2404,231,70,101,547,1742,581,37351,25206,1674,323,4186,37932
32,106,309,541,260,5471,3112,292,90,169,856,3826,1415,49719,32127,1768,402,5731,51134
32,107,273,506,135,5552,3378,221,120,127,755,3444,667,50430,34759,1364,396,5687,51097
32,108,57,142,19,837,356,29,40,27,151,767,49,5821,3438,64,70,856,5870
32,109,11,0,0,0,0,0,0,7,33,0,0,0,0,0,0,0,0
32,110,20,0,0,0,0,0,0,7,44,0,0,0,0,0,0,0,0
32,111,4,0,0,0,0,0,0,3,17,0,0,0,0,0,0,0,0
32,112,17,49,56,506,27,187,41,11,44,217,153,1574,137,361,86,562,1727
32,113,9,0,0,0,0,0,0,3,19,0,0,0,0,0,0,0,0
33,103,83,126,37,986,440,80,13,40,210,836,196,8201,4142,657,90,1023,8397
33,104,335,1135,150,7789,3635,488,197,145,847,7362,671,60637,34634,2559,1050,7939,61308
33,105,3265,27754,6950,142705,36718,12326,13401,222,7921,141236,19843,880082,281984,55532,49533,149655,899925
33,106,1246,8045,1920,49267,15964,4817,2040,501,3147,41317,6071,322623,139763,22784,8631,51187,328694
33,107,114,47,127,648,161,142,4,46,303,204,559,3426,1144,702,9,775,3985
33,108,119,140,74,1518,695,74,23,53,286,1004,522,13983,7426,409,131,1592,14505
33,109,33,19,0,205,128,22,0,12,73,157,0,2000,1460,127,0,205,2000
33,110,11,0,0,0,0,0,0,4,24,0,0,0,0,0,0,0,0
33,111,22,0,0,0,0,0,0,8,47,0,0,0,0,0,0,0,0
33,114,3,0,0,0,0,0,0,1,6,0,0,0,0,0,0,0,0
34,106,34,98,4,654,401,8,7,18,85,751,16,5883,3814,56,49,658,5899
34,107,80,220,160,2074,898,296,42,34,206,833,358,11292,6829,594,90,2234,11650
34,108,172,404,51,4039,1241,524,111,76,437,2017,121,26089,10873,2263,453,4090,26210
34,109,96,289,81,2239,612,227,77,42,248,1478,384,14641,5387,1316,452,2320,15025
34,110,4,0,0,0,0,0,0,2,10,0,0,0,0,0,0,0,0
34,111,9,0,0,0,0,0,0,1,18,0,0,0,0,0,0,0,0
34,114,4,0,0,0,0,0,0,2,9,0,0,0,0,0,0,0,0
34,115,6,0,0,0,0,0,0,5,14,0,0,0,0,0,0,0,0
35,96,70,0,0,0,0,0,0,34,190,0,0,0,0,0,0,0,0
35,106,3,0,0,0,0,0,0,2,8,0,0,0,0,0,0,0,0
35,107,15,54,23,387,124,35,26,11,42,355,181,3186,1185,285,247,410,3367
35,109,899,9485,1649,42988,8698,5835,4220,218,2172,42166,5397,196083,51759,23972,17359,44637,201480
35,110,1581,10678,13640,82416,14731,8130,8004,291,3883,43322,35494,309549,77199,28655,24984,96056,345043
35,111,2917,31811,15244,152980,26360,14946,8514,664,6673,124140,40255,583625,141691,43771,21444,168224,623880
35,112,2069,28341,38796,178226,18802,20279,12056,480,4452,95861,84429,547021,93423,49680,25677,217022,631450
35,113,59,156,137,1065,270,172,35,28,142,503,315,5585,2143,465,90,1202,5900
35,114,22,0,0,0,0,0,0,7,54,0,0,0,0,0,0,0,0
35,115,1,0,0,0,0,0,0,1,4,0,0,0,0,0,0,0,0
36,93,58,493,225,1196,127,114,220,36,177,4445,1290,9835,1204,867,1528,1421,11125
36,101,4,0,0,0,0,0,0,4,13,0,0,0,0,0,0,0,0
36,102,6,28,0,121,16,39,3,5,16,168,0,746,100,236,12,121,746
36,106,82,0,0,0,0,0,0,12,231,0,0,0,0,0,0,0,0
36,107,1,0,0,0,0,0,0,1,4,0,0,0,0,0,0,0,0
36,111,38,113,304,2593,242,705,131,33,109,435,923,10079,1252,2382,378,2897,11002
36,112,431,883,2525,16731,3207,3932,370,275,1203,3561,8353,75462,24179,10518,1176,19256,83815
36,113,42,56,355,885,362,137,31,19,107,361,752,6471,3505,1168,73,1240,7223
36,114,3,0,0,0,0,0,0,2,6,0,0,0,0,0,0,0,0
37,95,4,44,0,169,41,9,27,3,15,314,0,1582,516,56,265,169,1582
37,96,25,35,19,541,119,114,139,16,80,294,94,4420,1198,764,1132,560,4514
37,97,505,1273,373,14101,5351,1397,2836,20,1508,8781,2310,97571,39721,9887,23293,14474,99881
37,98,3,0,0,0,0,0,0,2,14,0,0,0,0,0,0,0,0
37,99,42,169,25,834,174,226,47,26,123,1393,142,6417,1624,1761,313,859,6559
37,100,865,493,213,4447,496,1072,1841,158,2505,4089,1537,35518,4591,8017,14659,4660,37055
37,101,1,0,0,0,0,0,0,1,4,0,0,0,0,0,0,0,0
37,102,184,1417,126,5485,1482,1119,349,47,502,9127,519,35969,10994,7491,2360,5611,36488
37,103,2400,7935,4201,78709,22070,16086,17108,339,6635,55890,23458,579432,208712,97613,128480,82910,602890
37,111,1062,4031,18507,85208,9345,14203,1895,355,2602,7850,33886,179648,21858,26744,4825,103715,213534
37,112,87,179,675,3827,531,893,87,72,236,587,2054,12936,3110,2251,173,4502,14990
37,113,10,0,0,0,0,0,0,4,22,0,0,0,0,0,0,0,0
38,94,27,31,17,272,62,74,37,13,85,221,119,2143,548,429,360,289,2262
38,95,234,423,394,4951,824,1483,1101,111,658,3575,2944,41668,8542,11940,8988,5345,44612
38,96,1206,1907,1313,39969,6773,3551,22741,119,3790,13150,7057,307411,57984,25358,180656,41282,314468
38,97,7,40,3,162,37,17,34,4,17,311,15,1407,370,121,288,165,1422
38,98,25,83,11,608,71,226,24,17,72,500,66,4229,526,1603,272,619,4295
38,99,10,6,1,90,21,26,9,5,26,38,8,602,221,135,80,91,610
38,100,4,9,19,168,14,69,12,3,10,21,52,503,68,248,34,187,555
38,101,23,49,62,521,38,228,54,14,53,309,310,2782,221,1283,312,583,3092
38,102,10,28,21,264,21,123,17,6,24,187,100,1586,215,636,76,285,1686
38,103,15,46,25,423,132,87,16,12,40,355,147,2971,1193,475,116,448,3118
38,105,253,462,336,7384,1946,1029,1427,114,765,3231,2059,52396,18827,6294,7769,7720,54455
38,106,558,407,107,4938,1967,568,223,97,1568,2685,595,35708,19048,3551,1317,5045,36303
38,107,298,2303,376,8964,2201,1251,1011,80,686,12469,1820,54338,17793,6869,5526,9340,56158
38,111,374,1104,8291,18681,2162,2777,459,166,949,3889,19869,57163,12650,6341,835,26972,77032
38,112,121,201,1900,2200,498,597,98,42,333,537,4271,7452,2713,1314,435,4100,11723
38,113,32,19,42,240,49,68,2,15,84,59,134,944,326,197,4,282,1078
39,93,970,6654,11271,28780,5823,5622,3617,159,2463,36329,62064,171766,44455,29838,18553,40051,233830
39,94,4352,22828,26435,138709,34521,20372,27284,654,11279,141951,111792,982796,293059,128774,190027,165144,1094588
39,96,508,30,18,316,48,89,97,30,1500,394,106,3102,464,924,862,334,3208
39,105,222,618,244,6061,1593,1200,391,95,637,3542,809,34212,12892,6255,1321,6305,35021
39,106,168,77,4,606,333,43,4,77,421,632,29,5209,3080,350,28,610,5238
39,107,2761,12164,11601,87902,23261,10151,10465,1124,7465,62400,47813,536100,176340,60798,52231,99503,583913
39,108,1925,10356,5218,90186,30887,5668,20052,326,5013,53414,21537,515052,212636,27377,98802,95404,536589
39,109,679,718,4861,23512,3166,1181,3017,140,1614,3631,23234,117958,20011,5600,14909,28373,141192
39,110,952,664,2683,30532,3103,967,11336,62,2354,2797,13514,122764,13229,2417,47722,33215,136278
39,111,64,82,141,1389,350,154,25,53,172,462,498,8627,2906,856,78,1530,9125
39,113,1,0,0,0,0,0,0,1,4,0,0,0,0,0,0,0,0
39,114,10,0,0,0,0,0,0,1,35,0,0,0,0,0,0,0,0
39,118,7,0,0,0,0,0,0,3,20,0,0,0,0,0,0,0,0
40,92,20,0,0,0,0,0,0,11,64,0,0,0,0,0,0,0,0
40,93,8,0,0,0,0,0,0,4,24,0,0,0,0,0,0,0,0
40,105,3913,19176,6211,141514,40401,18833,15583,928,10702,95669,26404,795808,281043,94787,78003,147725,822212
40,106,77,205,17,1594,894,92,10,34,198,1389,57,13070,8793,464,16,1611,13127
40,107,387,1065,345,9249,2964,879,674,168,1060,6360,1365,62695,27716,4617,3881,9594,64060
40,108,397,1488,364,12575,4492,802,1808,147,1117,9479,2195,81501,33718,5039,10515,12939,83696
40,109,505,1235,1743,12154,4174,663,644,238,1414,7502,9664,87242,37770,3962,3229,13897,96906
40,110,239,241,1254,3625,901,435,179,102,577,1235,3505,16961,7177,1405,524,4879,20466
40,111,7,2,0,131,100,0,0,7,22,8,0,1338,1043,0,0,131,1338
40,116,19,0,0,0,0,0,0,3,48,0,0,0,0,0,0,0,0
40,117,19,0,251,45,2,6,9,10,89,0,605,97,3,14,20,296,702
40,118,4,0,0,0,0,0,0,3,12,0,0,0,0,0,0,0,0
41,89,9,17,31,85,6,17,31,5,26,171,242,831,31,160,401,116,1073
41,90,13,19,34,152,17,44,44,9,44,152,211,1031,96,283,309,186,1242
41,104,361,1051,672,10216,2076,1373,2425,134,940,6101,4209,69835,17711,8114,15769,10888,74044
41,105,2143,9053,3017,61833,14807,6732,16102,261,6173,50736,14101,357524,100460,34366,94409,64850,371625
41,106,360,1848,700,13235,4450,1222,1233,172,975,8903,2094,77117,36027,5588,3571,13935,79211
41,107,1077,2084,796,27561,7848,2843,5176,361,3187,13853,4314,192384,72374,17756,28445,28357,196698
41,108,3331,19528,19823,109125,24480,4048,9514,797,7931,85960,92914,598489,181878,15227,39820,128948,691403
41,109,1094,1760,4213,28945,7583,978,3496,363,2979,10628,19688,191392,65737,5415,18107,33158,211080
41,110,15,18,7,212,66,6,0,8,44,123,32,1648,663,48,0,219,1680
41,111,15,3,30,56,14,6,6,13,41,6,64,303,158,16,14,86,367
41,112,3,0,0,0,0,0,0,2,6,0,0,0,0,0,0,0,0
41,113,23,10,756,662,117,85,13,10,56,14,1698,1531,361,135,29,1418,3229
41,114,17,0,0,0,0,0,0,13,45,0,0,0,0,0,0,0,0
41,116,8,0,0,0,0,0,0,4,20,0,0,0,0,0,0,0,0
42,99,99,290,34,2419,684,232,177,34,296,2328,187,19792,6922,1962,1366,2453,19979
42,100,1267,4133,1412,29567,10464,2113,2758,360,3624,29509,9045,240557,106120,15897,19564,30979,249602
42,101,140,163,89,2278,1033,142,138,32,427,1178,626,18898,9288,1271,1156,2367,19524
42,103,516,326,27,2465,432,386,98,64,1454,2079,168,16914,3330,2518,754,2492,17082
42,104,245,444,533,7663,1018,1539,455,105,683,2271,1865,40222,7616,7655,1750,8196,42087
42,108,4282,15197,30050,147706,35057,6537,21666,1190,12023,64278,138988,782726,233091,24504,98840,177756,921714
42,109,120,206,70,2464,1620,48,5,65,383,1418,466,21941,15801,296,14,2534,22407
42,110,13,0,219,213,53,14,11,8,35,0,491,1030,436,42,14,432,1521
42,111,148,126,4843,4580,352,302,119,48,358,327,12114,11284,2215,621,275,9423,23398
42,112,33,18,426,550,120,38,10,18,83,33,1023,1395,388,50,14,976,2418
42,116,1,0,0,0,0,0,0,1,6,0,0,0,0,0,0,0,0
43,90,167,387,1003,2008,217,291,651,105,493,4174,7823,18480,2158,2375,6470,3011,26303
43,91,1,0,0,0,0,0,0,1,3,0,0,0,0,0,0,0,0
43,97,376,1312,2337,10048,1380,1399,1731,91,958,7394,8136,62427,11324,9253,10625,12385,70563
43,98,5,0,0,0,0,0,0,1,10,0,0,0,0,0,0,0,0
43,99,3791,14307,9783,94415,31522,11436,8034,866,10030,81933,42661,633542,256390,73785,51697,104198,676203
43,100,2708,11819,2907,75140,27537,3780,5004,303,7805,80909,16864,582988,257375,26245,37377,78047,599852
43,101,640,1544,644,17027,6861,867,772,228,2018,9685,4098,132367,61839,6613,5236,17671,136465
43,103,401,2669,415,14047,2610,1096,835,156,1033,15299,2099,89869,20668,5634,4487,14462,91968
43,104,3156,25747,7708,141236,30572,14877,17970,664,8589,134902,29260,829930,220817,81831,84983,148944,859190
43,107,2127,3710,12609,45688,9953,2283,3003,679,6424,17147,56577,300120,86849,12951,13133,58297,356697
43,108,86,152,55,1355,701,63,19,54,267,999,215,11929,6729,534,74,1410,12144
43,109,2,0,0,0,0,0,0,1,4,0,0,0,0,0,0,0,0
43,111,3,0,0,0,0,0,0,2,8,0,0,0,0,0,0,0,0
43,112,8,0,0,0,0,0,0,3,21,0,0,0,0,0,0,0,0
43,113,90,113,3246,4308,207,421,138,28,258,238,6803,6289,305,585,274,7554,13092
43,115,13,0,0,0,0,0,0,7,34,0,0,0,0,0,0,0,0
44,88,38,27,64,415,46,60,168,22,118,210,531,3620,463,508,1674,479,4151
44,90,3,0,4,33,0,20,9,3,14,0,60,345,0,259,44,37,405
44,91,22,13,38,118,8,6,60,13,57,175,414,1239,36,60,612,156,1653
44,96,228,0,0,0,0,0,0,57,608,0,0,0,0,0,0,0,0
44,98,648,1897,606,12711,5710,1153,1042,243,1861,13502,3922,109486,59751,8808,7809,13317,113408
44,99,837,2242,1053,16613,6619,1611,1390,333,2499,15978,7081,140696,69336,12929,10366,17666,147777
44,106,44,48,24,629,165,33,32,19,104,273,146,4611,1509,233,183,653,4757
44,107,1369,2366,1423,36900,11322,3319,2680,251,3971,11942,5721,191680,67929,13240,12066,38323,197401
44,108,6,0,0,0,0,0,0,3,14,0,0,0,0,0,0,0,0
44,109,10,0,0,0,0,0,0,4,19,0,0,0,0,0,0,0,0
44,111,37,2,392,130,5,8,40,13,102,12,766,392,20,14,77,522,1158
44,112,11,8,308,26,4,0,3,7,32,24,684,90,28,0,8,334,774
44,113,9,0,0,0,0,0,0,3,19,0,0,0,0,0,0,0,0
44,114,7,0,0,0,0,0,0,5,16,0,0,0,0,0,0,0,0
44,115,36,0,100,60,11,4,0,15,80,0,328,437,75,19,0,160,765
45,85,84,426,548,4296,1461,583,677,27,258,2338,3416,27537,9128,3770,5833,4844,30953
45,86,2,0,0,0,0,0,0,1,6,0,0,0,0,0,0,0,0
45,87,21,37,44,304,29,25,131,15,67,358,348,2863,260,348,1378,348,3211
45,88,3,0,0,0,0,0,0,1,12,0,0,0,0,0,0,0,0
45,94,214,1253,457,8651,1474,1339,499,27,513,4474,1295,38701,7643,7011,1792,9108,39996
45,95,5291,8162,3581,99876,23009,23302,5225,1362,15090,38484,17618,577587,137462,146141,34453,103457,595205
45,96,20,20,21,680,30,13,82,9,60,146,227,5331,327,112,768,701,5558
45,98,119,80,52,997,180,61,370,66,347,496,234,7474,1650,304,2680,1049,7708
45,100,80,111,16,759,210,51,45,45,266,722,70,5811,1898,361,340,775,5881
45,101,70,308,63,1650,220,168,65,36,214,2101,260,10838,1529,1204,354,1713,11098
45,103,454,973,654,17421,5149,1144,647,141,1345,4094,1557,77684,27829,4390,3006,18075,79241
45,104,1038,2683,1161,45577,10732,4659,965,523,3005,9032,3652,195737,64210,15660,3773,46738,199389
45,105,249,265,51,4299,1299,466,164,56,735,1549,253,24672,9214,2225,783,4350,24925
45,106,1,0,0,0,0,0,0,1,2,0,0,0,0,0,0,0,0
45,107,5,8,0,73,44,0,0,3,12,53,0,706,500,0,0,73,706
45,111,25,7,410,106,17,16,6,9,57,8,1094,485,168,33,9,516,1579
45,113,74,77,1666,3113,219,576,41,20,173,116,3777,3774,320,694,92,4779,7551
45,114,13,0,0,0,0,0,0,6,59,0,0,0,0,0,0,0,0
45,115,4,0,0,0,0,0,0,3,11,0,0,0,0,0,0,0,0
45,116,5,0,0,0,0,0,0,2,10,0,0,0,0,0,0,0,0
46,85,336,1153,2509,7126,1421,735,1816,64,841,7803,16363,48784,11461,4919,12268,9635,65147
46,86,16,14,35,216,20,19,90,9,52,147,292,2274,400,125,887,251,2566
46,87,31,36,34,245,22,13,99,17,90,433,314,2340,255,117,1015,279,2654
46,93,878,560,1204,17438,1637,1625,3508,280,2468,4240,8972,143437,16475,12852,29715,18642,152409
46,94,638,894,1057,12200,1119,2115,3357,310,1785,4064,7178,73797,7335,11971,25905,13257,80975
46,95,219,419,193,4984,669,689,139,58,692,1692,915,23808,3811,3994,815,5177,24723
46,98,2,0,0,0,0,0,0,2,4,0,0,0,0,0,0,0,0
46,102,2,0,0,0,0,0,0,2,10,0,0,0,0,0,0,0,0
46,103,26,30,10,998,286,65,23,10,82,176,18,6313,2694,399,103,1008,6331
46,104,13,0,0,0,0,0,0,5,28,0,0,0,0,0,0,0,0
46,105,6,3,4,129,83,7,6,6,23,21,8,1011,697,32,36,133,1019
46,106,1,0,0,0,0,0,0,1,6,0,0,0,0,0,0,0,0
46,110,3,0,0,0,0,0,0,1,6,0,0,0,0,0,0,0,0
46,113,18,0,0,0,0,0,0,4,118,0,0,0,0,0,0,0,0
46,114,8,0,0,0,0,0,0,3,18,0,0,0,0,0,0,0,0
46,115,3,0,0,0,0,0,0,2,8,0,0,0,0,0,0,0,0
47,85,15,0,0,0,0,0,0,9,46,0,0,0,0,0,0,0,0
47,93,1403,263,76,2137,295,547,370,71,4201,1753,408,16615,2641,4585,2861,2213,17023
47,94,504,378,404,9675,1062,1134,3896,132,1288,2267,2445,67027,8544,6971,28896,10079,69472
47,96,38,76,10,916,273,52,35,14,116,472,61,7400,2908,383,420,926,7461
47,102,4,0,0,0,0,0,0,2,12,0,0,0,0,0,0,0,0
47,103,2,0,0,0,0,0,0,1,5,0,0,0,0,0,0,0,0
47,104,4,0,0,0,0,0,0,1,8,0,0,0,0,0,0,0,0
47,109,2,0,0,0,0,0,0,1,6,0,0,0,0,0,0,0,0
47,110,25,3,145,85,29,34,4,11,56,8,531,472,304,67,21,230,1003
47,113,21,0,0,0,0,0,0,7,55,0,0,0,0,0,0,0,0
47,114,1,0,0,0,0,0,0,1,3,0,0,0,0,0,0,0,0
47,115,10,0,0,0,0,0,0,5,24,0,0,0,0,0,0,0,0
48,84,59,49,91,616,64,102,115,33,193,424,539,5060,597,677,1078,707,5599
48,85,1,0,0,0,0,0,0,1,2,0,0,0,0,0,0,0,0
48,86,7,0,0,0,0,0,0,7,27,0,0,0,0,0,0,0,0
48,89,26,26,86,604,104,4,55,16,89,156,431,4540,1029,40,381,690,4971
48,90,12,10,39,282,104,2,45,4,35,78,350,2516,1219,4,372,321,2866
48,91,28,0,30,94,14,13,20,10,84,0,195,963,152,110,182,124,1158
48,92,1980,3858,4902,49494,4711,8192,5042,617,5390,22315,27400,324995,37484,51687,30202,54396,352395
48,93,97,60,86,1771,175,150,38,46,305,419,582,13990,1731,1016,303,1857,14572
48,94,762,210,160,4710,533,572,1848,186,1912,1435,1038,36357,4397,3992,14401,4870,37395
48,95,433,1067,210,9303,3678,235,255,160,1270,8276,1373,76564,36516,1406,1481,9513,77937
48,101,96,46,1589,1956,211,194,133,14,227,87,2924,3067,396,272,213,3545,5991
48,103,13,0,0,0,0,0,0,2,28,0,0,0,0,0,0,0,0
48,105,23,0,0,0,0,0,0,3,28,0,0,0,0,0,0,0,0
48,112,3,0,0,0,0,0,0,2,10,0,0,0,0,0,0,0,0
48,114,4,0,0,0,0,0,0,2,8,0,0,0,0,0,0,0,0
49,82,1,0,0,0,0,0,0,1,4,0,0,0,0,0,0,0,0
49,83,15,4,13,107,9,16,45,8,42,36,130,1116,109,206,506,120,1246
49,85,15,1,28,127,10,0,60,10,47,1,222,958,120,0,451,155,1180
49,86,575,412,1582,8869,793,485,3933,167,1774,3235,13108,77601,7316,5159,36209,10451,90709
49,88,32,25,60,607,89,0,63,10,76,149,445,5160,976,0,536,667,5605
49,89,3323,2927,9866,65192,11238,828,9789,1514,9984,22370,66187,514393,114268,6583,75711,75058,580580
49,90,848,915,2070,18416,1847,999,3763,245,2443,6727,14838,137084,16367,5850,29383,20486,151922
49,91,88,99,66,1016,157,76,156,35,254,752,432,8573,1528,498,1272,1082,9005
49,94,7,0,0,0,0,0,0,4,20,0,0,0,0,0,0,0,0
49,95,1,0,0,0,0,0,0,1,50,0,0,0,0,0,0,0,0
49,101,5,0,0,0,0,0,0,4,17,0,0,0,0,0,0,0,0
49,103,1,0,0,0,0,0,0,1,4,0,0,0,0,0,0,0,0
49,104,2,0,0,0,0,0,0,1,4,0,0,0,0,0,0,0,0
49,110,11,0,0,0,0,0,0,4,34,0,0,0,0,0,0,0,0
49,111,5,0,0,0,0,0,0,4,19,0,0,0,0,0,0,0,0
49,112,3,0,0,0,0,0,0,2,8,0,0,0,0,0,0,0,0
49,114,13,0,0,0,0,0,0,4,31,0,0,0,0,0,0,0,0
50,81,49,23,119,775,119,98,150,23,147,227,755,6329,1283,818,1341,894,7084
50,82,173,241,400,3339,270,272,1345,53,440,1761,2054,27285,2243,1701,10349,3739,29339
50,83,91,186,175,1658,401,78,603,43,274,1526,1391,15136,4106,641,5807,1833,16527
50,84,121,40,68,371,73,17,140,22,325,277,514,3394,810,257,1279,439,3908
50,85,79,58,173,1309,145,55,758,39,263,489,1154,12716,1467,385,7872,1482,13870
50,87,1610,17443,11636,91621,17754,3069,5590,238,4076,93780,38992,441948,117155,15405,27428,103257,480940
50,88,5850,13357,14643,150715,44002,4301,8439,910,17516,100825,87709,1235642,437503,31221,59032,165358,1323351
50,89,99,245,182,2248,426,33,243,38,280,1612,1321,17691,4551,167,1919,2430,19012
50,91,25,11,22,285,48,6,130,6,78,65,141,2218,514,46,913,307,2359
50,92,12,0,0,0,0,0,0,3,26,0,0,0,0,0,0,0,0
50,94,12,22,942,656,154,50,36,3,69,40,1773,1397,299,90,72,1598,3170
50,97,8,0,0,0,0,0,0,2,15,0,0,0,0,0,0,0,0
50,102,27,22,114,738,71,89,12,15,64,49,208,1398,167,183,17,852,1606
50,108,1,0,0,0,0,0,0,1,3,0,0,0,0,0,0,0,0
50,109,3,0,0,0,0,0,0,3,12,0,0,0,0,0,0,0,0
50,110,80,18,121,593,77,66,1,22,242,100,190,1151,147,71,1,714,1341
50,111,44,142,1477,5567,282,443,32,10,101,195,2329,6256,393,632,37,7044,8585
50,112,1,0,0,0,0,0,0,1,4,0,0,0,0,0,0,0,0
50,115,12,0,0,0,0,0,0,6,36,0,0,0,0,0,0,0,0
50,121,2,0,0,0,0,0,0,1,4,0,0,0,0,0,0,0,0
51,81,246,344,956,4338,707,905,592,127,736,2870,5638,29975,6346,6151,4462,5294,35613
51,83,1,0,0,0,0,0,0,1,3,0,0,0,0,0,0,0,0
51,84,364,623,1103,7949,1549,366,1799,202,1216,5194,8549,65301,14723,2709,15306,9052,73850
51,85,4978,16848,47789,314835,32042,19182,11584,2158,13162,76607,124571,945664,157464,53131,54193,362624,1070235
51,86,888,1630,3404,25787,4460,1135,1347,353,2460,9308,13188,139609,33238,4325,7592,29191,152797
51,87,10,11,15,187,86,0,2,5,36,116,62,1251,649,0,10,202,1313
51,88,916,1160,3452,18091,4283,341,1909,394,2635,8119,24212,144214,43003,2343,15371,21543,168426
51,89,34,79,162,654,133,22,87,19,99,563,1087,5360,1354,146,784,816,6447
51,90,217,194,249,4815,353,159,833,64,595,1486,1372,34645,3957,1279,6865,5064,36017
51,91,35,54,304,907,164,62,82,12,104,450,2648,6569,1237,322,523,1211,9217
51,92,94,138,34,1353,456,59,93,38,264,983,202,9896,4168,366,632,1387,10098
51,95,2,0,0,0,0,0,0,1,6,0,0,0,0,0,0,0,0
51,96,7,0,0,0,0,0,0,3,15,0,0,0,0,0,0,0,0
51,99,1,0,0,0,0,0,0,1,3,0,0,0,0,0,0,0,0
51,101,9,0,0,0,0,0,0,5,30,0,0,0,0,0,0,0,0
51,102,195,268,1312,34787,950,1162,142,27,437,318,1762,36960,1301,1600,157,36099,38722
51,105,3,0,0,0,0,0,0,1,5,0,0,0,0,0,0,0,0
51,109,47,0,0,0,0,0,0,8,109,0,0,0,0,0,0,0,0
51,110,2,0,0,0,0,0,0,2,5,0,0,0,0,0,0,0,0
51,111,4,0,0,0,0,0,0,3,13,0,0,0,0,0,0,0,0
51,114,2,0,0,0,0,0,0,1,4,0,0,0,0,0,0,0,0
51,115,4,0,0,0,0,0,0,2,11,0,0,0,0,0,0,0,0
51,117,2,0,0,0,0,0,0,1,6,0,0,0,0,0,0,0,0
51,118,2,0,0,0,0,0,0,1,4,0,0,0,0,0,0,0,0
51,119,3,0,0,0,0,0,0,1,6,0,0,0,0,0,0,0,0
52,79,77,57,83,801,104,167,291,37,197,517,930,7310,834,1408,3165,884,8240
52,83,375,492,1098,6334,728,268,3045,89,971,4370,8805,53270,7902,2477,24132,7432,62075
52,84,984,833,2088,21340,3165,503,2802,403,2897,5535,13638,152225,29229,2929,21079,23428,165863
52,85,424,448,1452,17266,1849,1184,385,297,1164,1917,5169,62153,9900,4178,2019,18718,67322
52,86,119,150,398,5779,802,493,79,79,357,637,1214,21049,4509,1457,272,6177,22263
52,87,14,0,0,0,0,0,0,6,35,0,0,0,0,0,0,0,0
52,88,186,183,277,3019,1117,62,492,81,567,1612,1866,26428,11695,408,4101,3296,28294
52,89,346,878,704,7418,2546,128,1252,109,939,6103,4732,56820,22280,709,9585,8122,61552
52,90,22,20,26,439,158,33,56,9,70,124,102,3739,1616,277,417,465,3841
52,91,90,64,36,1388,370,88,72,34,233,288,311,9496,3307,507,496,1424,9807
52,94,61,0,0,0,0,0,0,9,127,0,0,0,0,0,0,0,0
52,95,7,0,0,0,0,0,0,3,14,0,0,0,0,0,0,0,0
52,97,3,0,0,0,0,0,0,2,7,0,0,0,0,0,0,0,0
52,99,5,0,0,0,0,0,0,2,10,0,0,0,0,0,0,0,0
52,101,58,123,139,1757,334,247,12,17,133,683,281,4467,744,679,48,1896,4748
52,102,14,0,0,0,0,0,0,3,33,0,0,0,0,0,0,0,0
52,106,3,0,0,0,0,0,0,1,6,0,0,0,0,0,0,0,0
52,107,2,0,0,0,0,0,0,2,9,0,0,0,0,0,0,0,0
52,110,4,0,0,0,0,0,0,2,8,0,0,0,0,0,0,0,0
52,113,30,0,0,0,0,0,0,5,69,0,0,0,0,0,0,0,0
52,115,6,0,0,0,0,0,0,2,11,0,0,0,0,0,0,0,0
52,116,2,0,0,0,0,0,0,2,5,0,0,0,0,0,0,0,0
52,117,54,0,0,0,0,0,0,2,153,0,0,0,0,0,0,0,0
52,119,4,0,0,0,0,0,0,2,10,0,0,0,0,0,0,0,0
52,122,3,0,0,0,0,0,0,1,8,0,0,0,0,0,0,0,0
53,79,1,0,0,0,0,0,0,1,2,0,0,0,0,0,0,0,0
53,82,23,0,0,0,0,0,0,7,74,0,0,0,0,0,0,0,0
53,83,426,330,831,6494,930,121,2847,202,1269,3190,6579,58602,10073,1080,25380,7325,65181
53,84,1699,2605,5889,32660,5945,941,5077,550,4635,15734,33325,237150,54974,5278,39070,38549,270475
53,85,3,0,0,0,0,0,0,3,12,0,0,0,0,0,0,0,0
53,86,45,28,38,432,146,29,0,22,140,280,231,3422,1432,187,0,470,3653
53,87,9,0,0,0,0,0,0,6,33,0,0,0,0,0,0,0,0
53,88,11,4,18,74,28,3,3,9,35,16,124,605,294,14,30,92,729
53,89,299,199,686,5351,1248,276,769,149,878,1528,4813,44940,13096,2355,6012,6037,49753
53,90,393,427,395,9359,2189,464,2605,47,1118,2537,2827,57128,11577,1929,21239,9754,59955
53,91,15,0,7,140,45,3,0,4,42,0,21,708,194,6,0,147,729
53,95,146,43,1658,3103,225,1493,125,14,301,104,4282,4695,338,1758,433,4761,8977
53,96,7,0,0,0,0,0,0,4,15,0,0,0,0,0,0,0,0
53,97,30,39,425,737,92,147,24,7,69,57,1171,1624,139,331,31,1162,2795
53,100,5,0,0,0,0,0,0,1,10,0,0,0,0,0,0,0,0
53,101,3,3,21,184,25,8,0,3,6,3,35,446,67,14,0,205,481
53,102,3,2,2,395,28,44,3,3,10,4,2,650,44,59,30,397,652
53,107,16,3,25,256,50,36,0,8,42,11,65,832,296,67,0,281,897
53,111,3,0,0,0,0,0,0,1,18,0,0,0,0,0,0,0,0
53,112,2,0,0,0,0,0,0,1,4,0,0,0,0,0,0,0,0
53,113,23,0,0,0,0,0,0,6,50,0,0,0,0,0,0,0,0
53,114,24,0,0,0,0,0,0,14,59,0,0,0,0,0,0,0,0
53,115,55,0,0,0,0,0,0,4,135,0,0,0,0,0,0,0,0
53,116,20,0,0,0,0,0,0,1,40,0,0,0,0,0,0,0,0
53,117,1,0,0,0,0,0,0,1,6,0,0,0,0,0,0,0,0
53,118,17,0,0,0,0,0,0,3,38,0,0,0,0,0,0,0,0
53,119,13,0,0,0,0,0,0,6,27,0,0,0,0,0,0,0,0
53,121,6,0,0,0,0,0,0,2,28,0,0,0,0,0,0,0,0
53,122,2,0,0,0,0,0,0,1,8,0,0,0,0,0,0,0,0
54,77,3,0,0,0,0,0,0,1,6,0,0,0,0,0,0,0,0
54,81,232,179,479,3566,251,175,2073,78,663,1555,3905,31656,2747,1206,18326,4045,35561
54,82,400,331,884,5079,475,156,2999,149,1186,2583,8938,46624,4970,1474,27661,5963,55562
54,83,541,371,886,7648,965,179,1905,162,1442,3160,5545,63275,9810,1013,17141,8534,68820
54,84,141,172,65,1748,699,48,31,44,348,1102,415,14140,6967,337,220,1813,14555
54,85,14,0,0,0,0,0,0,7,32,0,0,0,0,0,0,0,0
54,86,16,61,15,544,166,22,1,8,46,426,43,4075,1645,96,1,559,4118
54,87,26,0,0,0,0,0,0,13,89,0,0,0,0,0,0,0,0
54,88,34,22,25,495,161,26,6,18,95,83,63,3144,1573,108,52,520,3207
54,90,127,142,111,2454,811,66,170,14,383,688,491,11389,3972,173,1016,2565,11880
54,96,8,0,0,0,0,0,0,2,17,0,0,0,0,0,0,0,0
54,102,24,0,0,0,0,0,0,6,48,0,0,0,0,0,0,0,0
54,105,23,15,73,1967,171,203,19,14,68,27,162,3446,343,344,21,2040,3608
54,110,2500,0,0,0,0,0,0,1,5000,0,0,0,0,0,0,0,0
54,114,111,0,0,0,0,0,0,8,326,0,0,0,0,0,0,0,0
54,115,40,0,0,0,0,0,0,5,80,0,0,0,0,0,0,0,0
54,116,51,77,178,785,127,31,19,6,102,90,299,1033,149,34,25,963,1332
54,117,6,0,0,0,0,0,0,3,15,0,0,0,0,0,0,0,0
54,118,6,0,0,0,0,0,0,2,14,0,0,0,0,0,0,0,0
54,119,3,0,0,0,0,0,0,1,6,0,0,0,0,0,0,0,0
54,123,1,0,0,0,0,0,0,1,2,0,0,0,0,0,0,0,0
54,124,17,0,0,0,0,0,0,1,34,0,0,0,0,0,0,0,0
55,80,1,0,0,0,0,0,0,1,4,0,0,0,0,0,0,0,0
55,81,1490,4550,9955,51133,5763,2287,7497,295,3771,20496,40601,234227,31907,7222,52610,61088,274828
55,82,4979,5540,28687,121383,12845,2241,28199,1002,13657,37011,162372,851055,111611,14537,208589,150070,1013427
55,83,11,0,0,0,0,0,0,5,32,0,0,0,0,0,0,0,0
55,84,20,0,0,0,0,0,0,5,44,0,0,0,0,0,0,0,0
55,85,11,0,0,0,0,0,0,3,26,0,0,0,0,0,0,0,0
55,87,13,0,0,68,32,5,4,9,45,0,0,663,401,55,20,68,663
55,88,273,376,1050,8416,2504,280,706,102,739,1993,5925,41426,18478,913,4930,9466,47351
55,89,2244,4573,4453,65111,14449,1970,5123,500,5909,23952,19861,374652,87323,7656,26402,69564,394513
55,90,2,0,0,0,0,0,0,1,4,0,0,0,0,0,0,0,0
55,102,10,0,0,0,0,0,0,4,20,0,0,0,0,0,0,0,0
55,104,4,0,0,0,0,0,0,2,16,0,0,0,0,0,0,0,0
55,108,32,32,132,1975,91,85,5,13,75,50,217,3163,149,270,5,2107,3380
55,109,59,0,0,0,0,0,0,2,119,0,0,0,0,0,0,0,0
55,110,4,0,0,0,0,0,0,1,8,0,0,0,0,0,0,0,0
55,111,2,0,0,0,0,0,0,2,7,0,0,0,0,0,0,0,0
55,114,4,0,0,0,0,0,0,3,10,0,0,0,0,0,0,0,0
55,115,24,0,0,0,0,0,0,7,53,0,0,0,0,0,0,0,0
55,116,276,391,1942,10183,1079,325,182,31,715,477,3912,13520,1682,464,331,12125,17432
55,117,17,0,0,0,0,0,0,4,35,0,0,0,0,0,0,0,0
55,120,15,0,0,0,0,0,0,1,34,0,0,0,0,0,0,0,0
55,121,2,0,0,0,0,0,0,1,4,0,0,0,0,0,0,0,0
55,122,5,0,0,0,0,0,0,1,32,0,0,0,0,0,0,0,0
55,123,4,0,0,0,0,0,0,1,8,0,0,0,0,0,0,0,0
56,80,6,11,24,103,12,10,29,4,18,35,142,801,135,54,195,127,943
56,81,2814,3858,6463,54742,10205,2146,13597,429,8014,28908,47645,418135,89509,15801,100853,61205,465780
56,82,29,4,161,303,61,11,21,11,75,16,1135,2346,692,109,144,464,3481
56,83,69,55,178,688,218,11,17,24,174,372,1273,6215,2411,79,202,866,7488
56,84,18,0,0,0,0,0,0,6,44,0,0,0,0,0,0,0,0
56,85,19,0,0,0,0,0,0,3,36,0,0,0,0,0,0,0,0
56,86,15,0,0,0,0,0,0,6,39,0,0,0,0,0,0,0,0
56,87,208,347,484,5009,1498,154,452,54,592,1603,2119,25331,9836,505,2003,5493,27450
56,88,37,49,35,556,163,4,173,15,85,310,215,4664,1546,34,1362,591,4879
56,89,8,7,0,97,47,0,12,6,22,69,0,954,579,0,94,97,954
56,91,1,0,0,0,0,0,0,1,6,0,0,0,0,0,0,0,0
56,93,2,0,0,0,0,0,0,1,4,0,0,0,0,0,0,0,0
56,102,3,0,0,0,0,0,0,2,6,0,0,0,0,0,0,0,0
56,103,233,638,573,25689,1876,1454,124,67,510,1095,883,38996,3628,2269,174,26262,39879
56,104,57,90,65,5104,528,531,16,25,144,165,107,9496,1160,995,22,5169,9603
56,105,10,29,65,598,63,56,0,4,22,73,111,1270,205,93,0,663,1381
56,107,5,0,0,0,0,0,0,5,11,0,0,0,0,0,0,0,0
56,108,177,273,1409,15699,664,786,96,85,484,471,2134,22665,1174,1218,128,17108,24799
56,114,16,0,95,248,8,41,0,5,47,0,171,295,8,52,0,343,466
56,115,11,0,0,0,0,0,0,2,28,0,0,0,0,0,0,0,0
56,120,105,0,0,0,0,0,0,3,210,0,0,0,0,0,0,0,0
56,121,18,0,0,0,0,0,0,3,36,0,0,0,0,0,0,0,0
56,122,2,0,0,0,0,0,0,1,4,0,0,0,0,0,0,0,0
56,123,37,0,0,0,0,0,0,7,102,0,0,0,0,0,0,0,0
56,124,1,0,0,0,0,0,0,1,2,0,0,0,0,0,0,0,0
56,125,3,0,0,0,0,0,0,2,6,0,0,0,0,0,0,0,0
57,80,95,100,319,1960,243,17,263,35,230,775,2316,16463,2570,185,2156,2279,18779
57,81,810,1579,1144,13190,3439,426,1314,169,2192,12471,8339,102523,30732,2863,9935,14334,110862
57,82,24,33,101,389,122,60,21,5,52,147,227,2118,1142,222,68,490,2345
57,83,6,0,0,0,0,0,0,1,12,0,0,0,0,0,0,0,0
57,85,2,0,0,0,0,0,0,1,3,0,0,0,0,0,0,0,0
57,86,105,113,271,1688,685,23,144,65,314,819,2080,14598,7199,147,1182,1959,16678
57,87,22,28,38,391,97,13,53,17,69,160,233,2434,679,61,406,429,2667
57,88,335,376,539,7166,2612,106,498,155,1005,2834,3429,59354,27613,650,3636,7705,62783
57,89,194,0,0,0,0,0,0,73,567,0,0,0,0,0,0,0,0
57,92,2,0,0,0,0,0,0,1,4,0,0,0,0,0,0,0,0
57,94,32,0,0,0,0,0,0,1,64,0,0,0,0,0,0,0,0
57,96,2,0,0,0,0,0,0,1,4,0,0,0,0,0,0,0,0
57,98,3,0,0,0,0,0,0,1,6,0,0,0,0,0,0,0,0
57,101,12,0,0,0,0,0,0,4,29,0,0,0,0,0,0,0,0
57,102,780,4332,5503,145907,9057,8615,1070,120,1758,7098,7964,190629,15580,12536,1218,151410,198593
57,103,14,31,18,1612,149,148,10,4,32,65,22,2585,269,220,13,1630,2607
57,104,1024,999,1023,33784,2717,2810,204,141,2832,1782,1880,53718,5396,4766,285,34807,55598
57,105,520,2291,1780,62379,11042,5439,340,92,1307,4025,2549,107806,21512,9552,517,64159,110355
57,106,73,209,350,8468,707,766,58,22,188,347,644,13235,1366,1257,91,8818,13879
57,107,2,0,0,0,0,0,0,1,2,0,0,0,0,0,0,0,0
57,108,2,0,0,0,0,0,0,1,4,0,0,0,0,0,0,0,0
57,113,16,0,0,0,0,0,0,2,40,0,0,0,0,0,0,0,0
57,120,3,0,0,0,0,0,0,1,8,0,0,0,0,0,0,0,0
57,121,2,0,0,0,0,0,0,1,4,0,0,0,0,0,0,0,0
57,122,13,0,0,0,0,0,0,5,27,0,0,0,0,0,0,0,0
57,123,74,0,0,0,0,0,0,18,170,0,0,0,0,0,0,0,0
57,125,67,0,0,0,0,0,0,3,124,0,0,0,0,0,0,0,0
58,78,18,4,48,53,11,8,7,5,51,60,395,570,152,96,77,101,965
58,79,3291,6375,10864,65007,14428,4744,13766,782,9447,52584,71232,531970,149011,33735,110050,75871,603202
58,80,49,42,20,762,248,44,45,5,153,260,148,4745,1888,218,190,782,4893
58,81,4,0,0,0,0,0,0,1,8,0,0,0,0,0,0,0,0
58,82,1,0,0,0,0,0,0,1,4,0,0,0,0,0,0,0,0
58,83,8,0,0,0,0,0,0,3,16,0,0,0,0,0,0,0,0
58,84,10,0,0,0,0,0,0,3,19,0,0,0,0,0,0,0,0
58,86,260,207,934,3903,788,60,563,135,771,1429,6165,29578,7189,444,4244,4837,35743
58,87,275,305,673,5630,1524,62,1287,154,990,2081,4129,44425,15054,380,10144,6303,48554
58,91,12,0,0,0,0,0,0,2,53,0,0,0,0,0,0,0,0
58,92,12,0,0,0,0,0,0,6,32,0,0,0,0,0,0,0,0
58,98,2,0,0,0,0,0,0,1,5,0,0,0,0,0,0,0,0
58,99,3,0,0,0,0,0,0,2,9,0,0,0,0,0,0,0,0
58,100,680,465,562,20451,1532,2299,194,140,1700,813,902,32105,2833,3800,231,21013,33007
58,101,14,0,0,0,0,0,0,3,28,0,0,0,0,0,0,0,0
58,103,70,0,0,0,0,0,0,14,234,0,0,0,0,0,0,0,0
58,104,5,0,0,0,0,0,0,2,10,0,0,0,0,0,0,0,0
58,105,7,0,0,0,0,0,0,4,20,0,0,0,0,0,0,0,0
58,106,3,0,0,0,0,0,0,2,13,0,0,0,0,0,0,0,0
58,119,31,0,0,0,0,0,0,15,90,0,0,0,0,0,0,0,0
58,122,6,0,0,0,0,0,0,1,10,0,0,0,0,0,0,0,0
58,123,99,0,0,0,0,0,0,8,237,0,0,0,0,0,0,0,0
58,124,27,0,0,0,0,0,0,2,59,0,0,0,0,0,0,0,0
58,125,11,0,0,0,0,0,0,4,21,0,0,0,0,0,0,0,0
58,127,1,0,0,0,0,0,0,1,2,0,0,0,0,0,0,0,0
59,76,47,53,191,563,63,32,273,27,125,477,1474,5151,799,191,2578,754,6625
59,78,554,807,1154,8355,1639,639,1223,201,1462,7448,9044,72550,18138,6233,9418,9509,81594
59,79,3073,3140,8845,44627,6709,1455,8195,732,8570,23049,62087,305051,64426,8996,60352,53472,367138
59,80,6,0,0,0,0,0,0,4,14,0,0,0,0,0,0,0,0
59,81,13,0,0,0,0,0,0,6,34,0,0,0,0,0,0,0,0
59,82,7,0,0,0,0,0,0,2,14,0,0,0,0,0,0,0,0
59,83,13,0,0,0,0,0,0,4,26,0,0,0,0,0,0,0,0
59,84,9,0,0,0,0,0,0,3,19,0,0,0,0,0,0,0,0
59,85,1,0,0,0,0,0,0,1,4,0,0,0,0,0,0,0,0
59,87,5,0,0,0,0,0,0,1,10,0,0,0,0,0,0,0,0
59,88,6,0,0,0,0,0,0,3,13,0,0,0,0,0,0,0,0
59,91,8,0,0,0,0,0,0,2,24,0,0,0,0,0,0,0,0
59,95,5,0,0,0,0,0,0,2,10,0,0,0,0,0,0,0,0
59,99,8,0,0,0,0,0,0,1,17,0,0,0,0,0,0,0,0
59,105,1,0,0,0,0,0,0,1,2,0,0,0,0,0,0,0,0
59,119,10,0,0,0,0,0,0,3,22,0,0,0,0,0,0,0,0
59,120,3,0,0,0,0,0,0,2,10,0,0,0,0,0,0,0,0
59,121,2,0,0,0,0,0,0,1,6,0,0,0,0,0,0,0,0
59,122,118,0,0,0,0,0,0,4,308,0,0,0,0,0,0,0,0
59,123,293,0,0,0,0,0,0,16,575,0,0,0,0,0,0,0,0
59,124,52,90,632,2020,112,556,61,13,114,195,898,2927,233,651,76,2652,3825
59,127,5,0,0,0,0,0,0,2,12,0,0,0,0,0,0,0,0
60,76,76,126,195,955,114,106,233,38,212,1000,1410,7584,1048,841,1804,1150,8994
60,78,1026,1655,3164,19777,2693,472,1528,408,2864,10860,20713,154700,25795,3439,11655,22941,175413
60,79,4,0,0,0,0,0,0,1,7,0,0,0,0,0,0,0,0
60,80,6,0,0,0,0,0,0,3,16,0,0,0,0,0,0,0,0
60,81,7,0,0,0,0,0,0,2,13,0,0,0,0,0,0,0,0
60,83,3,0,0,0,0,0,0,1,7,0,0,0,0,0,0,0,0
60,88,21,0,0,0,0,0,0,3,64,0,0,0,0,0,0,0,0
60,90,4,0,0,0,0,0,0,2,8,0,0,0,0,0,0,0,0
60,94,3,0,0,0,0,0,0,1,6,0,0,0,0,0,0,0,0
60,99,2,0,0,0,0,0,0,1,4,0,0,0,0,0,0,0,0
60,112,3,0,0,0,0,0,0,1,6,0,0,0,0,0,0,0,0
60,122,7,0,0,0,0,0,0,2,18,0,0,0,0,0,0,0,0
60,123,607,179,3182,5805,405,257,471,63,1287,378,6246,12530,901,585,864,8987,18776
60,124,222,310,2481,12461,819,602,309,108,563,687,6456,29865,2059,1617,563,14942,36321
60,126,59,0,0,0,0,0,0,2,111,0,0,0,0,0,0,0,0
60,127,305,0,0,0,0,0,0,10,533,0,0,0,0,0,0,0,0
61,77,196,143,758,1301,217,83,177,75,560,1170,6700,11184,1938,914,1384,2059,17884
61,78,6596,12384,38598,179752,20834,3971,17246,1842,16843,67235,156537,1051892,158859,18718,102222,218350,1208429
61,79,4,0,0,0,0,0,0,4,11,0,0,0,0,0,0,0,0
61,80,1,0,0,0,0,0,0,1,6,0,0,0,0,0,0,0,0
61,81,12,0,0,0,0,0,0,7,38,0,0,0,0,0,0,0,0
61,88,1,0,0,0,0,0,0,1,4,0,0,0,0,0,0,0,0
61,90,25,7,119,373,41,76,16,11,61,13,484,748,80,266,20,492,1232
61,91,1,0,0,0,0,0,0,1,4,0,0,0,0,0,0,0,0
61,92,4,0,0,0,0,0,0,1,13,0,0,0,0,0,0,0,0
61,112,176,98,9627,7729,115,141,928,23,294,249,36577,13121,448,399,2473,17356,49698
61,115,2,0,0,0,0,0,0,1,4,0,0,0,0,0,0,0,0
61,116,1,0,0,0,0,0,0,1,1,0,0,0,0,0,0,0,0
61,117,1,0,0,0,0,0,0,1,2,0,0,0,0,0,0,0,0
61,120,2,0,0,0,0,0,0,1,3,0,0,0,0,0,0,0,0
61,122,224,0,0,0,0,0,0,9,435,0,0,0,0,0,0,0,0
61,123,148,675,4565,12511,823,527,601,61,330,1128,7926,24383,1495,943,927,17076,32309
61,124,9269,26346,141141,829377,48697,48158,19941,1645,19170,43369,251666,1489993,92765,94157,32101,970518,1741659
61,125,45,0,0,0,0,0,0,8,91,0,0,0,0,0,0,0,0
61,127,15,0,0,0,0,0,0,3,28,0,0,0,0,0,0,0,0
62,77,344,194,957,9087,1065,281,266,80,963,1439,6103,42030,6985,1459,1901,10044,48133
62,78,46,0,7,84,13,10,4,7,82,0,36,317,33,15,4,91,353
62,79,202,247,471,3824,1188,133,205,100,547,2006,2752,26592,11947,601,1495,4295,29344
62,80,3,0,0,0,0,0,0,2,10,0,0,0,0,0,0,0,0
62,92,2,0,0,0,0,0,0,1,6,0,0,0,0,0,0,0,0
62,96,1,0,0,0,0,0,0,1,2,0,0,0,0,0,0,0,0
62,112,3,0,0,0,0,0,0,1,7,0,0,0,0,0,0,0,0
62,116,1,0,0,0,0,0,0,1,4,0,0,0,0,0,0,0,0
62,118,4,0,0,0,0,0,0,1,8,0,0,0,0,0,0,0,0
62,119,6,0,0,0,0,0,0,2,11,0,0,0,0,0,0,0,0
62,121,5,0,0,0,0,0,0,1,9,0,0,0,0,0,0,0,0
62,122,216,122,2149,9710,421,230,287,39,413,143,2845,13279,576,299,486,11859,16124
62,123,4,0,0,0,0,0,0,1,8,0,0,0,0,0,0,0,0
62,124,26,0,0,0,0,0,0,10,61,0,0,0,0,0,0,0,0
62,125,29,0,0,0,0,0,0,3,234,0,0,0,0,0,0,0,0
63,74,450,30,52,769,107,29,9,49,1036,197,380,5649,922,204,63,821,6029
63,75,516,663,499,12202,1582,370,475,180,1501,4911,2838,94361,14681,2820,3327,12701,97199
63,76,908,890,2626,19768,2757,594,1440,402,2496,6368,13400,147477,26071,4056,10155,22394,160877
63,77,150,121,399,3043,413,224,137,67,382,587,1907,14971,2886,929,592,3442,16878
63,78,3857,13266,34626,185167,29038,7670,6649,707,9508,70544,101927,897539,187995,28804,32128,219793,999466
63,79,313,953,2106,15569,2281,846,475,111,827,2270,6614,38784,8156,1940,1757,17675,45398
63,80,79,149,142,4087,658,378,88,27,211,241,235,6748,1164,574,144,4229,6983
63,82,6,0,0,0,0,0,0,2,16,0,0,0,0,0,0,0,0
63,96,13,0,0,0,0,0,0,4,34,0,0,0,0,0,0,0,0
63,113,8,0,0,0,0,0,0,1,16,0,0,0,0,0,0,0,0
63,116,3,0,0,0,0,0,0,1,6,0,0,0,0,0,0,0,0
63,121,13,0,0,0,0,0,0,2,27,0,0,0,0,0,0,0,0
63,124,232,947,4857,7203,674,680,228,14,446,1717,7807,11757,1423,1298,342,12060,19564
63,125,49,0,0,0,0,0,0,7,85,0,0,0,0,0,0,0,0
64,72,37,0,0,0,0,0,0,14,92,0,0,0,0,0,0,0,0
64,73,1871,2314,3325,44569,4475,794,2265,739,5621,15187,22763,346220,39748,5122,17862,47894,368983
64,74,1807,4555,2939,54084,9766,1787,3886,517,5403,30742,18667,373609,70735,9267,31850,57023,392276
64,75,982,869,1669,19065,2116,437,2386,393,2904,7808,13517,160251,22454,3385,22247,20734,173768
64,76,670,440,1124,13513,1932,398,1043,278,1933,3380,8233,107857,19013,2858,8526,14637,116090
64,77,1,0,0,0,0,0,0,1,4,0,0,0,0,0,0,0,0
64,78,12,54,30,409,192,13,0,12,60,434,209,3825,2025,65,0,439,4034
64,79,133,446,1061,18548,2331,619,120,36,316,731,1720,28948,5307,979,265,19609,30668
64,80,2,0,0,0,0,0,0,2,8,0,0,0,0,0,0,0,0
64,81,29,0,0,0,0,0,0,8,61,0,0,0,0,0,0,0,0
64,82,3,0,0,0,0,0,0,3,17,0,0,0,0,0,0,0,0
64,122,9,1,12,48,1,5,4,4,21,1,22,71,4,5,5,60,93
64,126,1,0,0,0,0,0,0,1,2,0,0,0,0,0,0,0,0
65,72,198,181,242,4246,584,79,294,91,613,1458,1828,38174,6009,724,2622,4488,40002
65,73,874,921,854,20332,3087,214,1095,355,2706,7845,6112,174037,32735,1615,9402,21186,180149
65,74,6,0,0,0,0,0,0,4,24,0,0,0,0,0,0,0,0
65,75,4,0,0,0,0,0,0,2,8,0,0,0,0,0,0,0,0
65,76,8,0,39,93,5,4,0,5,21,0,259,573,21,36,0,132,832
65,77,1,0,0,0,0,0,0,1,6,0,0,0,0,0,0,0,0
65,78,10,0,0,0,0,0,0,1,20,0,0,0,0,0,0,0,0
65,79,15,0,0,0,0,0,0,9,47,0,0,0,0,0,0,0,0
65,80,19,14,55,312,75,28,0,7,58,36,69,942,319,85,0,367,1011
65,81,4,0,0,0,0,0,0,2,10,0,0,0,0,0,0,0,0
65,83,9,7,0,114,16,4,9,6,30,20,0,654,78,18,46,114,654
65,94,2,0,0,0,0,0,0,1,4,0,0,0,0,0,0,0,0
65,117,3,0,0,0,0,0,0,2,6,0,0,0,0,0,0,0,0
65,119,1,0,0,0,0,0,0,1,5,0,0,0,0,0,0,0,0
65,124,45,0,0,0,0,0,0,4,101,0,0,0,0,0,0,0,0
65,127,2,0,0,0,0,0,0,1,3,0,0,0,0,0,0,0,0
66,61,7,2,11,71,6,8,24,6,24,18,55,722,52,33,437,82,777
66,71,62,130,117,1043,147,27,130,30,161,1200,1003,9296,1317,277,1109,1160,10299
66,72,17,53,12,322,95,4,25,11,65,455,90,2966,932,56,270,334,3056
66,73,526,521,279,11127,1366,127,728,235,1647,4210,2040,98907,14490,1122,7060,11406,100947
66,75,8,0,0,0,0,0,0,3,22,0,0,0,0,0,0,0,0
66,76,4,0,0,0,0,0,0,2,10,0,0,0,0,0,0,0,0
66,77,4,0,0,0,0,0,0,1,8,0,0,0,0,0,0,0,0
66,79,1,0,0,0,0,0,0,1,6,0,0,0,0,0,0,0,0
66,80,1,0,0,0,0,0,0,1,4,0,0,0,0,0,0,0,0
66,81,11,0,0,0,0,0,0,5,26,0,0,0,0,0,0,0,0
66,83,1,0,0,0,0,0,0,1,6,0,0,0,0,0,0,0,0
66,116,38,30,290,234,26,41,46,11,85,45,624,518,52,110,111,524,1142
67,63,642,404,5577,11630,756,445,1764,189,1790,3195,30950,75363,5323,2895,12855,17207,106313
67,71,14,0,0,0,0,0,0,6,34,0,0,0,0,0,0,0,0
67,72,491,561,301,10323,2191,169,615,232,1552,4695,2206,92806,24189,1490,5471,10624,95012
67,73,840,380,844,15959,2062,267,725,340,2426,2971,5730,130464,20476,1915,5608,16803,136194
67,74,5,0,0,0,0,0,0,3,14,0,0,0,0,0,0,0,0
67,75,2,0,0,0,0,0,0,2,5,0,0,0,0,0,0,0,0
67,76,2,0,0,0,0,0,0,1,8,0,0,0,0,0,0,0,0
67,77,1,0,0,0,0,0,0,1,2,0,0,0,0,0,0,0,0
67,78,9,0,0,0,0,0,0,3,22,0,0,0,0,0,0,0,0
67,79,2,0,0,0,0,0,0,1,4,0,0,0,0,0,0,0,0
67,80,1,0,0,0,0,0,0,1,4,0,0,0,0,0,0,0,0
67,81,30,16,156,251,26,31,4,11,69,39,402,1060,135,138,6,407,1462
67,85,32,0,0,0,0,0,0,5,69,0,0,0,0,0,0,0,0
67,115,2,0,0,0,0,0,0,1,4,0,0,0,0,0,0,0,0
67,117,108,0,0,0,0,0,0,12,215,0,0,0,0,0,0,0,0
67,119,3,0,0,0,0,0,0,2,10,0,0,0,0,0,0,0,0
67,122,96,0,0,0,0,0,0,4,205,0,0,0,0,0,0,0,0
67,126,74,0,0,0,0,0,0,2,128,0,0,0,0,0,0,0,0
68,62,28,0,0,0,0,0,0,14,71,0,0,0,0,0,0,0,0
68,63,8,0,0,0,0,0,0,6,20,0,0,0,0,0,0,0,0
68,70,22,37,22,296,41,5,68,11,53,313,162,3025,418,35,679,318,3187
68,71,126,224,354,2801,453,81,245,59,376,2028,2947,20924,4022,654,2222,3155,23871
68,73,3357,4576,18508,144173,21405,3930,5222,660,9008,30721,63891,750911,165088,17018,33244,162681,814802
68,74,6,0,0,0,0,0,0,3,15,0,0,0,0,0,0,0,0
68,75,12,0,0,0,0,0,0,4,26,0,0,0,0,0,0,0,0
68,76,7,12,0,78,17,0,0,5,27,98,0,679,146,0,0,78,679
68,79,1,0,0,0,0,0,0,1,6,0,0,0,0,0,0,0,0
68,80,3,0,0,0,0,0,0,2,11,0,0,0,0,0,0,0,0
68,85,8,0,0,0,0,0,0,2,14,0,0,0,0,0,0,0,0
68,86,30,0,0,0,0,0,0,1,46,0,0,0,0,0,0,0,0
68,118,3,0,0,0,0,0,0,1,6,0,0,0,0,0,0,0,0
68,123,3,0,0,0,0,0,0,1,5,0,0,0,0,0,0,0,0
69,62,234,172,677,3764,315,398,711,117,687,1415,5469,29997,2581,3179,7734,4441,35466
69,63,619,232,5712,15010,679,717,2050,245,1522,1544,27026,74116,3641,3901,13603,20722,101142
69,70,1,0,0,0,0,0,0,1,2,0,0,0,0,0,0,0,0
69,71,41,30,83,655,148,34,92,29,129,238,543,6169,1545,482,885,738,6712
69,73,5224,5465,6668,168009,23222,5438,4372,2108,15154,31387,32833,940389,171192,20369,29835,174677,973222
69,74,49,17,16,659,184,5,7,31,183,140,113,5549,1958,26,47,675,5662
69,80,2,0,0,0,0,0,0,1,4,0,0,0,0,0,0,0,0
69,117,1,0,0,0,0,0,0,1,2,0,0,0,0,0,0,0,0
69,121,6,0,0,0,0,0,0,1,12,0,0,0,0,0,0,0,0
69,122,10,0,0,0,0,0,0,1,22,0,0,0,0,0,0,0,0
69,123,1,0,0,0,0,0,0,1,2,0,0,0,0,0,0,0,0
70,63,126,91,298,1909,154,123,445,44,377,853,3377,17164,1408,1314,4926,2207,20541
70,70,245,110,826,3056,248,134,651,91,726,844,7144,27255,2659,1250,6850,3882,34399
70,71,199,184,955,2952,453,110,432,81,739,1462,6154,25200,4605,1030,4184,3907,31354
70,73,1325,1186,1686,44416,4597,744,1988,486,3913,8111,7702,261309,37500,3191,15032,46102,269011
70,74,1449,920,2791,39481,4649,861,2596,604,4291,6408,12395,249080,40004,3143,18808,42272,261475
70,75,15,0,9,167,31,0,1,9,52,0,45,1130,317,0,6,176,1175
70,76,5,0,0,0,0,0,0,2,14,0,0,0,0,0,0,0,0
70,84,3,0,0,0,0,0,0,3,15,0,0,0,0,0,0,0,0
70,111,35,0,0,0,0,0,0,5,70,0,0,0,0,0,0,0,0
70,120,2,0,0,0,0,0,0,1,4,0,0,0,0,0,0,0,0
70,127,1,0,0,0,0,0,0,1,3,0,0,0,0,0,0,0,0
71,48,2,0,0,0,0,0,0,1,4,0,0,0,0,0,0,0,0
71,69,2,0,0,0,0,0,0,2,9,0,0,0,0,0,0,0,0
71,70,274,238,525,4279,663,131,978,124,806,2131,3906,37507,6427,1133,9198,4804,41413
71,73,107,67,57,2693,248,3,177,49,341,597,419,21975,2426,11,1541,2750,22394
71,74,961,1281,3610,31801,3522,957,857,507,2941,5980,10906,170413,26555,4010,4637,35411,181319
71,75,4,0,0,0,0,0,0,2,12,0,0,0,0,0,0,0,0
71,76,2,0,0,0,0,0,0,1,4,0,0,0,0,0,0,0,0
71,77,7,0,0,84,24,0,0,4,20,0,0,776,239,0,0,84,776
71,82,4,0,0,0,0,0,0,2,18,0,0,0,0,0,0,0,0
71,84,6,0,0,0,0,0,0,2,12,0,0,0,0,0,0,0,0
71,115,3,0,0,0,0,0,0,1,6,0,0,0,0,0,0,0,0
71,118,17,0,0,0,0,0,0,1,36,0,0,0,0,0,0,0,0
71,119,5,0,0,0,0,0,0,1,10,0,0,0,0,0,0,0,0
71,120,17,0,0,0,0,0,0,1,33,0,0,0,0,0,0,0,0
71,123,16,0,0,0,0,0,0,5,33,0,0,0,0,0,0,0,0
71,125,2,0,0,0,0,0,0,1,4,0,0,0,0,0,0,0,0
72,66,88,40,61,2832,130,98,21,27,237,256,395,12301,866,597,135,2893,12696
72,69,553,813,1187,13175,1341,458,1170,177,1513,5467,6743,94859,12537,2765,9028,14362,101602
72,70,23,145,0,198,7,0,3,12,49,1626,0,2103,74,0,19,198,2103
72,73,7196,5916,44415,532502,27030,17988,4307,3917,17855,16343,87769,1434485,89010,45649,10094,576917,1522254
72,74,649,325,8934,52420,1965,1450,712,329,1779,1285,17247,123550,11334,4412,1766,61354,140797
72,75,10,0,0,0,0,0,0,5,27,0,0,0,0,0,0,0,0
72,76,7,0,0,0,0,0,0,3,17,0,0,0,0,0,0,0,0
72,78,1,0,0,0,0,0,0,1,4,0,0,0,0,0,0,0,0
72,82,8,0,0,0,0,0,0,3,16,0,0,0,0,0,0,0,0
72,115,4,0,0,0,0,0,0,2,12,0,0,0,0,0,0,0,0
72,116,19,113,65,700,151,64,49,5,53,223,116,1255,314,97,111,765,1371
72,118,3,0,0,0,0,0,0,1,6,0,0,0,0,0,0,0,0
72,119,7,0,0,0,0,0,0,1,18,0,0,0,0,0,0,0,0
73,66,3612,2965,6853,180855,7290,6924,4462,823,8632,16914,23198,624285,41454,33084,32100,187708,647483
73,69,10,0,0,0,0,0,0,4,24,0,0,0,0,0,0,0,0
73,70,86,62,38,849,115,47,66,43,254,568,343,6447,1013,311,483,887,6790
73,71,668,872,1154,12839,1041,322,945,257,1871,6406,8137,103645,9900,2534,9541,13993,111782
73,73,1522,2232,2115,62204,12377,3395,1520,608,4264,11158,7389,288425,64584,10739,7220,64319,295814
73,74,196,109,354,4690,618,202,55,145,618,734,1477,27903,5077,870,184,5044,29380
73,75,33,27,8,516,104,15,2,19,111,164,36,4128,993,72,7,524,4164
73,77,5,0,0,0,0,0,0,3,16,0,0,0,0,0,0,0,0
73,78,2,0,0,0,0,0,0,2,7,0,0,0,0,0,0,0,0
73,79,3,0,0,0,0,0,0,1,10,0,0,0,0,0,0,0,0
73,81,1,0,0,0,0,0,0,1,6,0,0,0,0,0,0,0,0
73,115,22,0,0,0,0,0,0,5,53,0,0,0,0,0,0,0,0
73,118,4,0,0,0,0,0,0,1,8,0,0,0,0,0,0,0,0
73,121,20,0,0,0,0,0,0,1,40,0,0,0,0,0,0,0,0
73,123,2,0,0,0,0,0,0,1,4,0,0,0,0,0,0,0,0
73,125,4,0,0,0,0,0,0,1,8,0,0,0,0,0,0,0,0
73,127,15,0,0,0,0,0,0,1,23,0,0,0,0,0,0,0,0
74,66,29,0,0,0,0,0,0,15,77,0,0,0,0,0,0,0,0
74,68,28,16,23,512,80,26,61,15,79,138,167,4366,878,192,549,535,4533
74,70,39,34,51,554,115,38,0,23,125,248,283,4199,1182,239,0,605,4482
74,71,2122,2545,6373,71003,9209,1696,5065,520,5571,15738,28808,514817,78191,10015,35103,77376,543625
74,73,2763,3095,10424,112694,9439,2118,2279,830,7137,15875,26845,570046,61296,9159,11317,123118,596891
74,74,95,38,88,1980,321,67,19,62,308,251,597,13852,3127,315,187,2068,14449
74,75,208,0,0,0,0,0,0,13,445,0,0,0,0,0,0,0,0
74,76,42,15,0,231,33,0,8,14,116,171,0,2045,349,0,9,231,2045
74,77,9,0,29,128,53,0,0,3,18,0,48,1175,511,0,0,157,1223
74,79,3,0,0,0,0,0,0,3,17,0,0,0,0,0,0,0,0
74,112,5,0,0,0,0,0,0,1,15,0,0,0,0,0,0,0,0
74,114,1,0,0,0,0,0,0,1,2,0,0,0,0,0,0,0,0
74,117,61,0,0,0,0,0,0,5,127,0,0,0,0,0,0,0,0
74,119,4,0,0,0,0,0,0,1,9,0,0,0,0,0,0,0,0
74,126,16,0,0,0,0,0,0,2,32,0,0,0,0,0,0,0,0
74,127,162,100,1797,1347,203,137,121,15,497,172,3244,3351,505,311,230,3144,6595
75,57,2,0,0,0,0,0,0,1,4,0,0,0,0,0,0,0,0
75,65,231,373,164,5649,1087,118,628,57,642,2807,1395,44634,8052,713,6017,5813,46029
75,66,1103,445,5646,28464,1380,1413,2612,242,2682,3283,31916,170062,10605,8168,18214,34110,201978
75,67,28,14,20,631,98,39,10,16,89,103,109,4672,872,286,64,651,4781
75,68,41,37,22,611,73,35,78,13,107,253,238,4452,659,227,559,633,4690
75,70,60,15,53,755,87,68,14,23,153,67,245,4008,693,382,99,808,4253
75,71,825,774,2483,18801,2833,803,1561,353,2360,6676,16129,143952,28165,5870,13857,21284,160081
75,72,772,483,506,14338,1609,276,398,333,2265,3453,3418,105903,14872,1743,2972,14844,109321
75,73,46,63,14,1158,409,5,1,33,186,565,72,10030,4251,18,14,1172,10102
75,74,13,11,0,259,89,0,0,7,42,77,0,2239,964,0,0,259,2239
75,75,3,0,0,0,0,0,0,3,18,0,0,0,0,0,0,0,0
75,76,11,3,2,99,19,0,0,5,34,15,18,879,187,0,0,101,897
75,77,8,0,0,0,0,0,0,2,15,0,0,0,0,0,0,0,0
75,78,89,69,3821,6930,843,117,128,15,162,124,7068,7785,961,288,268,10751,14853
75,79,12,0,0,0,0,0,0,4,25,0,0,0,0,0,0,0,0
75,80,11,0,0,0,0,0,0,3,26,0,0,0,0,0,0,0,0
75,114,10,0,0,0,0,0,0,3,26,0,0,0,0,0,0,0,0
75,127,24,0,0,0,0,0,0,5,52,0,0,0,0,0,0,0,0
76,65,292,104,230,6281,261,102,1000,83,908,990,1982,57942,2943,775,10396,6511,59924
76,66,751,1035,1738,17370,2290,831,2974,156,1951,9727,14250,135154,25163,6023,23822,19108,149404
76,67,138,92,84,1921,277,73,299,52,393,835,810,18234,3209,641,3384,2005,19044
76,68,2889,10452,6739,94900,11372,5651,4027,572,7129,75136,30117,589316,86204,30907,30087,101639,619433
76,70,15,41,17,255,61,26,0,6,40,403,77,2187,638,236,0,272,2264
76,72,3588,4160,5177,99980,15070,1469,4369,954,9914,23770,20062,608217,110829,6109,24212,105157,628279
76,73,64,63,10,1553,492,13,14,39,218,523,14,14120,5294,70,98,1563,14134
76,75,11,0,0,0,0,0,0,3,25,0,0,0,0,0,0,0,0
76,76,69,17,12,162,81,0,0,15,146,98,48,1472,887,0,0,174,1520
76,77,4,0,0,0,0,0,0,2,8,0,0,0,0,0,0,0,0
76,113,12,0,0,0,0,0,0,1,27,0,0,0,0,0,0,0,0
76,116,2,0,0,0,0,0,0,1,3,0,0,0,0,0,0,0,0
76,120,45,0,0,0,0,0,0,2,58,0,0,0,0,0,0,0,0
77,61,46,64,36,580,111,12,104,23,122,757,387,5947,1439,112,1152,616,6334
77,62,955,963,3440,23659,2683,1006,2228,266,2264,7852,13063,139920,23161,5301,16917,27099,152983
77,64,4,0,0,0,0,0,0,1,8,0,0,0,0,0,0,0,0
77,65,325,450,241,6156,1054,287,1220,96,925,3917,1906,50214,9513,1975,12453,6397,52120
77,66,1478,1362,4028,35171,3936,1846,4663,267,3748,10240,24056,232906,30959,11414,37849,39199,256962
77,69,8,18,12,326,56,22,0,3,17,104,44,1779,483,119,0,338,1823
77,70,183,81,491,2848,378,181,299,101,514,608,3910,20890,3838,1107,2571,3339,24800
77,72,1141,682,524,21869,2469,186,541,339,3206,4916,2788,159529,22133,1134,3977,22393,162317
77,73,29,16,2,463,194,12,1,22,112,184,4,4620,2277,102,1,465,4624
77,74,4,0,0,0,0,0,0,4,18,0,0,0,0,0,0,0,0
77,75,8,0,0,0,0,0,0,3,24,0,0,0,0,0,0,0,0
77,76,19,0,0,0,0,0,0,2,44,0,0,0,0,0,0,0,0
77,77,23,0,0,0,0,0,0,6,58,0,0,0,0,0,0,0,0
77,115,7,0,0,0,0,0,0,2,18,0,0,0,0,0,0,0,0
77,126,8,0,0,0,0,0,0,1,15,0,0,0,0,0,0,0,0
78,61,12,0,0,0,0,0,0,4,28,0,0,0,0,0,0,0,0
78,62,7,0,0,0,0,0,0,3,17,0,0,0,0,0,0,0,0
78,66,7,0,0,0,0,0,0,3,16,0,0,0,0,0,0,0,0
78,70,5,0,0,0,0,0,0,2,10,0,0,0,0,0,0,0,0
78,71,33,20,2,609,55,0,1,9,106,205,14,5371,560,0,14,611,5385
78,72,1456,1034,1152,31842,5190,350,1796,346,3776,7356,7320,233658,43984,2211,11918,32994,240978
78,73,12,0,5,131,38,0,0,4,30,0,10,1175,422,0,0,136,1185
78,75,1,0,0,0,0,0,0,1,6,0,0,0,0,0,0,0,0
78,76,2,0,0,0,0,0,0,1,6,0,0,0,0,0,0,0,0
78,125,8,0,0,0,0,0,0,2,52,0,0,0,0,0,0,0,0
78,127,2,0,0,0,0,0,0,2,4,0,0,0,0,0,0,0,0
79,60,11,0,0,0,0,0,0,6,47,0,0,0,0,0,0,0,0
79,61,42,30,47,778,40,21,217,15,137,157,438,7392,346,174,2500,825,7830
79,62,839,1107,1009,15696,2639,641,2162,320,2504,10687,7827,147678,30100,5689,22705,16705,155505
79,66,5,0,0,0,0,0,0,3,24,0,0,0,0,0,0,0,0
79,69,409,441,290,7915,902,341,360,166,1148,4251,2186,63790,8336,2389,2963,8205,65976
79,70,193,84,291,3308,379,108,299,87,563,660,2203,29617,3802,904,2851,3599,31820
79,71,100,123,37,2445,209,34,90,39,303,896,232,19503,2030,247,725,2482,19735
79,72,488,370,174,8971,1287,88,150,176,1428,2965,1009,71777,11983,749,1216,9145,72786
79,73,13,0,0,0,0,0,0,9,51,0,0,0,0,0,0,0,0
79,74,5,0,0,0,0,0,0,2,12,0,0,0,0,0,0,0,0
79,77,4,0,0,0,0,0,0,1,9,0,0,0,0,0,0,0,0
79,122,3,0,0,0,0,0,0,1,7,0,0,0,0,0,0,0,0
79,123,25,0,0,0,0,0,0,1,43,0,0,0,0,0,0,0,0
80,57,159,45,173,760,83,63,191,27,355,425,1163,6436,761,615,1960,933,7599
80,58,102,28,282,895,42,125,125,33,239,223,1527,6971,299,1148,1183,1177,8498
80,61,234,414,720,6971,1377,394,624,83,630,3191,3987,44078,11293,2833,5631,7691,48065
80,65,1,0,0,0,0,0,0,1,4,0,0,0,0,0,0,0,0
80,66,91,72,71,1337,127,68,427,27,239,704,583,11839,1125,636,4194,1408,12422
80,71,5980,5505,11022,170868,22069,1858,6848,1010,14641,34326,51389,1161114,146984,9296,48943,181890,1212503
80,72,20,15,9,386,113,15,6,10,62,88,37,2932,846,90,36,395,2969
80,73,10,0,0,0,0,0,0,7,34,0,0,0,0,0,0,0,0
80,74,19,0,0,0,0,0,0,10,63,0,0,0,0,0,0,0,0
80,75,5,0,0,0,0,0,0,3,17,0,0,0,0,0,0,0,0
80,76,7,0,0,0,0,0,0,2,14,0,0,0,0,0,0,0,0
80,115,8,0,0,0,0,0,0,1,16,0,0,0,0,0,0,0,0
80,116,13,0,0,0,0,0,0,4,28,0,0,0,0,0,0,0,0
80,117,17,0,0,0,0,0,0,3,41,0,0,0,0,0,0,0,0
80,121,223,200,8817,2544,241,126,464,11,407,396,39253,7321,661,281,1633,11361,46574
81,57,60,44,212,723,55,125,224,14,182,412,1704,6266,503,954,2315,935,7970
81,58,50,37,281,712,72,53,137,21,114,271,1552,4222,423,263,1024,993,5774
81,61,172,120,159,3053,428,156,233,71,554,998,1377,25285,4438,1198,2171,3212,26662
81,62,5,0,0,0,0,0,0,2,11,0,0,0,0,0,0,0,0
81,65,235,133,135,4321,302,125,479,87,659,1200,1117,35890,2824,631,4718,4456,37007
81,66,10,0,0,0,0,0,0,5,35,0,0,0,0,0,0,0,0
81,70,1278,541,1379,28870,1962,231,983,355,3162,3688,9790,213840,17367,1512,7918,30249,223630
81,71,1155,931,1713,35324,4001,329,1084,261,2708,5571,8633,245665,33555,1977,7664,37037,254298
81,72,8,0,0,0,0,0,0,3,20,0,0,0,0,0,0,0,0
81,74,1,0,0,0,0,0,0,1,6,0,0,0,0,0,0,0,0
81,113,9,0,0,0,0,0,0,1,15,0,0,0,0,0,0,0,0
81,117,12,0,0,0,0,0,0,1,40,0,0,0,0,0,0,0,0
81,119,9,0,0,0,0,0,0,1,22,0,0,0,0,0,0,0,0
81,120,5,0,0,0,0,0,0,3,13,0,0,0,0,0,0,0,0
81,121,2,0,0,0,0,0,0,1,5,0,0,0,0,0,0,0,0
81,123,1,0,0,0,0,0,0,1,3,0,0,0,0,0,0,0,0
81,126,14,0,0,0,0,0,0,1,27,0,0,0,0,0,0,0,0
81,127,10,0,0,0,0,0,0,2,17,0,0,0,0,0,0,0,0
82,62,37,10,61,302,41,25,40,17,103,104,510,2538,467,210,397,363,3048
82,63,10,0,0,0,0,0,0,2,20,0,0,0,0,0,0,0,0
82,64,8,0,0,0,0,0,0,2,17,0,0,0,0,0,0,0,0
82,65,17,9,2,283,12,2,21,9,54,80,14,3421,124,33,253,285,3435
82,66,66,14,18,871,17,14,237,24,207,154,136,8912,217,112,2760,889,9048
82,69,4357,6839,9287,144758,22726,2564,3313,1029,10426,39132,38066,918522,165751,13819,20457,154045,956588
82,70,5984,7302,10884,188647,19426,4824,5030,1463,14630,37038,49811,1195764,140509,25426,28203,199531,1245575
82,72,40,0,0,0,0,0,0,19,137,0,0,0,0,0,0,0,0
82,73,7,0,0,0,0,0,0,2,19,0,0,0,0,0,0,0,0
82,125,21,0,0,0,0,0,0,2,39,0,0,0,0,0,0,0,0
82,126,25,33,932,244,41,7,24,6,46,48,2326,485,122,9,28,1176,2811
83,62,155,78,205,2408,279,123,699,74,480,747,1619,21087,2912,1046,7517,2613,22706
83,63,67,14,55,802,54,44,106,14,151,138,372,5949,498,173,1011,857,6321
83,64,244,412,182,5596,1353,212,1384,43,591,3988,1390,49313,12103,1130,15038,5778,50703
83,68,2448,1622,3912,71595,6688,765,1259,560,6319,9976,19479,500995,47717,4001,8768,75507,520474
83,69,268,159,148,5296,308,22,212,69,644,1075,923,37587,2604,130,1525,5444,38510
83,71,1,0,0,0,0,0,0,1,6,0,0,0,0,0,0,0,0
83,72,17,13,7,348,126,4,0,12,73,147,49,3332,1423,20,0,355,3381
83,73,8,6,0,164,84,8,0,6,40,60,0,1763,1056,80,0,164,1763
83,74,7,0,0,0,0,0,0,4,26,0,0,0,0,0,0,0,0
83,114,5,0,0,0,0,0,0,1,10,0,0,0,0,0,0,0,0
83,127,18,0,0,0,0,0,0,1,36,0,0,0,0,0,0,0,0
84,62,1786,1451,8250,65441,3772,2131,2974,455,4562,8709,41305,275094,23469,10002,21352,73691,316399
84,63,845,400,770,11160,1142,165,2325,144,2149,3784,5958,101694,11294,1158,25869,11930,107652
84,67,2275,2824,1212,59545,3417,379,1391,329,5663,11763,7835,428387,26607,1745,10548,60757,436222
84,70,9,0,0,0,0,0,0,7,28,0,0,0,0,0,0,0,0
84,71,2,0,0,0,0,0,0,2,7,0,0,0,0,0,0,0,0
84,72,11,0,0,0,0,0,0,3,26,0,0,0,0,0,0,0,0
84,73,46,16,0,294,118,0,0,27,169,214,0,3003,1520,0,0,294,3003
84,74,4,0,0,0,0,0,0,1,8,0,0,0,0,0,0,0,0
84,113,85,84,1529,1636,279,207,67,6,208,114,3036,3143,458,358,194,3165,6179
85,61,130,115,333,2621,266,172,354,58,326,986,2464,19106,2155,1031,3533,2954,21570
85,62,638,389,1673,12651,1355,728,1278,190,1620,3539,9935,86678,11631,4937,13449,14324,96613
85,63,2993,2632,5454,69882,10065,1972,4677,443,7105,17781,30620,503221,78557,10600,35660,75336,533841
85,64,38,0,0,0,0,0,0,11,107,0,0,0,0,0,0,0,0
85,66,266,331,397,5800,985,370,508,71,709,2802,2752,43655,7542,2270,5213,6197,46407
85,68,2,0,0,0,0,0,0,2,10,0,0,0,0,0,0,0,0
85,71,1,0,0,0,0,0,0,1,4,0,0,0,0,0,0,0,0
85,72,35,4,0,171,91,0,0,12,81,28,0,2144,1350,0,0,171,2144
85,73,138,29,837,637,196,34,22,41,351,164,1393,4721,2222,68,35,1474,6114
85,74,11,0,0,0,0,0,0,5,30,0,0,0,0,0,0,0,0
85,120,4,0,0,0,0,0,0,4,20,0,0,0,0,0,0,0,0
85,122,6,0,0,0,0,0,0,1,12,0,0,0,0,0,0,0,0
86,62,8,0,0,0,0,0,0,2,18,0,0,0,0,0,0,0,0
86,63,638,390,1263,14868,1606,244,994,125,1507,2596,6653,107310,12858,1243,7443,16131,113963
86,64,96,10,78,1898,81,22,20,30,234,133,306,13798,667,62,148,1976,14104
86,66,664,404,4119,16927,2087,145,555,133,1744,2904,16698,116408,17014,776,4152,21046,133106
86,67,1337,443,747,41097,3114,277,905,205,3105,2466,4021,267256,17358,896,5011,41844,271277
86,68,11,0,0,0,0,0,0,3,22,0,0,0,0,0,0,0,0
86,69,4,0,0,0,0,0,0,1,8,0,0,0,0,0,0,0,0
86,74,1,0,0,0,0,0,0,1,6,0,0,0,0,0,0,0,0
86,113,16,0,0,0,0,0,0,1,23,0,0,0,0,0,0,0,0
86,125,18,0,0,0,0,0,0,1,39,0,0,0,0,0,0,0,0
87,62,76,43,62,1211,172,7,88,22,174,392,502,11515,1917,35,862,1273,12017
87,63,121,132,54,2540,417,63,126,41,290,1224,361,22024,3570,443,972,2594,22385
87,66,2786,1136,3577,74797,4234,738,3201,510,6629,5898,15820,485276,25803,2989,15014,78374,501096
87,68,5,0,0,0,0,0,0,4,12,0,0,0,0,0,0,0,0
87,112,5,0,0,0,0,0,0,1,13,0,0,0,0,0,0,0,0
87,116,21,0,0,0,0,0,0,1,49,0,0,0,0,0,0,0,0
88,59,254,19,91,1014,71,48,53,33,545,174,568,4726,418,240,508,1105,5294
88,62,141,0,0,0,0,0,0,40,329,0,0,0,0,0,0,0,0
88,63,13,4,20,111,9,0,7,6,28,42,347,1063,86,0,84,131,1410
88,65,6,0,0,0,0,0,0,2,11,0,0,0,0,0,0,0,0
88,67,13,0,0,0,0,0,0,3,35,0,0,0,0,0,0,0,0
88,68,26,7,274,701,61,41,9,4,56,7,468,1431,216,53,15,975,1899
88,111,1,0,0,0,0,0,0,1,2,0,0,0,0,0,0,0,0
88,113,9,0,0,0,0,0,0,4,18,0,0,0,0,0,0,0,0
88,115,6,0,0,0,0,0,0,1,22,0,0,0,0,0,0,0,0
88,116,73,75,3226,1208,156,109,178,6,143,169,6503,3859,559,163,295,4434,10362
88,117,1,0,0,0,0,0,0,1,6,0,0,0,0,0,0,0,0
88,118,86,0,0,0,0,0,0,4,202,0,0,0,0,0,0,0,0
88,120,13,0,0,0,0,0,0,1,56,0,0,0,0,0,0,0,0
88,124,27,92,425,481,8,136,46,6,49,188,1594,1581,27,324,144,906,3175
89,58,26,0,0,0,0,0,0,6,54,0,0,0,0,0,0,0,0
89,59,90,30,241,2879,120,181,103,27,205,111,1075,8866,548,584,755,3120,9941
89,62,384,126,293,5326,244,63,168,121,958,944,2223,41709,2365,451,1641,5619,43932
89,63,8,0,0,0,0,0,0,4,25,0,0,0,0,0,0,0,0
89,64,6,0,0,0,0,0,0,2,13,0,0,0,0,0,0,0,0
89,65,162,77,427,2444,463,135,161,58,422,297,1255,10698,2739,388,560,2871,11953
89,67,5,0,0,0,0,0,0,2,10,0,0,0,0,0,0,0,0
89,112,11,0,0,0,0,0,0,1,25,0,0,0,0,0,0,0,0
89,113,2,0,0,0,0,0,0,1,8,0,0,0,0,0,0,0,0
89,126,6,0,0,0,0,0,0,1,34,0,0,0,0,0,0,0,0
90,58,21,0,0,0,0,0,0,7,59,0,0,0,0,0,0,0,0
90,59,59,52,266,1505,128,90,115,9,166,314,1722,6524,604,352,1038,1771,8246
90,61,315,134,352,5806,441,92,267,83,818,1051,2608,43394,3664,574,2181,6158,46002
90,62,57,13,95,896,43,32,23,18,153,106,517,6932,351,237,141,991,7449
90,63,47,72,3,556,136,6,0,18,125,629,28,4921,1404,37,0,559,4949
90,64,146,57,74,2537,322,11,285,63,397,524,477,21499,3485,59,1975,2611,21976
90,65,24,14,10,174,63,2,6,10,58,80,17,1405,554,8,52,184,1422
90,112,15,0,0,0,0,0,0,1,23,0,0,0,0,0,0,0,0
90,115,10,0,0,0,0,0,0,3,26,0,0,0,0,0,0,0,0
90,118,18,0,0,0,0,0,0,3,38,0,0,0,0,0,0,0,0
90,120,1,0,0,0,0,0,0,1,6,0,0,0,0,0,0,0,0
90,122,6,0,0,0,0,0,0,1,12,0,0,0,0,0,0,0,0
91,58,64,0,0,0,0,0,0,8,183,0,0,0,0,0,0,0,0
91,61,2,0,0,0,0,0,0,1,10,0,0,0,0,0,0,0,0
91,62,371,94,206,5770,381,107,130,104,1075,658,1289,46092,3521,519,1017,5976,47381
91,63,484,161,271,10203,637,212,242,111,1287,900,1818,72770,5668,1397,1867,10474,74588
91,64,112,0,0,0,0,0,0,4,327,0,0,0,0,0,0,0,0
91,65,15,2,11,112,13,1,8,7,37,14,74,941,180,4,50,123,1015
91,118,35,0,0,0,0,0,0,2,65,0,0,0,0,0,0,0,0
91,120,100,0,0,0,0,0,0,4,310,0,0,0,0,0,0,0,0
92,58,91,70,418,2726,212,234,73,40,231,446,1935,10932,1294,805,546,3144,12867
92,64,6,0,0,0,0,0,0,1,11,0,0,0,0,0,0,0,0
92,66,10,0,0,0,0,0,0,1,20,0,0,0,0,0,0,0,0
92,120,7,0,0,0,0,0,0,1,17,0,0,0,0,0,0,0,0
93,58,77,15,132,1480,109,82,70,41,212,139,918,6959,724,556,627,1612,7877
93,60,272,0,0,0,0,0,0,6,814,0,0,0,0,0,0,0,0
93,61,18,7,11,146,8,8,0,11,40,14,57,709,32,46,0,157,766
93,62,4,0,0,0,0,0,0,1,8,0,0,0,0,0,0,0,0
93,65,98,0,0,0,0,0,0,8,238,0,0,0,0,0,0,0,0
93,112,5,0,0,0,0,0,0,2,17,0,0,0,0,0,0,0,0
93,113,33,0,0,0,0,0,0,3,68,0,0,0,0,0,0,0,0
93,115,6,0,0,0,0,0,0,1,15,0,0,0,0,0,0,0,0
93,119,1,0,0,0,0,0,0,1,4,0,0,0,0,0,0,0,0
93,123,3,0,0,0,0,0,0,1,8,0,0,0,0,0,0,0,0
94,58,5,0,0,0,0,0,0,3,20,0,0,0,0,0,0,0,0
94,60,102,64,321,3243,219,227,116,45,233,248,1461,11113,1115,723,545,3564,12574
94,61,91,172,841,4276,424,353,121,33,209,433,1810,11990,1527,824,265,5117,13800
94,62,6,0,0,0,0,0,0,2,12,0,0,0,0,0,0,0,0
94,112,267,480,7508,8887,1260,650,447,41,631,709,14886,16106,2188,837,753,16395,30992
94,113,6,0,0,0,0,0,0,1,11,0,0,0,0,0,0,0,0
94,119,65,86,2628,1246,104,84,157,6,109,99,4993,2833,271,169,216,3874,7826
94,120,1,0,0,0,0,0,0,1,2,0,0,0,0,0,0,0,0
95,57,117,115,261,2520,199,238,287,35,278,1046,1532,15990,1323,1321,2610,2781,17522
95,58,8,0,0,0,0,0,0,2,16,0,0,0,0,0,0,0,0
95,60,13,0,0,0,0,0,0,8,32,0,0,0,0,0,0,0,0
95,61,1,0,0,0,0,0,0,1,4,0,0,0,0,0,0,0,0
95,120,4,0,0,0,0,0,0,1,9,0,0,0,0,0,0,0,0
95,121,11,0,0,0,0,0,0,1,24,0,0,0,0,0,0,0,0
95,126,36,48,403,291,27,89,22,5,62,76,593,791,38,391,24,694,1384
96,60,100,0,0,0,0,0,0,23,256,0,0,0,0,0,0,0,0
96,113,17,0,0,0,0,0,0,2,50,0,0,0,0,0,0,0,0
97,58,210,33,233,3386,271,50,28,40,454,173,1126,19519,2133,183,197,3619,20645
97,59,23,21,6,452,31,18,14,8,62,185,41,3391,232,127,160,458,3432
97,60,586,539,945,23347,3573,521,414,105,1384,3572,4031,119746,28298,2239,2280,24292,123777
97,112,6,0,0,0,0,0,0,2,10,0,0,0,0,0,0,0,0
97,125,3,0,0,0,0,0,0,1,5,0,0,0,0,0,0,0,0
98,57,40,17,18,1017,75,12,5,12,94,129,116,6744,684,83,15,1035,6860
98,58,379,253,471,12505,907,276,45,59,834,1645,1931,74704,6450,1556,266,12976,76635
98,59,11,0,0,0,0,0,0,7,30,0,0,0,0,0,0,0,0
98,116,6,0,0,0,0,0,0,1,13,0,0,0,0,0,0,0,0
98,124,9,0,0,0,0,0,0,4,28,0,0,0,0,0,0,0,0
99,57,207,51,35,5351,193,24,7,30,498,437,116,40751,1631,113,50,5386,40867
99,58,730,987,1490,55239,5701,2117,556,96,2028,3650,4922,226681,24196,5956,1626,56729,231603
99,59,4,0,0,0,0,0,0,4,13,0,0,0,0,0,0,0,0
99,116,2,0,0,0,0,0,0,1,4,0,0,0,0,0,0,0,0
99,117,18,0,0,0,0,0,0,1,35,0,0,0,0,0,0,0,0
99,120,5,0,0,0,0,0,0,1,13,0,0,0,0,0,0,0,0
99,123,3,0,0,0,0,0,0,1,6,0,0,0,0,0,0,0,0
99,124,46,0,0,0,0,0,0,5,98,0,0,0,0,0,0,0,0
99,126,6,0,0,0,0,0,0,1,12,0,0,0,0,0,0,0,0
100,57,4045,7555,25767,369494,18967,10619,2251,995,9134,33524,65873,1285441,86177,34297,6015,395261,1351314
100,58,577,470,836,18082,2280,1058,178,189,1356,2999,2832,88809,16118,4340,661,18918,91641
100,113,33,6,330,285,46,59,22,4,69,8,639,689,84,335,22,615,1328
100,116,2,0,0,0,0,0,0,1,4,0,0,0,0,0,0,0,0
100,117,89,255,4770,3025,324,166,223,11,179,479,10621,5345,850,330,284,7795,15966
100,122,123,0,0,0,0,0,0,5,242,0,0,0,0,0,0,0,0
100,123,11,0,0,0,0,0,0,3,24,0,0,0,0,0,0,0,0
100,124,3,0,0,0,0,0,0,1,7,0,0,0,0,0,0,0,0
101,57,6503,9380,25940,635454,33295,16949,3323,2124,15290,33161,65158,1917977,108407,44611,8643,661394,1983135
101,58,200,39,251,2013,161,164,25,91,527,80,778,7378,627,391,29,2264,8156
101,121,2,0,0,0,0,0,0,2,7,0,0,0,0,0,0,0,0
101,123,13,0,0,0,0,0,0,4,29,0,0,0,0,0,0,0,0
101,127,71,127,2564,1613,120,152,421,8,175,172,3963,2341,271,174,456,4177,6304
102,57,1746,2414,10307,102938,11048,3619,918,309,4131,9983,26704,418228,47972,11121,3207,113245,444932
102,121,14,0,0,0,0,0,0,1,19,0,0,0,0,0,0,0,0
102,127,4,0,91,47,4,4,2,3,8,0,299,136,13,4,2,138,435
103,55,50,20,28,1337,78,18,7,23,135,79,40,3546,331,33,8,1365,3586
103,56,2563,2711,2469,97291,5746,2120,453,468,5743,16478,8552,543393,35205,8555,2040,99760,551945
103,57,104,47,235,3693,313,182,25,38,259,231,1036,19736,2246,798,77,3928,20772
103,122,205,0,0,0,0,0,0,13,360,0,0,0,0,0,0,0,0
103,124,6,0,0,0,0,0,0,2,12,0,0,0,0,0,0,0,0
103,126,20,25,250,136,13,2,10,6,42,44,448,297,26,6,20,386,745
103,127,46,3,1170,2138,29,0,104,9,89,6,2133,2346,58,0,124,3308,4479
104,55,68,42,653,4074,214,95,66,32,162,174,1390,10711,639,197,129,4727,12101
104,56,10,0,0,0,0,0,0,5,24,0,0,0,0,0,0,0,0
104,116,3,0,0,0,0,0,0,3,7,0,0,0,0,0,0,0,0
104,121,2,0,0,0,0,0,0,2,8,0,0,0,0,0,0,0,0
104,122,370,699,17801,10575,1120,572,867,79,780,1399,31416,24380,3067,1945,1366,28376,55796
104,123,51,9,1116,427,62,19,24,19,107,24,2299,918,244,40,28,1543,3217
104,124,10,0,0,0,0,0,0,2,18,0,0,0,0,0,0,0,0
104,125,13,0,0,0,0,0,0,1,29,0,0,0,0,0,0,0,0
104,127,20,0,0,0,0,0,0,3,44,0,0,0,0,0,0,0,0
105,54,23,5,5,225,26,9,2,10,55,17,23,798,109,16,2,230,821
105,55,56,18,51,947,85,31,3,26,142,124,429,6122,649,135,3,998,6551
105,56,3,0,0,0,0,0,0,2,6,0,0,0,0,0,0,0,0
105,111,10,0,0,0,0,0,0,3,22,0,0,0,0,0,0,0,0
105,112,25,42,756,660,100,37,43,11,60,78,1454,1352,206,62,162,1416,2806
105,113,2,0,0,0,0,0,0,1,4,0,0,0,0,0,0,0,0
105,118,7,0,0,0,0,0,0,1,14,0,0,0,0,0,0,0,0
105,123,61,0,0,0,0,0,0,9,157,0,0,0,0,0,0,0,0
106,53,28,11,1,236,26,4,4,11,58,87,3,1732,288,18,26,237,1735
106,54,14,0,0,0,0,0,0,6,31,0,0,0,0,0,0,0,0
106,55,33,6,4,606,68,1,0,16,96,84,30,5006,615,3,0,610,5036
106,116,135,0,0,0,0,0,0,5,242,0,0,0,0,0,0,0,0
106,117,241,125,6516,2630,458,359,119,19,590,454,9341,4785,985,622,239,9146,14126
106,126,22,0,0,0,0,0,0,3,73,0,0,0,0,0,0,0,0
107,53,150,215,86,4319,904,197,176,48,375,956,558,26865,4188,1087,1128,4405,27423
107,54,4,0,0,0,0,0,0,2,12,0,0,0,0,0,0,0,0
107,118,4,0,0,0,0,0,0,1,8,0,0,0,0,0,0,0,0
107,122,15,8,172,111,33,0,13,7,32,22,365,403,96,0,18,283,768
108,53,4,0,0,0,0,0,0,1,8,0,0,0,0,0,0,0,0
108,110,6,0,0,0,0,0,0,2,12,0,0,0,0,0,0,0,0
108,111,8,0,0,0,0,0,0,1,19,0,0,0,0,0,0,0,0
108,118,31,0,0,0,0,0,0,5,59,0,0,0,0,0,0,0,0
108,119,65,0,0,0,0,0,0,4,145,0,0,0,0,0,0,0,0
108,121,7,0,0,0,0,0,0,2,20,0,0,0,0,0,0,0,0
109,115,1,0,0,0,0,0,0,1,4,0,0,0,0,0,0,0,0
109,118,155,135,4537,1966,339,136,123,16,610,237,7836,4064,819,500,173,6503,11900
109,122,17,0,0,0,0,0,0,4,34,0,0,0,0,0,0,0,0
110,112,60,0,0,0,0,0,0,1,120,0,0,0,0,0,0,0,0
110,117,6,0,0,0,0,0,0,1,20,0,0,0,0,0,0,0,0
111,114,5,0,0,0,0,0,0,1,10,0,0,0,0,0,0,0,0
111,117,7,0,0,0,0,0,0,1,14,0,0,0,0,0,0,0,0
113,116,1,0,0,0,0,0,0,1,2,0,0,0,0,0,0,0,0
114,116,1,0,0,0,0,0,0,1,2,0,0,0,0,0,0,0,0
115,116,64,113,2740,918,146,36,81,7,124,161,3844,1228,234,41,83,3658,5072
