x,y,ACCOMMODATION UNITS (ROOMS APARTMENTS CAMPING SITES) - TOTAL,A_AUSTRIAN TOURISTS,A_DOMESTIC TOURISTS - TOTAL,A_FOREIGN TOURISTS - TOTAL,A_GERMAN TOURISTS,A_ITALIAN TOURISTS,A_SLOVENIAN TOURISTS,ESTABLISHMENTS - TOTAL,NUMBER OF PERMANENT BEDS,N_AUSTRIAN TOURISTS,N_DOMESTIC TOURISTS - TOTAL,N_FOREIGN TOURISTS - TOTAL,N_GERMAN TOURISTS,N_ITALIAN TOURISTS,N_SLOVENIAN TOURISTS,TOTAL ARRIVALS,TOTAL NIGHTS
0,14,18,118,2,608,113,165,12,6,50,703,14,4153,979,1149,52,610,4167
0,15,11798,94244,43435,529734,123279,70478,43478,2031,31096,507702,124902,3204020,1064931,338316,160618,573169,3328922
0,19,1,0,0,0,0,0,0,1,4,0,0,0,0,0,0,0,0
0,26,9,11,2,301,125,36,1,8,34,107,8,2716,1353,246,9,303,2724
0,27,41,136,22,1074,635,23,17,25,125,825,74,9003,5809,106,95,1096,9077
0,28,5,27,0,145,78,4,0,5,18,176,0,997,593,14,0,145,997
0,30,9,0,0,0,0,0,0,3,20,0,0,0,0,0,0,0,0
0,31,72,185,130,2070,661,363,96,30,204,1061,282,12378,6000,1274,221,2200,12660
0,32,36,0,0,0,0,0,0,14,108,0,0,0,0,0,0,0,0
0,33,5,0,0,0,0,0,0,2,16,0,0,0,0,0,0,0,0
0,34,14,0,0,0,0,0,0,8,50,0,0,0,0,0,0,0,0
0,35,19,56,11,533,330,15,12,13,66,426,62,4841,3228,91,53,544,4903
0,36,26,84,8,798,454,59,14,18,100,589,41,6917,4605,392,86,806,6958
0,37,25,7,13,406,224,71,13,14,69,41,61,4198,2391,474,61,419,4259
0,48,24,80,8,518,175,0,10,9,64,514,23,4330,1784,0,27,526,4353
0,51,5,0,0,0,0,0,0,1,10,0,0,0,0,0,0,0,0
0,55,43,53,20,774,511,40,20,19,109,393,68,6788,5120,113,52,794,6856
1,14,9,16,3,142,87,0,0,3,22,112,21,1230,824,0,0,145,1251
1,15,4,0,0,0,0,0,0,2,8,0,0,0,0,0,0,0,0
1,25,24,0,0,0,0,0,0,11,72,0,0,0,0,0,0,0,0
1,27,52,0,0,0,0,0,0,36,178,0,0,0,0,0,0,0,0
1,30,2,0,0,0,0,0,0,2,9,0,0,0,0,0,0,0,0
1,31,47,153,68,1734,664,226,154,25,153,825,192,10938,5946,772,462,1802,11130
1,32,4,0,0,0,0,0,0,2,8,0,0,0,0,0,0,0,0
1,33,10,7,62,337,214,27,33,6,37,43,195,2795,2031,169,123,399,2990
1,34,9,0,0,0,0,0,0,4,26,0,0,0,0,0,0,0,0
1,35,11,24,11,194,96,15,5,4,28,92,51,1459,893,99,18,205,1510
1,36,13,8,2,202,150,9,0,5,43,56,12,2069,1608,108,0,204,2081
1,39,2,0,0,0,0,0,0,1,4,0,0,0,0,0,0,0,0
1,40,40,0,0,0,0,0,0,15,98,0,0,0,0,0,0,0,0
1,41,29,0,0,0,0,0,0,9,60,0,0,0,0,0,0,0,0
1,52,10,0,0,0,0,0,0,7,33,0,0,0,0,0,0,0,0
1,53,7,24,9,149,34,10,8,3,17,129,24,1125,382,88,54,158,1149
2,14,54,0,0,0,0,0,0,5,155,0,0,0,0,0,0,0,0
2,15,5,19,21,325,68,49,13,3,16,71,40,1313,417,187,37,346,1353
2,27,32,0,0,0,0,0,0,13,80,0,0,0,0,0,0,0,0
2,29,32,122,38,1017,435,94,32,19,113,840,103,8041,4223,420,108,1055,8144
2,30,50,116,56,1146,585,150,23,25,142,744,207,9431,5830,682,141,1202,9638
2,31,2,0,0,0,0,0,0,1,8,0,0,0,0,0,0,0,0
2,35,4,0,0,0,0,0,0,3,14,0,0,0,0,0,0,0,0
2,36,5,0,0,0,0,0,0,3,10,0,0,0,0,0,0,0,0
2,39,27,63,23,428,244,30,26,10,69,429,81,3163,2210,118,50,451,3244
2,40,169,0,0,0,0,0,0,82,455,0,0,0,0,0,0,0,0
2,41,25,0,0,0,0,0,0,11,59,0,0,0,0,0,0,0,0
2,43,8,0,0,0,0,0,0,1,14,0,0,0,0,0,0,0,0
2,46,3,0,0,0,0,0,0,1,6,0,0,0,0,0,0,0,0
2,47,3,0,0,0,0,0,0,2,9,0,0,0,0,0,0,0,0
2,49,26,168,28,853,207,113,15,9,62,587,82,4261,1848,232,17,881,4343
2,52,7,0,0,0,0,0,0,2,34,0,0,0,0,0,0,0,0
2,54,7,0,0,0,0,0,0,2,14,0,0,0,0,0,0,0,0
2,56,12,0,0,0,0,0,0,3,24,0,0,0,0,0,0,0,0
3,12,3,0,0,0,0,0,0,1,6,0,0,0,0,0,0,0,0
3,13,770,0,0,0,0,0,0,1,2310,0,0,0,0,0,0,0,0
3,14,3,0,0,0,0,0,0,1,6,0,0,0,0,0,0,0,0
3,24,3,0,0,0,0,0,0,1,6,0,0,0,0,0,0,0,0
3,25,4,0,0,0,0,0,0,2,8,0,0,0,0,0,0,0,0
3,29,1,0,0,0,0,0,0,1,4,0,0,0,0,0,0,0,0
3,30,16,36,5,375,162,43,13,8,46,230,17,3212,1667,250,73,380,3229
3,33,12,0,0,0,0,0,0,4,34,0,0,0,0,0,0,0,0
3,37,8,0,0,0,0,0,0,4,16,0,0,0,0,0,0,0,0
3,39,1,0,0,0,0,0,0,1,4,0,0,0,0,0,0,0,0
3,40,11,0,0,0,0,0,0,4,22,0,0,0,0,0,0,0,0
3,41,10,0,0,0,0,0,0,6,25,0,0,0,0,0,0,0,0
3,48,11,0,0,0,0,0,0,4,24,0,0,0,0,0,0,0,0
3,55,51,166,66,986,370,65,53,18,128,837,219,6079,3148,191,108,1052,6298
3,56,6,0,0,100,78,0,0,3,12,0,0,935,737,0,0,100,935
4,11,8,0,0,0,0,0,0,2,22,0,0,0,0,0,0,0,0
4,12,37,0,0,0,0,0,0,2,112,0,0,0,0,0,0,0,0
4,13,1,0,0,0,0,0,0,1,4,0,0,0,0,0,0,0,0
4,14,9,36,0,216,127,0,0,3,18,254,0,1766,1123,0,0,216,1766
4,19,1,0,0,0,0,0,0,1,6,0,0,0,0,0,0,0,0
4,22,3,0,0,0,0,0,0,1,7,0,0,0,0,0,0,0,0
4,23,16,0,0,0,0,0,0,5,36,0,0,0,0,0,0,0,0
4,24,33,0,0,0,0,0,0,15,80,0,0,0,0,0,0,0,0
4,26,3,0,0,0,0,0,0,1,6,0,0,0,0,0,0,0,0
4,28,4,0,0,0,0,0,0,4,14,0,0,0,0,0,0,0,0
4,30,13,0,0,0,0,0,0,5,30,0,0,0,0,0,0,0,0
4,32,15,0,0,0,0,0,0,2,58,0,0,0,0,0,0,0,0
4,33,6,0,0,0,0,0,0,3,18,0,0,0,0,0,0,0,0
4,35,17,17,16,495,239,33,15,7,41,103,21,3799,2427,116,42,511,3820
4,36,3,0,0,0,0,0,0,3,8,0,0,0,0,0,0,0,0
4,37,39,56,4,524,248,36,0,11,85,431,4,4665,2352,221,0,528,4669
4,39,16,0,0,0,0,0,0,5,35,0,0,0,0,0,0,0,0
4,42,23,0,0,0,0,0,0,8,51,0,0,0,0,0,0,0,0
4,44,4,0,0,0,0,0,0,1,8,0,0,0,0,0,0,0,0
4,49,85,354,309,1983,324,295,228,25,227,1133,1340,7904,1991,713,656,2292,9244
4,51,2,0,0,0,0,0,0,1,6,0,0,0,0,0,0,0,0
5,11,3,0,0,0,0,0,0,1,6,0,0,0,0,0,0,0,0
5,12,3,0,0,0,0,0,0,1,6,0,0,0,0,0,0,0,0
5,13,5,0,0,0,0,0,0,2,12,0,0,0,0,0,0,0,0
5,14,3,0,0,0,0,0,0,2,8,0,0,0,0,0,0,0,0
5,18,34,230,54,1508,305,199,26,10,112,1118,201,8625,2439,984,106,1562,8826
5,19,202,476,260,4877,1571,918,114,86,493,3162,1055,31239,13607,4123,373,5137,32294
5,26,5,0,0,0,0,0,0,2,14,0,0,0,0,0,0,0,0
5,27,8,0,0,0,0,0,0,4,16,0,0,0,0,0,0,0,0
5,28,6,0,0,0,0,0,0,4,21,0,0,0,0,0,0,0,0
5,30,7,35,28,278,57,70,26,4,21,171,41,1334,527,157,101,306,1375
5,36,115,183,66,994,224,49,82,33,242,870,175,6659,1882,249,137,1060,6834
5,37,61,186,154,1557,501,87,63,23,137,1155,432,9739,4569,262,204,1711,10171
5,38,17,0,0,0,0,0,0,9,39,0,0,0,0,0,0,0,0
5,40,1,0,0,0,0,0,0,1,6,0,0,0,0,0,0,0,0
5,41,7,0,0,0,0,0,0,2,14,0,0,0,0,0,0,0,0
5,42,16,0,0,0,0,0,0,7,45,0,0,0,0,0,0,0,0
5,43,1,0,0,0,0,0,0,1,6,0,0,0,0,0,0,0,0
5,44,21,68,14,513,163,0,1,8,50,410,50,4108,1416,0,7,527,4158
5,49,5,2,2,77,14,0,0,3,11,12,4,694,151,0,0,79,698
5,50,3,0,0,0,0,0,0,1,6,0,0,0,0,0,0,0,0
5,53,5,27,23,190,31,36,15,4,10,83,33,763,279,73,29,213,796
6,11,4,0,0,0,0,0,0,1,8,0,0,0,0,0,0,0,0
6,13,5,0,0,0,0,0,0,2,14,0,0,0,0,0,0,0,0
6,18,15,44,41,514,166,116,10,10,54,244,220,3466,1581,550,27,555,3686
6,19,20,27,8,297,136,49,7,7,43,200,26,2245,1223,317,26,305,2271
6,24,4,0,0,0,0,0,0,1,8,0,0,0,0,0,0,0,0
6,28,6,0,0,0,0,0,0,2,12,0,0,0,0,0,0,0,0
6,29,8,0,0,0,0,0,0,4,24,0,0,0,0,0,0,0,0
6,31,11,18,9,288,191,4,0,7,39,187,35,2904,1909,28,0,297,2939
6,33,5,0,0,0,0,0,0,1,10,0,0,0,0,0,0,0,0
6,38,6,0,0,0,0,0,0,2,18,0,0,0,0,0,0,0,0
6,39,8,0,0,0,0,0,0,2,16,0,0,0,0,0,0,0,0
6,41,2,0,0,0,0,0,0,2,11,0,0,0,0,0,0,0,0
6,42,5,0,0,0,0,0,0,1,10,0,0,0,0,0,0,0,0
6,43,4,0,0,0,0,0,0,1,8,0,0,0,0,0,0,0,0
6,44,10,0,0,0,0,0,0,5,24,0,0,0,0,0,0,0,0
6,45,3,0,0,0,0,0,0,1,6,0,0,0,0,0,0,0,0
6,46,4,0,0,0,0,0,0,1,8,0,0,0,0,0,0,0,0
6,50,3,0,0,0,0,0,0,1,6,0,0,0,0,0,0,0,0
7,19,2,0,0,0,0,0,0,1,4,0,0,0,0,0,0,0,0
7,20,12,0,0,0,0,0,0,4,24,0,0,0,0,0,0,0,0
7,23,10,9,12,175,109,3,7,5,24,61,84,1655,1089,12,79,187,1739
7,24,9,0,0,0,0,0,0,4,26,0,0,0,0,0,0,0,0
7,25,16,0,0,0,0,0,0,9,43,0,0,0,0,0,0,0,0
7,26,48,87,46,503,120,19,24,16,104,442,67,3555,1099,261,69,549,3622
7,27,13,29,2,284,175,17,4,6,39,184,6,2512,1808,100,20,286,2518
7,33,4,0,0,0,0,0,0,1,8,0,0,0,0,0,0,0,0
7,34,10,0,0,0,0,0,0,2,22,0,0,0,0,0,0,0,0
7,35,7,0,0,0,0,0,0,3,14,0,0,0,0,0,0,0,0
7,36,2,0,0,0,0,0,0,1,4,0,0,0,0,0,0,0,0
7,38,2,0,0,0,0,0,0,1,4,0,0,0,0,0,0,0,0
7,39,1,0,0,0,0,0,0,1,3,0,0,0,0,0,0,0,0
7,40,19,0,0,0,0,0,0,7,40,0,0,0,0,0,0,0,0
7,41,2,0,0,0,0,0,0,1,8,0,0,0,0,0,0,0,0
7,42,12,0,0,0,0,0,0,5,30,0,0,0,0,0,0,0,0
7,43,10,0,0,0,0,0,0,3,20,0,0,0,0,0,0,0,0
7,44,20,0,0,0,0,0,0,10,49,0,0,0,0,0,0,0,0
7,47,12,0,0,0,0,0,0,3,26,0,0,0,0,0,0,0,0
7,50,2,0,0,0,0,0,0,1,5,0,0,0,0,0,0,0,0
7,51,4,0,0,0,0,0,0,1,8,0,0,0,0,0,0,0,0
7,53,6,0,0,0,0,0,0,2,12,0,0,0,0,0,0,0,0
8,6,14,17,6,266,38,46,119,5,30,112,46,1665,254,281,777,272,1711
8,18,4,0,0,0,0,0,0,1,10,0,0,0,0,0,0,0,0
8,19,51,0,0,0,0,0,0,19,123,0,0,0,0,0,0,0,0
8,20,34,0,0,0,0,0,0,15,81,0,0,0,0,0,0,0,0
8,23,4,0,0,0,0,0,0,2,8,0,0,0,0,0,0,0,0
8,24,8,9,0,148,116,4,0,4,22,161,0,1645,1264,28,0,148,1645
8,27,5,0,0,0,0,0,0,2,8,0,0,0,0,0,0,0,0
8,28,111,175,24,1085,345,35,6,32,236,1102,75,8675,2976,225,18,1109,8750
8,29,52,180,29,946,582,13,6,22,131,1208,149,8023,5395,50,32,975,8172
8,30,22,56,8,353,225,5,0,10,56,441,43,3540,2371,39,0,361,3583
8,31,1,0,0,0,0,0,0,1,4,0,0,0,0,0,0,0,0
8,33,18,0,0,0,0,0,0,6,38,0,0,0,0,0,0,0,0
8,34,5,0,0,0,0,0,0,1,10,0,0,0,0,0,0,0,0
8,37,13,0,0,0,0,0,0,4,30,0,0,0,0,0,0,0,0
8,39,15,0,0,0,0,0,0,4,30,0,0,0,0,0,0,0,0
8,44,27,0,0,0,0,0,0,12,69,0,0,0,0,0,0,0,0
8,49,1,0,0,0,0,0,0,1,6,0,0,0,0,0,0,0,0
8,51,17,72,4,222,111,0,0,6,37,482,28,1713,928,0,0,226,1741
9,6,70,178,30,1549,900,74,44,34,204,1357,168,13940,9307,520,238,1579,14108
9,7,51,143,63,1471,495,175,106,22,154,911,326,10951,4851,1033,451,1534,11277
9,19,57,91,34,1158,598,108,19,21,134,528,196,9066,5436,580,32,1192,9262
9,20,2,0,0,0,0,0,0,1,4,0,0,0,0,0,0,0,0
9,22,2,0,0,0,0,0,0,1,4,0,0,0,0,0,0,0,0
9,24,6,0,0,0,0,0,0,2,16,0,0,0,0,0,0,0,0
9,25,22,45,0,408,206,3,0,9,53,277,0,3487,1777,57,0,408,3487
9,26,3,0,0,0,0,0,0,1,6,0,0,0,0,0,0,0,0
9,27,23,0,0,0,0,0,0,7,53,0,0,0,0,0,0,0,0
9,28,47,0,0,0,0,0,0,18,101,0,0,0,0,0,0,0,0
9,30,17,0,0,0,0,0,0,9,42,0,0,0,0,0,0,0,0
9,31,1,0,0,0,0,0,0,1,4,0,0,0,0,0,0,0,0
9,32,10,0,0,0,0,0,0,5,28,0,0,0,0,0,0,0,0
9,33,8,0,0,0,0,0,0,2,15,0,0,0,0,0,0,0,0
9,34,17,0,0,0,0,0,0,7,40,0,0,0,0,0,0,0,0
9,36,29,105,8,750,460,27,19,13,72,848,41,6896,4424,178,75,758,6937
9,37,8,0,0,0,0,0,0,3,20,0,0,0,0,0,0,0,0
9,38,16,66,6,381,204,15,2,7,36,525,12,2649,1356,97,26,387,2661
9,39,4,0,0,0,0,0,0,1,8,0,0,0,0,0,0,0,0
9,40,3,0,0,0,0,0,0,2,10,0,0,0,0,0,0,0,0
9,41,9,0,0,0,0,0,0,3,18,0,0,0,0,0,0,0,0
9,51,3,0,5,36,19,0,2,3,8,0,37,310,223,0,8,41,347
10,4,1,0,0,0,0,0,0,1,3,0,0,0,0,0,0,0,0
10,5,2,0,0,0,0,0,0,2,4,0,0,0,0,0,0,0,0
10,6,3,0,0,0,0,0,0,2,12,0,0,0,0,0,0,0,0
10,7,4,0,0,0,0,0,0,2,12,0,0,0,0,0,0,0,0
10,16,26,53,74,830,283,175,21,10,57,330,153,4835,2372,460,31,904,4988
10,21,19,44,7,254,156,14,0,7,39,295,47,2383,1634,68,0,261,2430
10,24,1,0,0,0,0,0,0,1,4,0,0,0,0,0,0,0,0
10,25,1,0,0,0,0,0,0,1,5,0,0,0,0,0,0,0,0
10,26,19,79,3,410,200,29,0,8,46,648,8,3455,2012,196,0,413,3463
10,27,11,0,0,0,0,0,0,5,25,0,0,0,0,0,0,0,0
10,28,6,0,0,0,0,0,0,3,18,0,0,0,0,0,0,0,0
10,35,7,0,0,0,0,0,0,2,14,0,0,0,0,0,0,0,0
10,36,4,0,0,0,0,0,0,2,12,0,0,0,0,0,0,0,0
10,39,14,0,0,0,0,0,0,6,39,0,0,0,0,0,0,0,0
10,42,5,6,1,143,44,1,0,3,19,42,10,1122,448,14,0,144,1132
10,43,9,8,16,124,65,6,1,3,20,16,54,868,653,12,1,140,922
10,44,16,9,0,251,120,10,2,8,34,39,0,2137,1211,40,6,251,2137
10,49,7,0,0,0,0,0,0,2,14,0,0,0,0,0,0,0,0
10,53,2,0,0,0,0,0,0,1,4,0,0,0,0,0,0,0,0
11,2,5,0,0,0,0,0,0,2,16,0,0,0,0,0,0,0,0
11,11,16,62,30,470,108,168,28,9,36,356,93,2711,987,710,115,500,2804
11,12,802,5626,1804,44435,12181,7406,11525,87,2249,33734,5716,281967,104357,37267,69025,46239,287683
11,19,34,60,188,757,235,61,37,18,75,346,417,4456,1950,237,65,945,4873
11,21,7,0,0,0,0,0,0,2,14,0,0,0,0,0,0,0,0
11,23,2,0,0,0,0,0,0,1,4,0,0,0,0,0,0,0,0
11,24,3,0,0,0,0,0,0,1,6,0,0,0,0,0,0,0,0
11,26,11,0,0,0,0,0,0,5,30,0,0,0,0,0,0,0,0
11,27,9,21,0,210,104,0,0,3,18,139,0,1889,864,0,0,210,1889
11,28,9,18,3,149,96,5,3,3,20,121,9,1277,868,54,21,152,1286
11,29,7,6,0,172,114,0,0,3,18,42,0,1547,1101,0,0,172,1547
11,30,10,0,0,0,0,0,0,2,20,0,0,0,0,0,0,0,0
11,31,30,55,10,670,422,1,7,11,63,493,55,6689,4481,21,29,680,6744
11,32,12,24,4,249,148,0,4,5,32,211,28,2391,1414,0,28,253,2419
11,33,1,0,0,0,0,0,0,1,4,0,0,0,0,0,0,0,0
11,34,2,0,0,0,0,0,0,1,4,0,0,0,0,0,0,0,0
11,41,10,21,8,273,179,7,0,7,34,155,46,2624,1890,49,0,281,2670
11,42,5,0,0,0,0,0,0,2,10,0,0,0,0,0,0,0,0
11,43,8,14,7,134,36,4,4,4,19,113,19,896,287,13,12,141,915
11,44,33,50,167,865,197,108,79,11,72,282,324,4683,1473,162,131,1032,5007
11,47,15,0,0,0,0,0,0,6,30,0,0,0,0,0,0,0,0
11,51,2,0,0,0,0,0,0,1,4,0,0,0,0,0,0,0,0
12,1,32,60,18,975,488,93,40,21,109,410,84,8078,4749,723,216,993,8162
12,2,73,164,21,1695,797,73,80,37,207,1048,110,15091,8140,587,689,1716,15201
12,3,1,0,0,0,0,0,0,1,2,0,0,0,0,0,0,0,0
12,6,3,0,0,0,0,0,0,2,10,0,0,0,0,0,0,0,0
12,19,3,0,0,0,0,0,0,3,12,0,0,0,0,0,0,0,0
12,21,1,0,0,0,0,0,0,1,5,0,0,0,0,0,0,0,0
12,22,5,0,0,0,0,0,0,1,10,0,0,0,0,0,0,0,0
12,25,20,74,3,560,339,0,4,8,52,542,21,5172,3424,0,56,563,5193
12,26,31,42,13,453,185,4,2,12,68,336,52,3922,1744,12,4,466,3974
12,28,12,0,0,218,110,0,0,5,60,0,0,1745,895,0,0,218,1745
12,30,21,18,0,368,280,0,0,6,41,215,0,3640,2942,0,0,368,3640
12,31,7,0,0,0,0,0,0,2,20,0,0,0,0,0,0,0,0
12,32,6,8,3,109,44,0,0,3,20,112,6,1018,349,0,0,112,1024
12,34,13,62,45,473,212,35,1,7,50,462,85,3890,2323,124,2,518,3975
12,41,17,40,6,335,169,0,0,6,38,295,62,3063,1613,0,0,341,3125
12,43,4,0,0,0,0,0,0,1,8,0,0,0,0,0,0,0,0
12,44,5,0,0,0,0,0,0,2,10,0,0,0,0,0,0,0,0
12,48,1,0,0,0,0,0,0,1,4,0,0,0,0,0,0,0,0
12,49,3,0,0,0,0,0,0,1,6,0,0,0,0,0,0,0,0
12,50,26,95,71,539,138,14,58,8,60,242,119,2646,1141,18,87,610,2765
13,1,45,76,13,939,438,43,65,24,117,572,123,8296,4708,316,456,952,8419
13,2,466,538,1534,14072,2290,622,5680,143,1399,3314,6377,84997,21338,2522,37223,15606,91374
13,3,1,0,0,0,0,0,0,1,2,0,0,0,0,0,0,0,0
13,8,4,0,0,0,0,0,0,2,14,0,0,0,0,0,0,0,0
13,16,9,0,0,0,0,0,0,3,23,0,0,0,0,0,0,0,0
13,17,6,0,0,0,0,0,0,2,14,0,0,0,0,0,0,0,0
13,23,15,0,0,0,0,0,0,4,32,0,0,0,0,0,0,0,0
13,24,13,20,23,279,152,6,2,4,26,172,113,2213,1354,28,8,302,2326
13,28,22,20,6,374,212,11,7,8,52,178,12,3601,2132,33,49,380,3613
13,31,9,81,0,291,160,0,0,4,31,681,0,2766,1650,0,0,291,2766
13,34,1,0,0,0,0,0,0,1,6,0,0,0,0,0,0,0,0
13,40,7,0,0,0,0,0,0,3,16,0,0,0,0,0,0,0,0
13,42,8,12,8,116,66,0,0,3,16,119,24,1105,623,0,0,124,1129
13,44,55,394,291,4130,1117,341,213,22,131,852,566,9494,2877,506,408,4421,10060
13,45,424,0,0,0,0,0,0,27,1184,0,0,0,0,0,0,0,0
13,47,293,0,0,0,0,0,0,11,474,0,0,0,0,0,0,0,0
13,48,13,13,0,87,51,0,0,4,26,103,0,883,531,0,0,87,883
13,50,2,0,0,0,0,0,0,1,4,0,0,0,0,0,0,0,0
14,16,33,68,2,579,439,5,2,13,75,507,20,5708,4674,33,8,581,5728
14,17,6,3,1,68,21,19,0,4,16,12,7,432,195,137,0,69,439
14,22,13,55,14,316,170,0,0,3,26,461,98,2740,1475,0,0,330,2838
14,23,8,0,0,0,0,0,0,2,16,0,0,0,0,0,0,0,0
14,26,3,0,0,0,0,0,0,3,6,0,0,0,0,0,0,0,0
14,27,39,50,7,669,278,6,0,12,84,532,11,6601,2838,21,0,676,6612
14,28,19,27,9,338,157,12,0,8,44,206,76,3163,1755,56,0,347,3239
14,31,14,57,46,407,207,16,0,3,31,385,117,3551,2079,48,0,453,3668
14,32,6,6,42,150,69,19,5,4,16,15,94,989,710,74,12,192,1083
14,33,8,6,9,74,46,1,0,3,20,46,36,802,587,7,0,83,838
14,36,1,0,0,0,0,0,0,1,6,0,0,0,0,0,0,0,0
14,38,3,0,0,0,0,0,0,1,6,0,0,0,0,0,0,0,0
14,39,4,0,0,0,0,0,0,1,9,0,0,0,0,0,0,0,0
14,40,3,0,0,0,0,0,0,1,5,0,0,0,0,0,0,0,0
14,41,13,6,0,225,137,0,0,4,26,42,0,2408,1438,0,0,225,2408
14,47,6,0,0,0,0,0,0,2,11,0,0,0,0,0,0,0,0
14,49,7,0,0,0,0,0,0,2,14,0,0,0,0,0,0,0,0
15,7,2,0,0,0,0,0,0,2,10,0,0,0,0,0,0,0,0
15,8,74,336,59,1908,1154,43,18,27,189,2393,180,17233,11599,336,31,1967,17413
15,17,14,33,2,271,197,0,0,4,28,222,5,2512,1956,0,0,273,2517
15,18,23,0,0,0,0,0,0,8,52,0,0,0,0,0,0,0,0
15,19,5,0,0,0,0,0,0,2,12,0,0,0,0,0,0,0,0
15,20,24,14,0,435,224,12,10,9,51,94,0,3688,2256,66,29,435,3688
15,21,34,48,52,919,419,87,37,20,83,375,179,7048,4387,439,286,971,7227
15,23,1,0,0,0,0,0,0,1,3,0,0,0,0,0,0,0,0
15,26,2,0,0,0,0,0,0,1,4,0,0,0,0,0,0,0,0
15,31,2,0,0,0,0,0,0,1,4,0,0,0,0,0,0,0,0
15,33,2,0,0,0,0,0,0,1,5,0,0,0,0,0,0,0,0
15,34,4,0,0,0,0,0,0,1,8,0,0,0,0,0,0,0,0
15,36,4,3,16,137,50,8,0,4,17,21,72,1209,532,56,0,153,1281
15,37,1,0,0,0,0,0,0,1,6,0,0,0,0,0,0,0,0
15,38,7,17,9,247,161,1,0,6,32,195,59,2641,1688,11,0,256,2700
15,42,3,0,0,0,0,0,0,1,6,0,0,0,0,0,0,0,0
15,44,4,0,0,0,0,0,0,1,8,0,0,0,0,0,0,0,0
15,45,4,0,0,0,0,0,0,1,8,0,0,0,0,0,0,0,0
15,49,2,0,0,0,0,0,0,1,4,0,0,0,0,0,0,0,0
16,17,38,67,66,752,351,12,28,17,85,451,150,6429,3512,63,95,818,6579
16,18,5,0,0,0,0,0,0,2,10,0,0,0,0,0,0,0,0
16,20,9,0,0,0,0,0,0,4,19,0,0,0,0,0,0,0,0
16,23,12,0,0,0,0,0,0,3,28,0,0,0,0,0,0,0,0
16,24,4,5,18,153,77,8,0,3,12,23,43,1002,707,23,0,171,1045
16,25,2,0,0,0,0,0,0,2,8,0,0,0,0,0,0,0,0
16,27,18,7,16,305,175,4,0,6,36,98,91,2995,1745,28,0,321,3086
16,28,63,119,46,1115,725,17,16,26,141,810,344,10886,7872,86,71,1161,11230
16,32,12,26,1,340,230,11,0,6,43,275,14,3305,2311,61,0,341,3319
16,35,1,0,0,0,0,0,0,1,4,0,0,0,0,0,0,0,0
16,36,5,0,0,0,0,0,0,2,10,0,0,0,0,0,0,0,0
16,37,20,48,149,759,280,43,32,6,47,127,277,3471,1680,98,46,908,3748
16,42,7,0,0,0,0,0,0,3,16,0,0,0,0,0,0,0,0
16,47,6,0,0,0,0,0,0,3,12,0,0,0,0,0,0,0,0
16,51,2,0,0,0,0,0,0,1,4,0,0,0,0,0,0,0,0
16,52,8,0,0,0,0,0,0,4,20,0,0,0,0,0,0,0,0
17,3,298,656,371,7578,2749,522,1198,162,876,4574,2185,61667,26883,3785,7787,7949,63852
17,10,40,136,4,798,573,0,1,12,79,1081,12,7906,6129,0,3,802,7918
17,11,17,0,0,0,0,0,0,4,34,0,0,0,0,0,0,0,0
17,15,13,26,10,243,136,0,0,5,28,210,44,2310,1346,0,0,253,2354
17,17,11,1,1,150,119,0,0,3,22,7,5,1311,1064,0,0,151,1316
17,18,2,0,0,0,0,0,0,1,6,0,0,0,0,0,0,0,0
17,19,3,0,0,0,0,0,0,2,6,0,0,0,0,0,0,0,0
17,20,13,12,4,306,182,0,3,4,32,80,16,2774,1751,0,14,310,2790
17,21,15,10,0,283,205,6,0,6,38,91,0,3035,2284,42,0,283,3035
17,22,17,45,16,366,171,25,3,7,44,353,58,3229,1849,97,13,382,3287
17,23,19,23,13,354,163,18,25,6,38,167,39,2852,1535,153,114,367,2891
17,24,3,0,0,0,0,0,0,2,8,0,0,0,0,0,0,0,0
17,28,25,65,11,552,291,0,13,10,60,675,45,5723,3114,0,54,563,5768
17,29,3,0,0,0,0,0,0,2,8,0,0,0,0,0,0,0,0
17,31,5,0,0,0,0,0,0,2,9,0,0,0,0,0,0,0,0
17,35,3,0,0,0,0,0,0,1,6,0,0,0,0,0,0,0,0
17,36,4,0,0,0,0,0,0,1,8,0,0,0,0,0,0,0,0
17,37,3,0,0,0,0,0,0,1,5,0,0,0,0,0,0,0,0
17,44,6,0,0,0,0,0,0,2,11,0,0,0,0,0,0,0,0
17,47,5,0,0,0,0,0,0,2,10,0,0,0,0,0,0,0,0
18,0,8,10,4,192,92,8,2,5,22,70,9,1727,838,40,4,196,1736
18,7,7,0,0,0,0,0,0,2,14,0,0,0,0,0,0,0,0
18,9,11,0,0,0,0,0,0,4,21,0,0,0,0,0,0,0,0
18,10,18,3,1,287,214,0,0,6,39,49,7,3148,2325,0,0,288,3155
18,11,124,137,11,1090,720,6,12,34,254,1018,31,10232,7209,56,60,1101,10263
18,12,6,0,0,0,0,0,0,2,12,0,0,0,0,0,0,0,0
18,14,3,0,0,0,0,0,0,2,8,0,0,0,0,0,0,0,0
18,15,6,0,0,0,0,0,0,2,12,0,0,0,0,0,0,0,0
18,17,24,43,45,396,167,13,10,12,47,364,139,3268,1687,41,24,441,3407
18,18,8,0,0,0,0,0,0,2,16,0,0,0,0,0,0,0,0
18,20,10,0,0,0,0,0,0,3,22,0,0,0,0,0,0,0,0
18,21,5,0,0,0,0,0,0,3,14,0,0,0,0,0,0,0,0
18,22,2,0,0,0,0,0,0,1,10,0,0,0,0,0,0,0,0
18,23,6,13,0,135,83,0,0,3,16,126,0,1296,889,0,0,135,1296
18,24,2,0,0,0,0,0,0,1,4,0,0,0,0,0,0,0,0
18,25,7,0,0,0,0,0,0,2,14,0,0,0,0,0,0,0,0
18,26,4,0,0,0,0,0,0,2,13,0,0,0,0,0,0,0,0
18,28,1,0,0,0,0,0,0,1,4,0,0,0,0,0,0,0,0
18,30,1,0,0,0,0,0,0,1,4,0,0,0,0,0,0,0,0
18,31,2,0,0,0,0,0,0,2,8,0,0,0,0,0,0,0,0
18,32,2,0,0,0,0,0,0,1,8,0,0,0,0,0,0,0,0
18,35,3,0,0,0,0,0,0,1,6,0,0,0,0,0,0,0,0
18,47,6,0,0,0,0,0,0,2,14,0,0,0,0,0,0,0,0
19,7,6,0,0,0,0,0,0,2,12,0,0,0,0,0,0,0,0
19,8,29,51,14,245,63,3,5,7,58,230,59,1706,528,15,15,259,1765
19,9,17,53,6,305,198,0,0,6,34,362,42,2868,2039,0,0,311,2910
19,10,51,119,11,1103,684,16,37,18,116,952,178,10694,7418,91,207,1114,10872
19,11,7,0,0,0,0,0,0,1,20,0,0,0,0,0,0,0,0
19,13,31,74,10,671,357,6,20,11,65,513,19,5956,3606,20,73,681,5975
19,14,2,0,0,0,0,0,0,1,9,0,0,0,0,0,0,0,0
19,15,16,0,0,0,0,0,0,6,32,0,0,0,0,0,0,0,0
19,16,4,0,0,0,0,0,0,1,8,0,0,0,0,0,0,0,0
19,17,16,0,2,187,91,0,0,6,38,0,2,1726,738,0,0,189,1728
19,18,4,0,0,0,0,0,0,1,8,0,0,0,0,0,0,0,0
19,19,7,0,0,0,0,0,0,2,14,0,0,0,0,0,0,0,0
19,21,14,16,0,242,208,0,0,4,30,161,0,2835,2454,0,0,242,2835
19,22,11,0,0,0,0,0,0,3,31,0,0,0,0,0,0,0,0
19,24,7,0,0,0,0,0,0,2,14,0,0,0,0,0,0,0,0
19,25,13,0,0,0,0,0,0,6,33,0,0,0,0,0,0,0,0
19,27,1,0,0,0,0,0,0,1,3,0,0,0,0,0,0,0,0
19,28,5,0,0,0,0,0,0,2,14,0,0,0,0,0,0,0,0
19,30,2,0,0,0,0,0,0,1,4,0,0,0,0,0,0,0,0
19,31,9,13,0,201,136,0,0,3,22,91,0,2016,1378,0,0,201,2016
19,33,8,0,0,0,0,0,0,1,16,0,0,0,0,0,0,0,0
19,34,21,17,50,311,123,14,6,9,54,95,133,2363,1270,66,21,361,2496
19,35,3,0,0,0,0,0,0,1,6,0,0,0,0,0,0,0,0
19,36,4,0,0,0,0,0,0,2,8,0,0,0,0,0,0,0,0
19,37,1,0,0,0,0,0,0,1,6,0,0,0,0,0,0,0,0
19,50,6,0,0,0,0,0,0,2,12,0,0,0,0,0,0,0,0
20,10,81,135,0,1323,826,39,25,26,172,1119,0,12674,8328,267,140,1323,12674
20,13,20,49,0,420,234,33,2,8,45,399,0,3713,2344,209,14,420,3713
20,16,42,43,32,746,451,26,0,18,90,361,120,7607,5087,230,0,778,7727
20,21,17,0,0,0,0,0,0,5,37,0,0,0,0,0,0,0,0
20,23,1,0,0,0,0,0,0,1,2,0,0,0,0,0,0,0,0
20,24,17,16,36,308,162,29,14,10,40,134,183,2693,1588,83,89,344,2876
20,27,7,10,7,118,72,0,3,3,14,64,16,1225,869,0,15,125,1241
20,28,10,52,0,379,225,11,0,5,34,376,0,3534,2252,77,0,379,3534
20,29,5,14,14,89,55,0,0,3,18,133,48,810,484,0,0,103,858
20,31,6,0,0,0,0,0,0,2,12,0,0,0,0,0,0,0,0
20,32,15,35,14,260,156,5,0,6,35,246,80,2214,1420,37,0,274,2294
20,33,16,51,160,468,54,84,4,3,42,202,232,2447,188,215,4,628,2679
20,39,2,0,0,0,0,0,0,1,4,0,0,0,0,0,0,0,0
20,50,20,0,0,0,0,0,0,7,42,0,0,0,0,0,0,0,0
20,52,5,0,0,0,0,0,0,4,10,0,0,0,0,0,0,0,0
20,56,4,0,0,0,0,0,0,1,8,0,0,0,0,0,0,0,0
20,58,1,0,0,0,0,0,0,1,4,0,0,0,0,0,0,0,0
21,4,3,0,0,0,0,0,0,1,12,0,0,0,0,0,0,0,0
21,6,9,0,0,0,0,0,0,1,22,0,0,0,0,0,0,0,0
21,8,7,0,0,0,0,0,0,2,14,0,0,0,0,0,0,0,0
21,9,12,15,7,160,123,0,0,4,24,105,49,1593,1265,0,0,167,1642
21,12,7,0,0,0,0,0,0,2,14,0,0,0,0,0,0,0,0
21,13,14,0,0,0,0,0,0,6,41,0,0,0,0,0,0,0,0
21,15,25,0,0,0,0,0,0,8,55,0,0,0,0,0,0,0,0
21,18,7,0,0,0,0,0,0,3,18,0,0,0,0,0,0,0,0
21,20,29,99,19,704,411,0,2,9,68,779,125,6641,4183,11,16,723,6766
21,21,8,0,0,0,0,0,0,2,20,0,0,0,0,0,0,0,0
21,23,3,0,0,0,0,0,0,1,6,0,0,0,0,0,0,0,0
21,25,3,0,0,0,0,0,0,1,6,0,0,0,0,0,0,0,0
21,32,10,0,1,108,67,0,0,3,26,0,7,1222,774,0,0,109,1229
21,35,1,0,0,0,0,0,0,1,4,0,0,0,0,0,0,0,0
21,39,1,0,0,0,0,0,0,1,2,0,0,0,0,0,0,0,0
21,46,6,0,0,0,0,0,0,2,16,0,0,0,0,0,0,0,0
21,48,7,0,0,0,0,0,0,2,14,0,0,0,0,0,0,0,0
21,51,4,0,0,0,0,0,0,1,8,0,0,0,0,0,0,0,0
22,8,21,12,17,397,228,20,10,10,48,58,89,3909,2554,150,87,414,3998
22,11,2,0,0,0,0,0,0,1,4,0,0,0,0,0,0,0,0
22,22,9,0,0,0,0,0,0,3,18,0,0,0,0,0,0,0,0
22,24,22,13,2,619,443,11,0,8,79,101,10,6116,4486,82,0,621,6126
22,27,3,0,0,0,0,0,0,2,15,0,0,0,0,0,0,0,0
22,29,5,0,0,0,0,0,0,2,10,0,0,0,0,0,0,0,0
22,30,4,0,0,0,0,0,0,2,12,0,0,0,0,0,0,0,0
22,34,41,78,2236,1543,171,401,111,12,87,210,4370,5044,447,800,165,3779,9414
22,39,4,0,0,0,0,0,0,1,8,0,0,0,0,0,0,0,0
22,50,3,0,0,0,0,0,0,2,8,0,0,0,0,0,0,0,0
22,53,9,26,6,196,55,2,8,4,20,203,12,1679,573,20,13,202,1691
22,55,9,36,8,358,184,0,2,4,19,351,16,2877,1553,0,2,366,2893
23,0,1,0,0,0,0,0,0,1,2,0,0,0,0,0,0,0,0
23,1,2,0,0,0,0,0,0,2,8,0,0,0,0,0,0,0,0
23,4,12,18,0,177,75,0,0,5,31,116,0,1638,838,0,0,177,1638
23,6,3,0,0,0,0,0,0,1,6,0,0,0,0,0,0,0,0
23,7,28,62,29,649,304,49,5,12,59,394,77,5270,3258,201,34,678,5347
23,10,11,14,0,191,127,0,0,4,24,86,0,2048,1477,0,0,191,2048
23,11,2,0,0,0,0,0,0,1,4,0,0,0,0,0,0,0,0
23,15,3,0,0,0,0,0,0,2,6,0,0,0,0,0,0,0,0
23,19,11,32,26,296,135,20,8,4,22,259,38,1965,1156,79,14,322,2003
23,20,9,16,15,190,73,14,2,4,20,128,44,1640,823,48,4,205,1684
23,21,1,0,0,0,0,0,0,1,4,0,0,0,0,0,0,0,0
23,23,2,0,0,0,0,0,0,1,4,0,0,0,0,0,0,0,0
23,24,13,0,0,0,0,0,0,5,31,0,0,0,0,0,0,0,0
23,30,6,13,7,163,83,0,4,3,15,74,18,1257,861,0,8,170,1275
23,32,3,0,0,0,0,0,0,2,10,0,0,0,0,0,0,0,0
23,42,3,0,0,0,0,0,0,2,7,0,0,0,0,0,0,0,0
23,43,1,0,0,0,0,0,0,1,2,0,0,0,0,0,0,0,0
23,45,3,0,0,0,0,0,0,1,5,0,0,0,0,0,0,0,0
23,48,1,0,0,0,0,0,0,1,2,0,0,0,0,0,0,0,0
23,53,100,643,1749,5640,599,587,328,17,202,1464,3514,14641,1865,1047,436,7389,18155
24,0,10,0,0,0,0,0,0,5,31,0,0,0,0,0,0,0,0
24,2,4,4,3,91,47,9,3,3,10,24,21,726,496,40,6,94,747
24,3,1,0,0,0,0,0,0,1,3,0,0,0,0,0,0,0,0
24,4,2,0,0,0,0,0,0,1,6,0,0,0,0,0,0,0,0
24,6,10,0,0,0,0,0,0,4,20,0,0,0,0,0,0,0,0
24,10,2,0,0,0,0,0,0,1,6,0,0,0,0,0,0,0,0
24,11,20,69,0,450,284,4,0,9,49,490,0,4467,3111,48,0,450,4467
24,13,9,53,0,228,93,7,0,5,24,353,0,1976,951,56,0,228,1976
24,15,45,173,235,1160,656,15,70,16,101,1089,334,10501,6789,90,190,1395,10835
24,20,7,0,0,0,0,0,0,3,14,0,0,0,0,0,0,0,0
24,21,15,0,0,0,0,0,0,5,35,0,0,0,0,0,0,0,0
24,23,3,0,0,0,0,0,0,1,7,0,0,0,0,0,0,0,0
24,24,2,0,0,0,0,0,0,1,7,0,0,0,0,0,0,0,0
24,27,6,0,0,0,0,0,0,3,14,0,0,0,0,0,0,0,0
24,34,7,7,132,167,43,29,2,4,17,40,588,1042,318,243,2,299,1630
24,36,7,0,0,0,0,0,0,2,18,0,0,0,0,0,0,0,0
24,45,1,0,0,0,0,0,0,1,4,0,0,0,0,0,0,0,0
24,49,2,0,0,0,0,0,0,1,4,0,0,0,0,0,0,0,0
24,50,3,0,0,0,0,0,0,1,6,0,0,0,0,0,0,0,0
24,51,1,0,0,0,0,0,0,1,3,0,0,0,0,0,0,0,0
24,53,10,0,0,0,0,0,0,3,19,0,0,0,0,0,0,0,0
24,54,6,0,0,0,0,0,0,2,12,0,0,0,0,0,0,0,0
24,55,6,0,0,0,0,0,0,3,16,0,0,0,0,0,0,0,0
25,0,2,0,0,0,0,0,0,2,6,0,0,0,0,0,0,0,0
25,3,99,120,21,2040,1327,126,25,43,239,844,103,19351,13960,834,67,2061,19454
25,7,2,0,0,0,0,0,0,1,4,0,0,0,0,0,0,0,0
25,8,34,143,43,725,429,20,0,11,78,908,271,6314,4292,119,0,768,6585
25,10,15,0,0,0,0,0,0,8,44,0,0,0,0,0,0,0,0
25,15,3,0,0,0,0,0,0,1,5,0,0,0,0,0,0,0,0
25,17,7,0,0,0,0,0,0,4,16,0,0,0,0,0,0,0,0
25,18,56,165,19,934,359,57,51,15,112,1040,142,7311,3082,286,145,953,7453
25,19,1,0,0,0,0,0,0,1,3,0,0,0,0,0,0,0,0
25,20,9,0,0,104,75,11,0,3,19,0,0,989,830,54,0,104,989
25,21,2,0,0,0,0,0,0,1,8,0,0,0,0,0,0,0,0
25,37,5,0,0,0,0,0,0,2,10,0,0,0,0,0,0,0,0
25,51,3,0,0,0,0,0,0,1,6,0,0,0,0,0,0,0,0
25,52,3,0,0,0,0,0,0,2,6,0,0,0,0,0,0,0,0
25,54,2,0,0,0,0,0,0,1,4,0,0,0,0,0,0,0,0
26,3,2,0,0,0,0,0,0,1,4,0,0,0,0,0,0,0,0
26,8,30,74,45,611,174,92,19,8,67,482,85,3304,1223,481,41,656,3389
26,9,46,109,50,910,524,29,8,19,104,605,132,7448,4894,127,50,960,7580
26,14,4,0,16,95,43,22,0,3,12,0,52,881,495,100,0,111,933
26,15,31,36,1,578,444,10,0,12,74,302,1,5908,4840,70,0,579,5909
26,17,6,0,0,0,0,0,0,1,17,0,0,0,0,0,0,0,0
26,21,6,0,0,0,0,0,0,2,12,0,0,0,0,0,0,0,0
26,29,3,0,0,0,0,0,0,1,6,0,0,0,0,0,0,0,0
26,30,3,0,0,0,0,0,0,1,6,0,0,0,0,0,0,0,0
26,32,1,0,0,0,0,0,0,1,4,0,0,0,0,0,0,0,0
26,35,3,0,0,0,0,0,0,1,6,0,0,0,0,0,0,0,0
26,41,5,0,0,0,0,0,0,2,12,0,0,0,0,0,0,0,0
26,46,4,0,0,0,0,0,0,2,8,0,0,0,0,0,0,0,0
26,48,3,0,0,0,0,0,0,2,6,0,0,0,0,0,0,0,0
26,49,7,0,0,0,0,0,0,3,14,0,0,0,0,0,0,0,0
27,3,9,0,0,0,0,0,0,3,18,0,0,0,0,0,0,0,0
27,4,4,0,0,0,0,0,0,2,7,0,0,0,0,0,0,0,0
27,8,3,0,0,0,0,0,0,2,14,0,0,0,0,0,0,0,0
27,9,5,0,0,0,0,0,0,4,20,0,0,0,0,0,0,0,0
27,11,1,0,0,0,0,0,0,1,4,0,0,0,0,0,0,0,0
27,15,13,5,3,256,180,0,0,8,29,27,9,2532,1829,0,0,259,2541
27,17,7,0,0,0,0,0,0,2,14,0,0,0,0,0,0,0,0
27,18,4,0,0,0,0,0,0,2,10,0,0,0,0,0,0,0,0
27,19,15,0,0,0,0,0,0,5,36,0,0,0,0,0,0,0,0
27,22,5,0,0,0,0,0,0,2,10,0,0,0,0,0,0,0,0
27,27,2,0,0,0,0,0,0,2,10,0,0,0,0,0,0,0,0
27,32,2,0,0,0,0,0,0,1,4,0,0,0,0,0,0,0,0
27,33,1,0,0,0,0,0,0,1,2,0,0,0,0,0,0,0,0
27,38,2,0,0,0,0,0,0,1,8,0,0,0,0,0,0,0,0
27,39,6,0,0,0,0,0,0,2,16,0,0,0,0,0,0,0,0
27,45,5,0,0,0,0,0,0,4,16,0,0,0,0,0,0,0,0
27,49,14,0,0,75,38,0,0,7,25,0,0,602,364,0,0,75,602
27,53,2,0,0,0,0,0,0,1,4,0,0,0,0,0,0,0,0
28,1,22,30,12,461,343,10,0,8,52,213,54,4627,3800,59,0,473,4681
28,3,14,23,15,245,183,10,0,7,30,161,81,2686,2165,83,0,260,2767
28,4,3,0,0,0,0,0,0,1,6,0,0,0,0,0,0,0,0
28,8,37,64,2,748,460,38,12,15,80,486,6,6599,4432,182,45,750,6605
28,9,41,71,39,606,371,9,0,15,85,560,51,5919,3753,57,0,645,5970
28,15,9,0,0,0,0,0,0,4,18,0,0,0,0,0,0,0,0
28,16,31,42,1,615,418,23,9,12,66,311,13,5752,4333,122,58,616,5765
28,17,3,0,0,0,0,0,0,1,6,0,0,0,0,0,0,0,0
28,18,4,0,0,0,0,0,0,2,8,0,0,0,0,0,0,0,0
28,23,11,10,5,192,95,9,18,4,24,70,63,1584,1005,23,38,197,1647
28,27,2,0,0,0,0,0,0,1,8,0,0,0,0,0,0,0,0
28,28,7,68,4,343,207,4,0,4,28,286,11,2699,1891,24,0,347,2710
28,30,3,0,0,0,0,0,0,1,6,0,0,0,0,0,0,0,0
28,32,20,24,78,450,112,78,20,9,46,104,178,2226,889,257,32,528,2404
28,41,5,0,0,0,0,0,0,2,12,0,0,0,0,0,0,0,0
28,42,1,0,0,0,0,0,0,1,4,0,0,0,0,0,0,0,0
28,52,2,0,0,0,0,0,0,2,6,0,0,0,0,0,0,0,0
28,54,2,0,0,0,0,0,0,1,4,0,0,0,0,0,0,0,0
28,55,2,0,0,0,0,0,0,1,7,0,0,0,0,0,0,0,0
28,58,1,0,0,0,0,0,0,1,2,0,0,0,0,0,0,0,0
29,0,78,191,88,1567,711,85,35,30,193,1504,616,12778,6499,503,188,1655,13394
29,1,31,36,1,633,342,66,6,15,84,284,14,5985,3775,425,10,634,5999
29,2,9,27,0,198,128,2,6,6,22,181,0,2215,1637,16,84,198,2215
29,5,2,0,0,0,0,0,0,2,5,0,0,0,0,0,0,0,0
29,10,15,57,6,382,288,8,1,8,36,496,37,3698,2883,56,7,388,3735
29,11,7,43,1,145,87,0,0,5,16,395,1,1511,941,0,0,146,1512
29,15,11,17,0,163,85,9,3,6,21,133,0,1548,948,34,21,163,1548
29,23,4,0,0,0,0,0,0,2,14,0,0,0,0,0,0,0,0
29,26,2,0,0,0,0,0,0,1,5,0,0,0,0,0,0,0,0
29,27,2,0,0,0,0,0,0,2,8,0,0,0,0,0,0,0,0
29,29,6,8,1,122,94,0,0,3,13,56,5,1331,1066,0,0,123,1336
29,30,19,4,65,305,182,6,4,9,40,28,254,2565,1812,38,10,370,2819
29,31,2,0,0,0,0,0,0,1,8,0,0,0,0,0,0,0,0
29,49,1,0,0,0,0,0,0,1,2,0,0,0,0,0,0,0,0
29,51,3,0,0,0,0,0,0,1,6,0,0,0,0,0,0,0,0
29,52,7,0,0,0,0,0,0,5,18,0,0,0,0,0,0,0,0
30,2,84,104,29,1289,763,43,22,36,192,624,190,11201,7531,347,102,1318,11391
30,3,3,0,0,0,0,0,0,1,6,0,0,0,0,0,0,0,0
30,4,4,0,0,0,0,0,0,1,8,0,0,0,0,0,0,0,0
30,5,523,569,3357,10026,1764,976,2455,95,1530,2964,18966,65359,16161,5711,14782,13383,84325
30,10,46,70,1,863,596,14,6,20,103,544,7,8307,6118,98,39,864,8314
30,11,25,81,0,536,349,2,2,13,65,515,0,5309,3942,14,14,536,5309
30,14,31,141,36,938,397,24,31,11,69,690,86,6059,3574,97,61,974,6145
30,20,1,0,0,0,0,0,0,1,2,0,0,0,0,0,0,0,0
30,28,14,65,0,285,149,3,4,6,34,261,0,2262,1481,9,28,285,2262
30,29,4,0,0,0,0,0,0,2,10,0,0,0,0,0,0,0,0
30,30,3,0,0,0,0,0,0,1,6,0,0,0,0,0,0,0,0
30,31,2,0,0,0,0,0,0,2,6,0,0,0,0,0,0,0,0
30,35,4,0,0,0,0,0,0,1,8,0,0,0,0,0,0,0,0
30,37,1,0,0,0,0,0,0,1,4,0,0,0,0,0,0,0,0
30,47,12,73,104,812,160,84,22,9,28,193,178,1969,620,130,46,916,2147
30,49,1,0,0,0,0,0,0,1,2,0,0,0,0,0,0,0,0
30,52,29,0,0,0,0,0,0,18,65,0,0,0,0,0,0,0,0
30,53,6,0,0,0,0,0,0,2,12,0,0,0,0,0,0,0,0
30,57,3,0,0,0,0,0,0,1,7,0,0,0,0,0,0,0,0
31,2,4,0,0,0,0,0,0,2,12,0,0,0,0,0,0,0,0
31,3,8,0,0,64,17,6,37,3,23,0,0,731,183,82,410,64,731
31,17,24,21,8,453,303,5,0,10,54,253,53,4644,3307,10,0,461,4697
31,18,12,0,0,0,0,0,0,6,35,0,0,0,0,0,0,0,0
31,19,2,0,0,0,0,0,0,2,10,0,0,0,0,0,0,0,0
31,20,14,35,7,307,193,5,0,7,39,337,49,3112,2015,35,0,314,3161
31,21,8,0,0,0,0,0,0,5,24,0,0,0,0,0,0,0,0
31,22,3,0,0,0,0,0,0,1,6,0,0,0,0,0,0,0,0
31,24,4,0,0,0,0,0,0,2,7,0,0,0,0,0,0,0,0
31,29,5,0,0,73,57,0,0,3,14,0,0,849,672,0,0,73,849
31,30,8,17,0,196,124,0,0,3,20,203,0,1767,1136,0,0,196,1767
31,33,4,0,0,0,0,0,0,1,9,0,0,0,0,0,0,0,0
31,35,1,0,0,0,0,0,0,1,4,0,0,0,0,0,0,0,0
31,42,7,0,0,0,0,0,0,3,19,0,0,0,0,0,0,0,0
31,48,7,0,0,0,0,0,0,2,14,0,0,0,0,0,0,0,0
32,1,2,0,0,0,0,0,0,1,6,0,0,0,0,0,0,0,0
32,5,9,45,0,271,157,38,6,3,23,325,0,2376,1590,143,40,271,2376
32,6,143,315,3,2986,1925,109,32,63,321,2316,10,28137,19792,743,212,2989,28147
32,7,22,56,0,585,328,123,0,10,52,381,0,5168,3392,747,0,585,5168
32,11,4,22,0,97,36,9,3,3,10,150,0,843,445,43,21,97,843
32,18,6,0,0,0,0,0,0,3,13,0,0,0,0,0,0,0,0
32,19,6,8,0,111,53,0,5,3,17,56,0,1156,540,0,70,111,1156
32,20,8,48,15,286,138,10,11,5,29,279,67,2453,1456,26,51,301,2520
32,21,3,0,0,0,0,0,0,2,12,0,0,0,0,0,0,0,0
32,23,30,59,27,814,417,91,21,17,81,276,91,5972,3985,418,21,841,6063
32,24,42,55,2,794,526,14,9,16,93,467,14,7812,5632,113,57,796,7826
32,27,2,0,0,0,0,0,0,1,4,0,0,0,0,0,0,0,0
32,28,3,0,0,0,0,0,0,1,6,0,0,0,0,0,0,0,0
32,29,2,0,0,0,0,0,0,1,5,0,0,0,0,0,0,0,0
32,30,7,0,0,0,0,0,0,2,13,0,0,0,0,0,0,0,0
32,31,3,0,0,0,0,0,0,2,12,0,0,0,0,0,0,0,0
32,32,12,116,19,655,222,29,40,4,27,523,49,3980,2054,64,70,674,4029
32,34,1,0,0,0,0,0,0,1,6,0,0,0,0,0,0,0,0
32,49,7,49,56,506,27,187,41,6,20,217,153,1574,137,361,86,562,1727
32,50,6,0,0,0,0,0,0,2,10,0,0,0,0,0,0,0,0
32,52,3,0,0,0,0,0,0,2,8,0,0,0,0,0,0,0,0
33,6,11,4,14,233,73,40,0,3,30,28,96,1704,696,228,0,247,1800
33,10,27,107,37,655,296,16,2,14,79,719,143,5150,2797,96,2,692,5293
33,11,21,79,3,485,296,7,0,11,51,575,11,4324,2910,81,0,488,4335
33,13,36,47,0,843,633,12,0,19,110,406,0,8539,6818,94,0,843,8539
33,17,2,0,0,0,0,0,0,1,4,0,0,0,0,0,0,0,0
33,18,36,52,11,585,413,20,2,14,83,379,65,6085,4560,189,10,596,6150
33,19,11,0,0,0,0,0,0,5,33,0,0,0,0,0,0,0,0
33,20,7,4,0,197,105,29,11,6,23,20,0,1676,1058,180,33,197,1676
33,21,13,48,0,237,140,8,4,7,29,382,0,2277,1482,31,28,237,2277
33,23,7,0,0,0,0,0,0,3,17,0,0,0,0,0,0,0,0
33,24,4,0,0,0,0,0,0,2,9,0,0,0,0,0,0,0,0
33,26,1,0,0,0,0,0,0,1,6,0,0,0,0,0,0,0,0
33,27,61,181,42,1365,760,26,59,23,156,1152,102,11877,7398,245,174,1407,11979
33,29,3,0,0,0,0,0,0,2,14,0,0,0,0,0,0,0,0
33,30,3,0,0,0,0,0,0,2,12,0,0,0,0,0,0,0,0
33,34,1,0,0,0,0,0,0,1,6,0,0,0,0,0,0,0,0
33,42,7,0,0,0,0,0,0,2,14,0,0,0,0,0,0,0,0
33,44,1,0,0,0,0,0,0,1,4,0,0,0,0,0,0,0,0
33,47,1,0,0,0,0,0,0,1,2,0,0,0,0,0,0,0,0
33,56,1,0,0,0,0,0,0,1,3,0,0,0,0,0,0,0,0
34,6,6,32,0,242,66,53,4,3,26,218,0,1940,711,430,24,242,1940
34,10,2,0,0,0,0,0,0,1,4,0,0,0,0,0,0,0,0
34,12,4,29,0,120,71,0,1,3,10,176,0,1020,735,0,7,120,1020
34,15,10,0,0,0,0,0,0,5,23,0,0,0,0,0,0,0,0
34,16,1,0,0,0,0,0,0,1,4,0,0,0,0,0,0,0,0
34,17,6,0,0,0,0,0,0,5,16,0,0,0,0,0,0,0,0
34,18,9,19,26,251,150,18,4,6,22,89,93,1953,1471,85,10,277,2046
34,19,40,97,55,756,415,61,15,21,99,514,115,6522,4086,320,69,811,6637
34,20,1,0,0,0,0,0,0,1,4,0,0,0,0,0,0,0,0
34,22,3,0,0,0,0,0,0,2,7,0,0,0,0,0,0,0,0
34,24,17,30,0,421,267,7,0,8,53,205,0,3898,2816,33,0,421,3898
34,25,2,0,0,0,0,0,0,1,4,0,0,0,0,0,0,0,0
34,26,4,0,0,0,0,0,0,2,9,0,0,0,0,0,0,0,0
34,30,1,0,0,0,0,0,0,1,6,0,0,0,0,0,0,0,0
34,32,4,0,0,0,0,0,0,2,12,0,0,0,0,0,0,0,0
34,34,4,0,0,0,0,0,0,2,8,0,0,0,0,0,0,0,0
34,35,2,0,0,0,0,0,0,1,4,0,0,0,0,0,0,0,0
34,41,5,0,0,0,0,0,0,2,10,0,0,0,0,0,0,0,0
34,47,2,0,0,0,0,0,0,1,11,0,0,0,0,0,0,0,0
34,49,1,0,0,0,0,0,0,1,6,0,0,0,0,0,0,0,0
35,11,2,0,0,0,0,0,0,1,4,0,0,0,0,0,0,0,0
35,13,6,0,0,0,0,0,0,1,14,0,0,0,0,0,0,0,0
35,14,8,8,0,119,60,4,4,4,17,48,0,1151,658,32,28,119,1151
35,15,25,33,58,531,370,36,2,11,60,200,209,5051,3991,230,8,589,5260
35,16,46,53,20,805,528,27,20,19,108,382,162,8160,5652,232,77,825,8322
35,17,40,35,11,849,529,42,3,22,125,229,52,8561,5988,357,21,860,8613
35,18,3,0,0,0,0,0,0,2,8,0,0,0,0,0,0,0,0
35,19,42,75,10,965,622,24,7,19,118,566,82,9190,6717,204,37,975,9272
35,20,2,0,0,0,0,0,0,2,8,0,0,0,0,0,0,0,0
35,24,2,0,0,0,0,0,0,2,11,0,0,0,0,0,0,0,0
35,28,3,0,0,0,0,0,0,2,8,0,0,0,0,0,0,0,0
35,29,1,0,0,0,0,0,0,1,4,0,0,0,0,0,0,0,0
35,31,4,0,0,0,0,0,0,2,10,0,0,0,0,0,0,0,0
35,33,1,0,0,0,0,0,0,1,5,0,0,0,0,0,0,0,0
35,35,2,0,0,0,0,0,0,1,4,0,0,0,0,0,0,0,0
35,40,1,0,0,0,0,0,0,1,4,0,0,0,0,0,0,0,0
35,54,8,0,0,0,0,0,0,2,16,0,0,0,0,0,0,0,0
36,5,207,0,0,0,0,0,0,17,584,0,0,0,0,0,0,0,0
36,10,17,0,0,0,0,0,0,7,39,0,0,0,0,0,0,0,0
36,12,11,8,8,133,90,12,4,6,27,77,36,1206,780,144,40,141,1242
36,16,12,45,16,307,115,54,9,4,27,288,103,1855,763,342,23,323,1958
36,17,17,26,16,611,169,56,32,9,39,189,55,4034,1336,387,166,627,4089
36,18,18,0,0,0,0,0,0,10,54,0,0,0,0,0,0,0,0
36,19,48,75,45,994,450,78,31,32,135,497,328,8227,4330,530,94,1039,8555
36,20,35,59,82,711,423,32,0,18,96,541,587,6539,4296,134,0,793,7126
36,22,18,56,16,378,203,12,0,11,66,503,78,3641,2131,69,0,394,3719
36,23,42,91,23,967,678,36,3,22,131,699,205,9289,6903,265,15,990,9494
36,24,39,59,30,814,503,42,9,20,119,428,183,7805,5444,267,32,844,7988
36,25,17,31,11,377,227,5,19,7,49,217,72,3777,2581,23,97,388,3849
36,27,3,0,0,0,0,0,0,2,13,0,0,0,0,0,0,0,0
36,28,8,26,0,182,134,0,0,4,16,244,0,1841,1384,0,0,182,1841
36,29,3,0,0,0,0,0,0,1,6,0,0,0,0,0,0,0,0
36,41,4,0,0,0,0,0,0,1,8,0,0,0,0,0,0,0,0
36,42,3,0,0,0,0,0,0,1,8,0,0,0,0,0,0,0,0
37,7,38,0,0,0,0,0,0,18,98,0,0,0,0,0,0,0,0
37,14,12,13,2,222,113,11,7,8,27,83,8,1802,1081,32,31,224,1810
37,16,22,31,4,352,190,26,4,8,50,165,8,3157,2267,94,8,356,3165
37,17,67,129,48,1668,935,152,38,33,169,907,118,14678,9939,673,166,1716,14796
37,18,30,32,44,827,294,151,31,14,86,124,108,5755,2829,690,128,871,5863
37,19,5,9,0,128,58,22,9,5,17,86,0,1049,549,158,63,128,1049
37,20,101,299,635,3890,1082,893,128,57,243,901,1613,17270,8352,2305,263,4525,18883
37,22,39,154,84,996,522,109,5,22,129,962,404,8598,5516,522,15,1080,9002
37,25,17,0,0,0,0,0,0,5,40,0,0,0,0,0,0,0,0
37,27,25,0,0,0,0,0,0,10,55,0,0,0,0,0,0,0,0
37,28,20,0,0,0,0,0,0,11,48,0,0,0,0,0,0,0,0
37,31,7,0,0,0,0,0,0,4,23,0,0,0,0,0,0,0,0
37,32,6,6,17,85,64,0,0,3,14,56,303,858,713,0,0,102,1161
37,39,4,0,0,0,0,0,0,1,8,0,0,0,0,0,0,0,0
37,42,4,0,0,0,0,0,0,2,10,0,0,0,0,0,0,0,0
37,46,12,0,0,0,0,0,0,4,27,0,0,0,0,0,0,0,0
38,5,14,58,33,444,145,57,13,10,40,309,188,3203,1238,486,90,477,3391
38,6,19,68,4,414,222,17,0,7,44,527,8,3893,2251,111,0,418,3901
38,7,6,0,0,128,73,6,0,3,16,0,0,1105,653,60,0,128,1105
38,14,3,0,0,0,0,0,0,1,8,0,0,0,0,0,0,0,0
38,16,21,53,2,494,275,16,4,11,44,406,2,4533,3081,113,16,496,4535
38,17,10,71,0,370,225,0,0,5,32,440,0,3155,2143,0,0,370,3155
38,18,7,25,8,311,116,30,13,5,21,106,26,1648,939,119,22,319,1674
38,19,18,56,34,724,293,110,19,11,56,294,95,4921,2670,469,61,758,5016
38,20,10,0,0,0,0,0,0,3,28,0,0,0,0,0,0,0,0
38,28,47,74,53,896,387,46,13,19,118,580,174,8007,3973,271,68,949,8181
38,32,7,6,0,92,35,2,0,4,14,76,0,901,383,14,0,92,901
38,33,9,0,0,0,0,0,0,4,22,0,0,0,0,0,0,0,0
38,35,5,0,0,0,0,0,0,1,12,0,0,0,0,0,0,0,0
38,36,7,19,0,205,128,22,0,3,15,157,0,2000,1460,127,0,205,2000
38,40,3,0,0,0,0,0,0,1,6,0,0,0,0,0,0,0,0
38,44,3,0,0,0,0,0,0,1,6,0,0,0,0,0,0,0,0
39,11,18,53,19,582,259,67,7,7,61,324,80,4203,2263,354,24,601,4283
39,12,22,118,2,583,419,2,0,12,70,961,14,5489,4215,12,0,585,5503
39,14,2,0,0,0,0,0,0,1,7,0,0,0,0,0,0,0,0
39,16,14,6,0,238,158,12,2,8,33,52,0,2157,1553,74,14,238,2157
39,17,1,0,0,0,0,0,0,1,6,0,0,0,0,0,0,0,0
39,18,22,33,25,737,264,87,13,9,70,174,190,5255,2600,258,42,762,5445
39,19,2,0,0,0,0,0,0,2,6,0,0,0,0,0,0,0,0
39,20,4,11,7,133,22,28,6,4,10,52,19,679,115,142,28,140,698
39,21,21,62,1,484,257,43,16,10,57,378,1,3458,2294,163,29,485,3459
39,24,3,0,0,0,0,0,0,1,9,0,0,0,0,0,0,0,0
39,25,7,0,0,0,0,0,0,4,27,0,0,0,0,0,0,0,0
39,36,2,0,0,0,0,0,0,1,4,0,0,0,0,0,0,0,0
39,45,6,0,0,0,0,0,0,2,12,0,0,0,0,0,0,0,0
39,46,1,0,0,0,0,0,0,1,2,0,0,0,0,0,0,0,0
39,59,3,0,0,0,0,0,0,1,6,0,0,0,0,0,0,0,0
40,7,4,0,0,0,0,0,0,1,8,0,0,0,0,0,0,0,0
40,10,29,212,8,932,487,10,2,8,81,1514,41,8135,4878,80,14,940,8176
40,11,14,11,4,238,130,11,0,5,26,69,12,1974,1269,69,0,242,1986
40,12,6,0,0,0,0,0,0,3,14,0,0,0,0,0,0,0,0
40,13,394,0,0,0,0,0,0,34,1171,0,0,0,0,0,0,0,0
40,14,35,0,0,0,0,0,0,19,107,0,0,0,0,0,0,0,0
40,15,2,0,0,0,0,0,0,1,4,0,0,0,0,0,0,0,0
40,16,2535,26754,6661,133720,33332,11260,13014,12,5851,135676,18815,814100,249741,50084,47382,140381,832915
40,17,123,630,212,4865,1344,773,222,71,332,3184,726,31053,10996,3865,1171,5077,31779
40,18,917,7136,1065,39457,12071,3267,1793,334,2261,36645,3549,261037,105009,17695,7947,40522,264586
40,20,67,228,17,1580,985,77,7,23,152,1595,66,12953,8890,263,33,1597,13019
40,21,1,0,0,0,0,0,0,1,5,0,0,0,0,0,0,0,0
40,26,41,47,127,648,161,142,4,16,110,204,559,3426,1144,702,9,775,3985
40,34,6,0,0,0,0,0,0,2,12,0,0,0,0,0,0,0,0
40,36,4,0,0,0,0,0,0,1,8,0,0,0,0,0,0,0,0
41,7,2,0,0,0,0,0,0,1,4,0,0,0,0,0,0,0,0
41,8,47,0,0,0,0,0,0,30,117,0,0,0,0,0,0,0,0
41,9,102,336,44,2907,1333,202,81,53,260,2270,271,23572,13276,1168,393,2951,23843
41,10,97,405,73,2547,1007,196,107,27,218,2224,253,17264,8733,876,619,2620,17517
41,17,24,67,21,776,146,76,110,9,80,323,166,5447,1183,597,745,797,5613
41,18,2,0,0,0,0,0,0,1,6,0,0,0,0,0,0,0,0
41,24,20,0,0,0,0,0,0,9,58,0,0,0,0,0,0,0,0
41,27,1,0,0,0,0,0,0,1,4,0,0,0,0,0,0,0,0
41,28,29,54,4,445,209,26,10,11,63,292,45,4217,2357,124,63,449,4262
41,29,3,0,0,0,0,0,0,1,6,0,0,0,0,0,0,0,0
42,20,34,98,4,654,401,8,7,18,85,751,16,5883,3814,56,49,658,5899
42,24,17,141,152,969,273,238,36,5,39,319,289,2295,650,406,48,1121,2584
42,29,2,0,0,0,0,0,0,1,4,0,0,0,0,0,0,0,0
42,43,9,0,0,0,0,0,0,1,18,0,0,0,0,0,0,0,0
44,23,32,13,2,528,339,29,6,15,89,77,14,4574,3442,93,42,530,4588
44,24,2,0,0,0,0,0,0,2,6,0,0,0,0,0,0,0,0
44,25,5,0,0,0,0,0,0,2,12,0,0,0,0,0,0,0,0
44,63,3,0,0,0,0,0,0,2,6,0,0,0,0,0,0,0,0
44,64,3,0,0,0,0,0,0,3,8,0,0,0,0,0,0,0,0
45,26,1,0,0,0,0,0,0,1,4,0,0,0,0,0,0,0,0
45,27,23,66,6,577,286,29,0,9,56,437,55,4423,2737,95,0,583,4478
45,28,5,0,0,0,0,0,0,1,15,0,0,0,0,0,0,0,0
45,29,2,0,0,0,0,0,0,1,4,0,0,0,0,0,0,0,0
45,30,28,29,10,611,226,76,11,11,78,128,11,4194,2145,312,45,621,4205
45,31,12,0,0,0,0,0,0,7,32,0,0,0,0,0,0,0,0
45,32,25,48,11,614,330,59,10,16,62,298,22,5052,3291,351,40,625,5074
45,34,16,27,3,277,176,17,4,9,40,211,15,2273,1578,95,28,280,2288
45,36,8,15,0,95,58,3,0,3,19,140,0,812,496,12,0,95,812
45,62,4,0,0,0,0,0,0,2,9,0,0,0,0,0,0,0,0
46,29,96,327,30,2814,685,389,90,38,236,1591,88,16843,5437,1600,368,2844,16931
46,32,2,0,0,0,0,0,0,1,6,0,0,0,0,0,0,0,0
46,34,4,0,0,0,0,0,0,3,12,0,0,0,0,0,0,0,0
46,35,7,41,6,235,69,27,4,6,20,176,31,1498,572,136,8,241,1529
46,36,49,181,64,1490,266,176,67,17,127,838,322,9267,2476,1033,412,1554,9589
46,37,12,25,8,142,43,4,2,4,30,113,16,791,265,40,4,150,807
46,40,4,0,0,0,0,0,0,2,10,0,0,0,0,0,0,0,0
47,34,60,239,21,1603,465,166,61,32,157,1284,86,10128,3829,752,254,1624,10214
47,35,380,6238,1235,22102,3359,3091,1835,52,773,26667,3534,92078,20687,11477,6750,23337,95612
47,36,395,2785,361,17652,4250,2395,2278,106,1067,12955,1665,83691,22120,10985,10115,18013,85356
47,37,64,223,32,1631,624,183,46,28,175,1260,112,10186,5123,758,240,1663,10298
47,38,12,0,0,0,0,0,0,3,24,0,0,0,0,0,0,0,0
47,39,3,0,0,0,0,0,0,1,9,0,0,0,0,0,0,0,0
47,40,23,0,0,0,0,0,0,11,75,0,0,0,0,0,0,0,0
47,41,26,0,0,0,0,0,0,11,58,0,0,0,0,0,0,0,0
47,42,20,0,0,0,0,0,0,13,58,0,0,0,0,0,0,0,0
47,43,32,110,117,973,350,86,21,22,104,634,905,6325,3214,526,45,1090,7230
47,44,17,60,30,566,161,38,11,13,57,277,57,3036,1218,96,23,596,3093
47,45,15,0,0,0,0,0,0,6,40,0,0,0,0,0,0,0,0
47,46,3,0,0,0,0,0,0,1,8,0,0,0,0,0,0,0,0
47,54,6,16,6,189,57,27,0,5,19,59,16,930,444,87,0,195,946
47,56,21,101,58,444,158,25,14,7,48,303,148,3274,1431,64,63,502,3422
48,39,399,1192,618,15977,3585,1339,2730,36,1162,4935,2467,63489,16797,4910,11251,16595,65956
48,41,155,621,489,3582,823,320,119,66,364,3658,2280,23507,6502,2117,648,4071,25787
48,42,943,8865,12533,62857,10323,6471,5155,150,2133,34729,30747,222553,53900,21628,13085,75390,253300
48,43,186,547,307,6347,1949,437,177,106,561,2854,1166,39801,16326,2008,582,6654,40967
48,44,137,326,216,3848,900,469,92,52,355,1473,853,20625,6874,1729,424,4064,21478
48,45,45,143,31,1391,558,90,20,26,133,822,66,10418,5069,400,70,1422,10484
48,47,11,26,3,426,154,28,3,7,31,117,15,2839,1436,94,16,429,2854
48,48,1,0,0,0,0,0,0,1,6,0,0,0,0,0,0,0,0
48,56,1,0,0,0,0,0,0,1,2,0,0,0,0,0,0,0,0
48,62,19,0,0,0,0,0,0,6,48,0,0,0,0,0,0,0,0
48,63,1,0,0,0,0,0,0,1,4,0,0,0,0,0,0,0,0
49,43,83,448,183,3408,575,432,159,34,212,1708,564,16208,3711,1887,574,3591,16772
49,44,639,4095,1099,27018,6261,2273,1163,137,1607,16951,3959,110303,30113,7317,4047,28117,114262
49,45,19,222,122,1053,187,116,55,12,56,738,215,4382,1348,291,96,1175,4597
49,46,10,14,5,364,113,22,25,6,35,97,18,2689,997,170,142,369,2707
49,47,1,0,0,0,0,0,0,1,4,0,0,0,0,0,0,0,0
49,50,8,5,9,119,36,14,0,6,22,19,43,1021,362,108,0,128,1064
49,55,2,0,0,0,0,0,0,2,6,0,0,0,0,0,0,0,0
49,61,3,0,0,0,0,0,0,1,6,0,0,0,0,0,0,0,0
50,24,15,54,23,387,124,35,26,11,42,355,181,3186,1185,285,247,410,3367
50,45,354,0,0,0,0,0,0,26,674,0,0,0,0,0,0,0,0
50,46,997,15374,11855,85612,12194,9385,6232,73,1944,52200,27328,267222,53451,23876,13892,97467,294550
50,47,120,467,548,4469,726,504,182,84,321,2028,2442,20885,4724,1636,486,5017,23327
50,48,43,181,43,1311,583,42,13,29,144,1113,271,10070,5204,239,49,1354,10341
50,49,8,23,6,218,55,33,9,5,25,113,16,1064,425,106,19,224,1080
50,50,30,71,66,895,310,169,34,17,81,287,163,4963,2630,537,59,961,5126
50,52,2,0,0,0,0,0,0,1,4,0,0,0,0,0,0,0,0
50,53,10,39,73,432,55,120,21,6,20,141,151,1381,268,314,27,505,1532
50,54,5,0,0,0,0,0,0,3,15,0,0,0,0,0,0,0,0
50,55,9,0,0,0,0,0,0,1,22,0,0,0,0,0,0,0,0
50,56,2,0,0,0,0,0,0,1,4,0,0,0,0,0,0,0,0
51,22,3,0,0,0,0,0,0,2,8,0,0,0,0,0,0,0,0
51,46,10,0,0,0,0,0,0,1,19,0,0,0,0,0,0,0,0
51,47,238,9979,728,17505,2232,1066,374,57,512,44241,2667,78892,13210,3741,1047,18233,81559
51,48,1809,26931,37001,166538,15972,18602,11637,320,3708,90477,78880,493896,73200,45078,24816,203539,572776
51,49,144,1106,1600,8546,1666,1300,351,83,392,3751,4921,32418,9865,3156,688,10146,37339
51,50,19,24,71,599,180,119,12,13,52,101,135,3589,1737,456,46,670,3724
51,51,5,0,0,0,0,0,0,5,18,0,0,0,0,0,0,0,0
51,53,3,0,0,0,0,0,0,2,6,0,0,0,0,0,0,0,0
52,20,1,0,0,0,0,0,0,1,6,0,0,0,0,0,0,0,0
52,48,2,0,0,0,0,0,0,1,8,0,0,0,0,0,0,0,0
52,49,17,34,219,504,51,116,27,10,47,118,660,1861,322,331,76,723,2521
52,50,87,201,389,3912,613,1522,64,62,255,892,1580,15698,4612,3564,262,4301,17278
52,51,26,15,33,698,238,79,10,15,67,111,85,4984,2490,322,38,731,5069
52,62,2,0,0,0,0,0,0,1,4,0,0,0,0,0,0,0,0
53,24,1,0,0,0,0,0,0,1,4,0,0,0,0,0,0,0,0
53,48,2,0,0,0,0,0,0,1,7,0,0,0,0,0,0,0,0
53,49,37,51,641,1248,196,175,108,15,93,200,2230,6335,1431,530,378,1889,8565
53,50,31,51,53,716,262,40,13,22,99,303,180,4913,2213,193,50,769,5093
53,51,52,188,461,3091,444,880,61,26,146,423,968,10333,2302,2129,136,3552,11301
54,48,27,85,45,1112,332,173,15,22,79,435,277,6537,2859,677,48,1157,6814
54,49,24,30,93,484,82,181,10,8,58,107,237,2047,591,516,17,577,2284
54,50,6,11,92,526,35,68,7,4,16,21,188,1231,209,116,15,618,1419
54,51,3,0,0,0,0,0,0,2,6,0,0,0,0,0,0,0,0
54,53,19,37,10,406,172,13,12,7,44,247,19,3144,1735,108,16,416,3163
54,58,1,0,0,0,0,0,0,1,2,0,0,0,0,0,0,0,0
55,0,1,0,0,0,0,0,0,1,2,0,0,0,0,0,0,0,0
55,22,9,0,0,0,0,0,0,2,22,0,0,0,0,0,0,0,0
55,47,1,0,0,0,0,0,0,1,4,0,0,0,0,0,0,0,0
55,48,18,50,35,758,145,77,9,16,51,241,64,3905,1113,211,40,793,3969
55,49,23,40,73,812,217,119,3,17,60,155,268,3808,1587,279,7,885,4076
55,50,7,0,0,0,0,0,0,3,17,0,0,0,0,0,0,0,0
55,53,1,0,0,0,0,0,0,1,4,0,0,0,0,0,0,0,0
55,54,4,0,0,0,0,0,0,2,9,0,0,0,0,0,0,0,0
56,22,72,0,0,0,0,0,0,9,203,0,0,0,0,0,0,0,0
56,47,37,113,304,2593,242,705,131,32,105,435,923,10079,1252,2382,378,2897,11002
56,48,39,88,321,1687,295,356,17,30,108,299,1475,7423,1848,1050,57,2008,8898
56,49,13,7,20,361,59,56,6,12,42,45,34,2013,439,274,12,381,2047
56,50,8,16,50,679,180,80,20,5,22,37,107,2928,1492,252,40,729,3035
56,51,2,0,0,0,0,0,0,1,4,0,0,0,0,0,0,0,0
56,52,7,16,0,143,58,10,0,3,18,174,0,1446,671,74,0,143,1446
56,53,9,12,108,247,132,24,5,6,29,77,228,1789,1469,72,5,355,2017
56,54,9,7,237,232,58,100,14,3,21,37,505,1538,301,988,52,469,2043
57,47,154,0,0,0,0,0,0,10,407,0,0,0,0,0,0,0,0
57,48,9,17,65,478,48,99,12,9,23,35,125,1533,260,285,19,543,1658
57,49,12,51,43,681,63,116,3,12,34,171,120,2270,239,236,21,724,2390
57,50,4,0,0,0,0,0,0,4,12,0,0,0,0,0,0,0,0
57,52,9,28,106,253,47,56,15,5,25,104,278,1024,340,156,19,359,1302
57,53,1,0,0,0,0,0,0,1,4,0,0,0,0,0,0,0,0
57,54,3,0,0,0,0,0,0,1,6,0,0,0,0,0,0,0,0
58,47,11,28,149,548,58,124,7,11,29,81,341,1443,333,221,7,697,1784
58,48,8,13,39,243,54,43,14,8,28,43,271,1076,449,150,23,282,1347
58,49,3,0,0,0,0,0,0,2,6,0,0,0,0,0,0,0,0
58,52,1,0,0,0,0,0,0,1,3,0,0,0,0,0,0,0,0
59,6,2,0,0,0,0,0,0,2,5,0,0,0,0,0,0,0,0
59,7,8,8,1,101,15,7,43,8,16,50,10,1048,161,34,495,102,1058
59,47,108,48,210,1005,97,177,23,9,223,165,1307,2659,293,343,72,1215,3966
59,48,8,1,4,212,81,19,4,5,18,1,8,1322,664,128,16,216,1330
59,49,1,0,0,0,0,0,0,1,2,0,0,0,0,0,0,0,0
59,51,1,0,0,0,0,0,0,1,2,0,0,0,0,0,0,0,0
59,54,2,0,0,0,0,0,0,1,4,0,0,0,0,0,0,0,0
60,6,1,0,0,0,0,0,0,1,3,0,0,0,0,0,0,0,0
60,46,3,2,5,77,7,10,0,3,6,8,16,281,18,62,0,82,297
60,47,53,60,232,1861,207,357,34,43,137,184,600,6240,1276,993,58,2093,6840
60,48,2,0,0,0,0,0,0,2,6,0,0,0,0,0,0,0,0
60,49,11,25,176,1085,89,270,29,9,25,81,379,2648,279,514,55,1261,3027
60,50,3,6,11,73,52,0,0,3,14,14,77,530,371,0,0,84,607
61,5,2379,7904,4181,78371,22031,15962,17060,322,6588,55746,23356,577107,208395,96920,127970,82552,600463
61,6,10,23,19,237,24,117,5,6,23,94,92,1277,156,659,15,256,1369
61,46,664,3781,17612,78871,8644,12963,1810,222,1617,7141,30561,160079,18801,23357,4625,96483,190640
61,47,69,112,299,2846,332,572,21,57,183,271,1061,8946,1137,1768,63,3145,10007
61,48,13,38,231,802,97,290,10,9,33,138,796,2533,508,782,20,1033,3329
61,51,2,0,0,0,0,0,0,1,5,0,0,0,0,0,0,0,0
61,53,4,0,0,0,0,0,0,1,8,0,0,0,0,0,0,0,0
62,1,3,6,13,95,8,42,12,3,8,18,68,528,88,172,59,108,596
62,19,9,0,0,0,0,0,0,2,18,0,0,0,0,0,0,0,0
62,20,344,0,0,0,0,0,0,3,1031,0,0,0,0,0,0,0,0
62,46,77,475,3310,11130,690,1627,240,24,176,833,5277,18193,1551,2473,318,14440,23470
62,47,11,10,59,516,46,66,12,11,24,15,246,1724,212,166,23,575,1970
62,51,1,0,0,0,0,0,0,1,4,0,0,0,0,0,0,0,0
62,53,10,0,0,0,0,0,0,4,24,0,0,0,0,0,0,0,0
62,54,4,0,0,0,0,0,0,2,17,0,0,0,0,0,0,0,0
63,1,7,22,8,169,13,81,5,3,16,169,32,1058,127,464,17,177,1090
63,7,15,46,25,423,132,87,16,12,40,355,147,2971,1193,475,116,448,3118
63,18,12,21,12,335,127,79,20,3,27,119,20,2213,1193,416,87,347,2233
63,19,47,62,30,1508,448,176,71,30,131,425,166,10411,4474,1115,569,1538,10577
63,45,4,9,37,112,9,21,5,4,11,27,92,280,29,78,7,149,372
63,46,20,30,50,537,70,70,9,19,47,145,291,2280,336,211,25,587,2571
63,47,4,10,40,161,51,25,4,4,12,26,139,989,400,147,14,201,1128
63,49,1,0,0,0,0,0,0,1,2,0,0,0,0,0,0,0,0
63,51,6,0,0,0,0,0,0,2,12,0,0,0,0,0,0,0,0
63,52,4,0,0,0,0,0,0,2,9,0,0,0,0,0,0,0,0
63,53,8,19,42,240,49,68,2,5,18,59,134,944,326,197,4,282,1078
63,54,5,0,0,0,0,0,0,2,10,0,0,0,0,0,0,0,0
64,18,63,178,38,1566,601,116,59,22,146,1175,255,10769,5644,696,259,1604,11024
64,19,39,25,16,858,419,149,57,19,102,169,95,6956,4221,948,310,874,7051
64,45,7,12,32,247,47,48,2,5,21,39,90,1023,273,158,4,279,1113
64,46,11,25,104,526,40,108,7,11,30,78,262,2186,161,333,12,630,2448
64,48,1,0,0,0,0,0,0,1,2,0,0,0,0,0,0,0,0
64,49,11,34,73,280,73,43,3,7,42,95,221,1150,329,132,147,353,1371
64,50,31,76,540,722,146,187,46,7,80,219,1134,2265,855,357,93,1262,3399
64,51,3,0,0,0,0,0,0,2,8,0,0,0,0,0,0,0,0
64,52,14,16,20,247,86,48,1,7,35,49,41,1152,528,145,2,267,1193
64,53,5,0,0,0,0,0,0,2,15,0,0,0,0,0,0,0,0
65,18,29,121,11,671,372,48,16,12,79,797,59,5359,3516,376,92,682,5418
65,44,188,461,4517,4251,892,717,163,58,448,2262,12648,21063,6996,2333,391,8768,33711
65,45,20,33,69,604,122,39,10,11,76,245,201,5402,1130,166,27,673,5603
65,48,3,0,0,0,0,0,0,1,13,0,0,0,0,0,0,0,0
65,49,8,8,18,90,49,10,4,3,20,19,39,678,385,45,124,108,717
65,50,3,0,0,0,0,0,0,1,7,0,0,0,0,0,0,0,0
65,51,27,28,1082,479,78,101,40,3,78,62,2288,1178,381,155,64,1561,3466
65,52,7,39,167,382,66,208,4,3,17,93,548,1029,235,480,5,549,1577
66,15,224,399,331,6820,1717,929,1414,98,677,2585,2038,48028,16662,5805,7683,7151,50066
66,16,4,0,0,0,0,0,0,3,8,0,0,0,0,0,0,0,0
66,17,25,63,5,564,229,100,13,13,80,646,21,4368,2165,489,86,569,4389
66,20,15,0,0,0,0,0,0,6,34,0,0,0,0,0,0,0,0
66,23,11,4,9,251,23,45,111,4,23,4,89,1718,177,289,814,260,1807
66,24,287,2299,367,8713,2178,1206,900,76,663,12465,1731,52620,17616,6580,4712,9080,54351
66,43,9,0,0,0,0,0,0,5,40,0,0,0,0,0,0,0,0
66,44,20,39,73,597,195,56,7,13,54,219,623,4023,1562,276,14,670,4646
66,46,3,0,0,0,0,0,0,1,10,0,0,0,0,0,0,0,0
66,49,1,0,0,0,0,0,0,1,4,0,0,0,0,0,0,0,0
67,15,5,0,0,0,0,0,0,1,10,0,0,0,0,0,0,0,0
67,16,63,100,63,1642,464,221,224,22,190,636,248,8000,3387,1148,770,1705,8248
67,19,13,45,1,400,209,43,2,7,33,362,8,3264,1911,350,14,401,3272
67,20,1,0,0,0,0,0,0,1,6,0,0,0,0,0,0,0,0
67,23,347,864,476,8776,2110,1165,1628,171,1038,5751,2615,64768,19014,8277,10468,9252,67383
67,24,12,17,3,194,71,27,19,4,31,239,12,2137,871,413,133,197,2149
67,43,19,20,20,330,70,30,3,11,50,92,161,2934,627,320,17,350,3095
68,17,11,31,2,158,75,6,2,5,28,256,14,1288,634,60,8,160,1302
68,18,4,0,0,0,0,0,0,2,8,0,0,0,0,0,0,0,0
68,19,3,0,0,0,0,0,0,1,6,0,0,0,0,0,0,0,0
68,21,10,32,3,206,124,0,2,4,22,270,21,1945,1169,0,14,209,1966
68,23,97,0,0,0,0,0,0,57,264,0,0,0,0,0,0,0,0
68,24,3,0,0,0,0,0,0,2,8,0,0,0,0,0,0,0,0
68,44,8,9,33,102,34,14,7,8,21,35,82,616,277,90,25,135,698
68,46,6,5,46,154,11,29,8,5,13,23,153,474,112,67,23,200,627
68,47,1,0,0,0,0,0,0,1,2,0,0,0,0,0,0,0,0
69,16,22,59,45,668,187,146,25,13,68,381,112,4144,1738,682,67,713,4256
69,21,12,0,0,0,0,0,0,5,28,0,0,0,0,0,0,0,0
69,22,85,0,0,0,0,0,0,39,216,0,0,0,0,0,0,0,0
69,23,3,0,0,0,0,0,0,1,6,0,0,0,0,0,0,0,0
69,24,1796,10554,9658,68204,18637,7518,7308,679,4757,52131,37399,398493,134174,43421,33724,77862,435892
69,25,106,27,442,789,32,40,334,13,226,206,2288,5117,384,374,1677,1231,7405
69,28,24,0,0,0,0,0,0,15,66,0,0,0,0,0,0,0,0
69,43,1,0,0,0,0,0,0,1,2,0,0,0,0,0,0,0,0
69,44,13,15,36,473,89,57,2,13,35,73,84,2175,535,272,4,509,2259
69,45,3,0,0,0,0,0,0,3,11,0,0,0,0,0,0,0,0
70,14,3,0,0,0,0,0,0,1,6,0,0,0,0,0,0,0,0
70,16,101,367,118,3138,719,739,140,43,287,1885,343,17426,5771,3913,476,3256,17769
70,17,1,0,0,0,0,0,0,1,6,0,0,0,0,0,0,0,0
70,22,40,0,0,0,0,0,0,18,102,0,0,0,0,0,0,0,0
70,23,40,0,0,0,0,0,0,22,121,0,0,0,0,0,0,0,0
70,24,39,39,88,1126,258,195,69,24,128,322,464,8175,2314,1438,435,1214,8639
70,25,131,311,381,3735,1116,620,262,64,346,1981,2117,25582,10633,3540,1174,4116,27699
70,27,163,352,553,5078,1037,586,845,77,482,1770,2918,31828,8950,3335,4620,5631,34746
70,28,1548,7737,4263,76374,26723,4639,17971,245,4167,40949,17195,436974,183046,22479,88290,80637,454169
70,29,353,2619,955,13812,4164,1029,2081,66,780,12465,4342,78078,29590,4898,10512,14767,82420
70,34,337,243,2448,15512,1499,434,961,9,681,895,9036,67928,5848,1047,4112,17960,76964
70,35,11,17,30,304,63,28,71,6,32,96,142,2060,565,136,482,334,2202
70,36,244,335,2213,5697,1039,429,1798,76,663,2025,12923,35000,8592,2786,9240,7910,47923
70,45,11,33,6,330,146,24,5,9,33,239,18,2428,1355,107,9,336,2446
70,56,1,0,0,0,0,0,0,1,4,0,0,0,0,0,0,0,0
70,58,10,0,0,0,0,0,0,1,35,0,0,0,0,0,0,0,0
70,81,1,0,0,0,0,0,0,1,3,0,0,0,0,0,0,0,0
71,15,16,61,16,455,148,88,0,9,42,384,92,3354,1362,452,0,471,3446
71,24,24,0,0,0,0,0,0,10,58,0,0,0,0,0,0,0,0
71,33,2,0,0,0,0,0,0,1,4,0,0,0,0,0,0,0,0
71,34,66,91,144,1606,477,244,122,38,183,405,907,10063,4179,1229,606,1750,10970
71,35,19,32,26,393,88,46,65,10,51,210,226,2907,827,402,469,419,3133
71,40,941,657,2670,30287,3026,941,11322,54,2326,2762,13441,121091,12589,2265,47640,32957,134532
71,41,11,7,13,245,77,26,14,8,28,35,73,1673,640,152,82,258,1746
71,45,2,0,0,0,0,0,0,2,5,0,0,0,0,0,0,0,0
71,79,6,0,0,0,0,0,0,2,17,0,0,0,0,0,0,0,0
72,13,8,40,12,264,116,42,3,7,26,194,68,1847,976,292,12,276,1915
72,14,14,0,0,0,0,0,0,5,39,0,0,0,0,0,0,0,0
72,23,42,27,45,643,270,116,7,20,114,198,250,5462,2833,830,47,688,5712
72,24,47,128,72,1313,516,238,30,17,109,876,279,9024,4817,943,131,1385,9303
72,38,2,0,0,0,0,0,0,1,8,0,0,0,0,0,0,0,0
72,39,6,10,1,118,75,2,0,3,12,126,7,1129,708,14,0,119,1136
72,40,16,16,33,335,57,34,39,13,40,82,169,2153,648,247,190,368,2322
72,41,63,93,1055,1581,242,258,72,8,150,365,2762,3973,1190,479,127,2636,6735
72,42,17,51,55,472,118,44,24,8,34,230,146,2110,724,183,98,527,2256
72,43,3,0,0,0,0,0,0,3,10,0,0,0,0,0,0,0,0
72,44,4,2,0,131,100,0,0,4,12,8,0,1338,1043,0,0,131,1338
72,78,2,0,0,0,0,0,0,2,8,0,0,0,0,0,0,0,0
73,13,1176,4740,1639,48328,13828,5882,10250,208,3371,27124,8970,281759,97964,29890,54646,49967,290729
73,14,214,677,399,7474,1457,1688,341,113,610,3119,1753,40747,10455,9118,1516,7873,42500
73,23,19,0,0,0,0,0,0,9,41,0,0,0,0,0,0,0,0
73,24,6,0,0,0,0,0,0,2,12,0,0,0,0,0,0,0,0
73,26,1,0,0,0,0,0,0,1,4,0,0,0,0,0,0,0,0
73,27,12,0,0,0,0,0,0,6,34,0,0,0,0,0,0,0,0
73,28,6,0,0,0,0,0,0,2,14,0,0,0,0,0,0,0,0
73,39,20,19,57,205,44,24,14,9,48,120,298,1625,443,166,56,262,1923
73,40,2,0,0,0,0,0,0,1,4,0,0,0,0,0,0,0,0
73,41,3,0,0,0,0,0,0,2,7,0,0,0,0,0,0,0,0
73,42,1,0,0,0,0,0,0,1,4,0,0,0,0,0,0,0,0
73,75,5,0,0,0,0,0,0,2,16,0,0,0,0,0,0,0,0
73,79,2,0,0,0,0,0,0,1,4,0,0,0,0,0,0,0,0
74,13,378,4858,803,21208,7628,1464,1366,6,771,19310,2199,100301,43398,4927,3846,22011,102500
74,14,1404,8043,2964,56621,14920,8705,2851,441,3755,40938,11263,318043,105911,44278,13314,59585,329306
74,16,10,22,17,200,120,15,13,6,22,153,76,1764,1129,93,95,217,1840
74,17,3,0,0,0,0,0,0,1,6,0,0,0,0,0,0,0,0
74,22,9,30,0,236,146,17,0,4,17,171,0,2002,1548,67,0,236,2002
74,23,10,0,0,0,0,0,0,4,21,0,0,0,0,0,0,0,0
74,24,9,17,3,166,111,0,0,6,22,114,19,1572,1110,0,0,169,1591
74,25,5,0,0,0,0,0,0,4,15,0,0,0,0,0,0,0,0
74,26,27,13,0,562,160,77,58,12,80,57,0,3701,1597,387,345,562,3701
74,28,150,308,199,4288,1304,403,666,65,406,2139,1119,32714,12467,2898,4335,4487,33833
74,29,28,0,0,0,0,0,0,16,74,0,0,0,0,0,0,0,0
74,38,8,18,10,322,87,37,27,5,22,96,26,1467,743,111,43,332,1493
74,39,55,0,0,0,0,0,0,28,135,0,0,0,0,0,0,0,0
74,42,27,34,18,432,162,34,3,12,59,216,58,3060,1474,193,10,450,3118
74,74,11,0,251,45,2,6,9,6,65,0,605,97,3,14,20,296,702
74,75,2,0,0,0,0,0,0,1,4,0,0,0,0,0,0,0,0
75,13,428,0,0,0,0,0,0,1,1329,0,0,0,0,0,0,0,0
75,16,9,16,24,320,105,79,19,5,25,49,108,2106,920,431,69,344,2214
75,17,2,0,0,0,0,0,0,1,4,0,0,0,0,0,0,0,0
75,22,42,82,7,771,411,56,6,15,102,603,41,6306,4007,308,12,778,6347
75,23,23,106,9,422,260,1,0,7,47,810,64,3941,2689,4,0,431,4005
75,25,23,35,29,567,143,99,12,13,58,153,75,3292,1315,502,28,596,3367
75,27,107,558,178,4407,936,272,542,37,345,2836,644,25645,7581,1398,3194,4585,26289
75,31,11,17,0,129,48,27,7,4,24,94,0,974,481,167,49,129,974
75,35,19,32,50,430,127,11,36,11,53,293,550,3697,1346,81,276,480,4247
75,36,133,390,286,3029,1154,161,169,63,372,2651,1759,22758,10368,1094,840,3315,24517
75,37,23,83,181,451,116,56,34,13,57,520,582,3020,1108,459,116,632,3602
75,38,5,0,0,0,0,0,0,3,14,0,0,0,0,0,0,0,0
75,40,6,0,0,0,0,0,0,5,25,0,0,0,0,0,0,0,0
75,68,19,0,0,0,0,0,0,3,48,0,0,0,0,0,0,0,0
75,74,1,0,0,0,0,0,0,1,4,0,0,0,0,0,0,0,0
76,15,14,80,4,421,195,14,11,5,42,647,4,3538,1915,99,77,425,3542
76,16,253,700,349,6678,2032,944,729,129,702,4135,1963,45703,18375,5659,4428,7027,47666
76,18,1,0,0,0,0,0,0,1,5,0,0,0,0,0,0,0,0
76,20,20,93,10,587,337,19,4,12,62,615,16,4762,3238,89,4,597,4778
76,21,5,0,0,0,0,0,0,2,12,0,0,0,0,0,0,0,0
76,24,6,39,0,169,47,4,0,3,16,256,0,1289,409,44,0,169,1289
76,25,29,101,6,593,276,58,6,13,67,781,25,5249,2933,387,54,599,5274
76,26,14,41,3,407,245,14,19,10,54,279,9,3520,2432,122,82,410,3529
76,27,7,0,0,0,0,0,0,4,21,0,0,0,0,0,0,0,0
76,28,202,1163,165,8158,3140,372,1135,60,599,7246,1076,47813,20770,1974,6131,8323,48889
76,35,222,501,761,5706,1931,285,276,108,661,2640,4291,41306,17872,1697,1438,6467,45597
76,36,108,229,465,2538,846,150,129,43,271,1398,2482,16461,7076,631,559,3003,18943
76,39,8,0,25,160,116,2,0,3,15,0,39,1444,1247,12,0,185,1483
77,12,94,254,120,2464,449,177,855,28,231,1791,803,17474,3461,1220,5878,2584,18277
77,16,18,65,0,340,204,19,13,6,44,511,0,2986,1932,121,100,340,2986
77,18,2,0,0,0,0,0,0,1,6,0,0,0,0,0,0,0,0
77,20,1,0,0,0,0,0,0,1,6,0,0,0,0,0,0,0,0
77,24,5,10,0,73,57,4,0,3,12,96,0,699,561,28,0,73,699
77,25,18,56,3,267,128,8,2,6,47,369,21,2376,1385,96,6,270,2397
77,27,3,0,0,0,0,0,0,2,10,0,0,0,0,0,0,0,0
77,28,24,63,22,738,148,30,210,9,71,535,181,5760,1532,244,1604,760,5941
77,35,13,37,37,385,121,28,9,5,33,312,163,2677,1033,168,40,422,2840
77,36,24,20,42,470,120,26,56,12,80,191,234,3473,1182,146,375,512,3707
77,38,6,11,0,120,39,6,0,3,18,97,0,958,354,48,0,120,958
77,39,4,0,0,0,0,0,0,1,8,0,0,0,0,0,0,0,0
78,12,267,797,552,7752,1627,1196,1570,106,709,4310,3406,52361,14250,6894,9891,8304,55767
78,13,2007,7722,2522,56377,12990,6161,15739,221,5802,45602,12319,332681,90588,31613,93176,58899,345000
78,14,118,1266,495,5116,1613,552,350,34,327,4623,1782,21857,7940,2632,1133,5611,23639
78,22,12,19,4,308,147,38,18,8,42,153,32,2621,1577,280,90,312,2653
78,23,28,70,47,865,259,135,60,18,78,297,272,5887,2253,839,349,912,6159
78,25,9,20,0,197,79,20,14,4,22,141,0,1595,737,88,110,197,1595
78,26,95,194,63,2055,702,293,207,48,246,1188,289,14228,6707,1758,1136,2118,14517
78,27,2,0,0,0,0,0,0,2,4,0,0,0,0,0,0,0,0
78,33,33,45,48,649,163,36,24,12,92,298,321,4847,1478,320,174,697,5168
78,34,25,31,12,489,174,36,6,14,66,157,54,3430,1510,232,18,501,3484
78,37,9,28,3,187,107,9,0,6,26,224,12,1799,1177,87,0,190,1811
78,38,5,7,7,92,27,0,0,4,18,26,32,690,309,0,0,99,722
78,44,4,3,30,56,14,6,6,4,12,6,64,303,158,16,14,86,367
78,52,2,0,0,0,0,0,0,1,4,0,0,0,0,0,0,0,0
78,72,2,0,0,0,0,0,0,1,6,0,0,0,0,0,0,0,0
79,22,5,0,0,0,0,0,0,2,11,0,0,0,0,0,0,0,0
79,23,40,99,61,1151,388,157,81,23,124,912,379,8552,3666,1198,452,1212,8931
79,24,1,0,0,0,0,0,0,1,6,0,0,0,0,0,0,0,0
79,25,1,0,0,0,0,0,0,1,2,0,0,0,0,0,0,0,0
79,26,11,15,0,154,45,27,5,6,30,146,0,1343,443,229,25,154,1343
79,27,233,456,308,7229,1828,938,661,111,744,3066,1612,52434,17365,6464,3624,7537,54046
79,33,730,1198,3186,21332,4872,637,3097,196,1963,7065,14588,136411,40647,3274,16158,24518,150999
79,34,28,35,190,496,214,14,16,14,85,228,1167,4039,2187,110,81,686,5206
79,37,1,0,0,0,0,0,0,1,4,0,0,0,0,0,0,0,0
79,52,1,0,0,0,0,0,0,1,2,0,0,0,0,0,0,0,0
79,68,4,0,0,0,0,0,0,1,8,0,0,0,0,0,0,0,0
79,72,1,0,0,0,0,0,0,1,2,0,0,0,0,0,0,0,0
80,19,9,35,1,307,207,10,6,3,28,220,1,2593,1953,47,24,308,2594
80,20,2,0,0,0,0,0,0,1,6,0,0,0,0,0,0,0,0
80,23,1,0,0,0,0,0,0,1,4,0,0,0,0,0,0,0,0
80,27,630,1164,314,15570,4362,1261,4146,135,1858,7638,1741,105270,39257,7056,22743,15884,107011
80,28,46,345,39,1814,335,149,271,15,114,2118,206,11744,2658,753,1793,1853,11950
80,32,809,6354,6505,23747,3485,520,1762,134,1743,27727,41600,129643,27476,2027,7669,30252,171243
80,33,141,122,472,3458,1265,120,168,68,393,761,2371,25593,11984,703,865,3930,27964
80,35,10,0,0,0,0,0,0,9,38,0,0,0,0,0,0,0,0
80,36,33,142,88,870,291,41,101,14,86,639,344,4837,2343,193,365,958,5181
80,44,1,0,0,0,0,0,0,1,4,0,0,0,0,0,0,0,0
80,45,4,0,0,0,0,0,0,3,11,0,0,0,0,0,0,0,0
80,58,10,0,0,0,0,0,0,7,25,0,0,0,0,0,0,0,0
80,70,1,0,0,0,0,0,0,1,4,0,0,0,0,0,0,0,0
81,19,218,905,257,7097,2693,642,238,109,587,4782,958,47026,22781,3239,1205,7354,47984
81,20,111,889,438,5523,1403,532,971,47,289,3748,1103,24877,9716,2022,2252,5961,25980
81,30,125,2017,776,5560,1060,180,626,23,299,7738,2962,24992,6268,799,2412,6336,27954
81,31,1685,9742,9313,58393,16378,2760,5675,507,4166,42808,36318,320538,118686,9556,22172,67706,356856
81,32,642,1007,3168,18873,3074,409,970,109,1538,5034,11647,105812,25258,1848,4170,22041,117459
81,34,3,0,0,0,0,0,0,2,8,0,0,0,0,0,0,0,0
81,35,39,83,125,518,215,31,19,7,92,621,400,3537,1859,182,31,643,3937
81,36,5,19,10,91,41,0,0,3,13,132,34,749,337,0,0,101,783
81,45,2,0,0,0,0,0,0,2,5,0,0,0,0,0,0,0,0
81,46,1,0,0,0,0,0,0,1,2,0,0,0,0,0,0,0,0
81,47,3,0,0,0,0,0,0,2,7,0,0,0,0,0,0,0,0
81,57,23,10,756,662,117,85,13,10,56,14,1698,1531,361,135,29,1418,3229
81,58,5,0,0,0,0,0,0,5,16,0,0,0,0,0,0,0,0
81,59,2,0,0,0,0,0,0,1,4,0,0,0,0,0,0,0,0
82,7,338,0,0,0,0,0,0,2,1011,0,0,0,0,0,0,0,0
82,30,572,1842,3581,20759,6169,879,1409,218,1469,8409,15344,108002,40051,3078,6131,24340,123346
82,31,475,1142,1405,12794,4021,450,535,218,1380,6674,6584,87054,34912,2551,2561,14199,93638
82,32,19,164,4,469,235,7,2,5,42,1157,12,3650,1990,50,4,473,3662
82,33,6,7,59,66,40,0,4,4,21,75,442,732,526,0,12,125,1174
82,34,29,56,0,519,325,8,0,11,74,375,0,4547,3121,56,0,519,4547
82,35,43,95,10,1063,687,39,1,22,135,537,23,8897,6399,226,2,1073,8920
82,36,4,0,0,0,0,0,0,1,8,0,0,0,0,0,0,0,0
82,45,7,13,561,425,144,51,13,5,18,43,1402,2692,1500,176,13,986,4094
82,52,3,0,0,0,0,0,0,2,7,0,0,0,0,0,0,0,0
83,6,98,0,0,0,0,0,0,27,236,0,0,0,0,0,0,0,0
83,7,80,326,27,2465,432,386,98,35,207,2079,168,16914,3330,2518,754,2492,17082
83,29,209,1228,4629,9414,1020,556,977,32,746,4249,17137,43403,5446,1838,4426,14043,60540
83,30,493,796,6111,13470,3578,402,848,192,1577,4269,25734,90442,31888,2465,4125,19581,116176
83,31,85,216,151,2611,1113,123,62,35,247,1228,520,17324,9206,527,185,2762,17844
83,32,2,0,0,0,0,0,0,1,8,0,0,0,0,0,0,0,0
83,33,17,15,0,380,263,1,0,10,54,120,0,3660,2779,14,0,380,3660
83,34,8,10,1,253,170,0,0,8,42,104,1,2333,1666,0,0,254,2334
83,35,5,23,0,183,135,0,0,5,25,207,0,1772,1310,0,0,183,1772
83,42,13,0,219,213,53,14,11,8,35,0,491,1030,436,42,14,432,1521
83,43,7,0,0,0,0,0,0,3,19,0,0,0,0,0,0,0,0
83,45,87,56,2895,1206,116,121,78,28,216,180,8308,4982,479,279,215,4101,13290
83,46,33,57,1387,2949,92,130,28,6,65,104,2404,3610,236,166,47,4336,6014
83,47,3,0,0,0,0,0,0,1,6,0,0,0,0,0,0,0,0
83,51,9,13,175,455,118,23,5,4,26,28,527,1158,384,35,7,630,1685
83,52,2,0,0,0,0,0,0,1,4,0,0,0,0,0,0,0,0
84,11,2,0,0,0,0,0,0,1,4,0,0,0,0,0,0,0,0
84,28,863,1466,3118,34200,7079,1655,10139,65,2342,5885,17264,154575,30374,4747,46174,37318,171839
84,29,1467,8192,10943,52238,10774,2399,7681,369,3899,31278,55977,262443,68571,8778,35047,63181,318420
84,31,12,0,0,0,0,0,0,4,38,0,0,0,0,0,0,0,0
84,32,20,8,36,283,143,14,0,13,59,34,230,2490,1575,68,0,319,2720
84,33,6,0,0,0,0,0,0,2,14,0,0,0,0,0,0,0,0
84,34,2,0,0,0,0,0,0,2,10,0,0,0,0,0,0,0,0
84,47,11,0,0,0,0,0,0,5,34,0,0,0,0,0,0,0,0
84,51,1,0,0,0,0,0,0,1,4,0,0,0,0,0,0,0,0
84,69,1,0,0,0,0,0,0,1,6,0,0,0,0,0,0,0,0
85,9,1,0,0,0,0,0,0,1,4,0,0,0,0,0,0,0,0
85,10,61,101,113,1579,231,359,64,22,166,683,404,8983,1697,2072,226,1692,9387
85,11,25,44,18,531,84,130,32,14,58,228,62,2957,693,665,129,549,3019
85,28,3,4,5,78,31,4,7,3,10,52,30,720,276,16,161,83,750
85,29,4,0,0,0,0,0,0,1,14,0,0,0,0,0,0,0,0
85,31,30,53,57,478,343,10,0,9,75,421,100,4341,3211,100,0,535,4441
85,32,12,17,0,361,253,16,0,11,53,102,0,3434,2587,148,0,361,3434
85,48,4,0,0,0,0,0,0,2,8,0,0,0,0,0,0,0,0
85,49,2,0,0,0,0,0,0,1,5,0,0,0,0,0,0,0,0
85,50,1,0,0,0,0,0,0,1,2,0,0,0,0,0,0,0,0
85,51,11,5,251,95,2,15,5,6,27,5,496,237,4,15,7,346,733
86,8,49,94,90,1950,373,382,109,22,142,426,316,10228,2948,1714,542,2040,10544
86,9,107,205,312,3603,330,668,250,45,309,934,1083,18054,2278,3204,853,3915,19137
86,29,3,0,0,74,47,0,0,3,12,0,0,655,466,0,0,74,655
86,30,8,62,5,306,108,16,6,6,33,471,41,2502,1046,106,26,311,2543
86,31,5,7,5,171,143,6,0,5,19,49,15,1691,1492,32,0,176,1706
87,7,401,2669,415,14047,2610,1096,835,156,1033,15299,2099,89869,20668,5634,4487,14462,91968
87,8,442,2094,576,16164,3530,1953,963,176,1232,12205,3145,106151,28790,11858,5137,16740,109296
87,9,67,145,115,1950,272,434,121,27,164,649,406,10923,2073,2136,490,2065,11329
87,28,4,0,0,0,0,0,0,1,8,0,0,0,0,0,0,0,0
87,29,12,39,29,170,90,2,0,5,45,295,45,1652,995,20,0,199,1697
87,30,19,64,6,433,204,16,15,14,68,399,12,3655,1945,154,70,439,3667
87,31,3,0,0,0,0,0,0,2,10,0,0,0,0,0,0,0,0
88,8,2564,22959,6960,120825,26254,12175,16781,423,6977,118408,25390,696946,185655,65634,78690,127785,722336
88,26,396,0,0,0,0,0,0,30,1369,0,0,0,0,0,0,0,0
88,28,3,0,0,53,39,0,0,3,10,0,0,550,406,0,0,53,550
88,29,43,49,20,699,368,45,4,27,120,305,158,6072,3383,360,4,719,6230
88,30,1,0,0,0,0,0,0,1,4,0,0,0,0,0,0,0,0
88,55,54,81,2516,3693,148,317,72,11,143,119,5316,5117,225,464,103,6209,10433
88,56,4,0,72,31,5,11,2,4,12,0,128,76,8,19,2,103,204
88,57,3,0,0,0,0,0,0,3,6,0,0,0,0,0,0,0,0
89,8,83,549,57,2297,516,315,105,38,216,3640,319,15910,4299,2203,666,2354,16229
89,26,322,382,995,7333,1920,434,375,151,950,2052,5290,49221,16898,2717,1806,8328,54511
89,27,13,6,26,227,70,17,23,6,41,25,102,1693,529,90,163,253,1795
89,28,1,0,0,0,0,0,0,1,2,0,0,0,0,0,0,0,0
89,35,2,0,0,0,0,0,0,1,4,0,0,0,0,0,0,0,0
89,47,3,0,0,0,0,0,0,2,8,0,0,0,0,0,0,0,0
89,55,1,0,0,0,0,0,0,1,2,0,0,0,0,0,0,0,0
89,56,26,32,658,584,54,93,64,7,88,119,1359,1096,72,102,169,1242,2455
89,63,3,0,0,0,0,0,0,1,9,0,0,0,0,0,0,0,0
89,64,6,0,0,0,0,0,0,4,18,0,0,0,0,0,0,0,0
90,25,254,972,3441,9353,375,142,999,14,568,3801,12738,55465,2301,310,3595,12794,68203
90,26,913,2054,4211,23207,6162,1405,1213,384,2710,9535,20543,153539,54082,7857,5228,27418,174082
90,48,1,0,0,0,0,0,0,1,4,0,0,0,0,0,0,0,0
91,25,196,239,3894,4845,1196,256,361,75,687,1404,17719,34744,10846,1742,2156,8739,52463
91,26,33,57,42,723,230,29,32,19,99,330,185,5458,2193,235,185,765,5643
91,48,7,0,0,0,0,0,0,2,17,0,0,0,0,0,0,0,0
91,54,2,0,0,0,0,0,0,2,7,0,0,0,0,0,0,0,0
91,63,4,0,0,0,0,0,0,2,7,0,0,0,0,0,0,0,0
92,25,353,607,533,9073,3122,822,631,93,980,3280,1945,52116,23000,2976,2657,9606,54061
92,27,4,0,0,0,0,0,0,2,10,0,0,0,0,0,0,0,0
92,32,1,0,0,0,0,0,0,1,4,0,0,0,0,0,0,0,0
92,53,1,0,0,0,0,0,0,1,3,0,0,0,0,0,0,0,0
92,61,3,0,0,0,0,0,0,2,6,0,0,0,0,0,0,0,0
92,62,1,0,0,0,0,0,0,1,4,0,0,0,0,0,0,0,0
92,63,18,0,0,0,0,0,0,5,42,0,0,0,0,0,0,0,0
93,25,42,168,115,1432,393,40,66,18,135,912,423,9455,3422,173,389,1547,9878
93,27,1,0,0,0,0,0,0,1,2,0,0,0,0,0,0,0,0
93,47,2,0,0,0,0,0,0,2,6,0,0,0,0,0,0,0,0
93,49,3,0,0,0,0,0,0,2,12,0,0,0,0,0,0,0,0
94,23,846,1443,644,23972,7252,2282,1790,86,2500,6776,2683,113035,36296,9014,7988,24616,115718
94,24,102,148,131,2423,555,175,193,39,288,974,670,17074,5211,1077,1032,2554,17744
94,27,5,0,0,0,0,0,0,4,14,0,0,0,0,0,0,0,0
94,29,2,0,0,0,0,0,0,1,4,0,0,0,0,0,0,0,0
94,46,12,2,309,87,2,6,40,4,27,12,568,235,6,12,77,396,803
94,47,8,0,83,43,3,2,0,4,18,0,198,157,14,2,0,126,355
94,48,6,8,308,26,4,0,3,4,16,24,684,90,28,0,8,334,774
94,51,2,0,0,0,0,0,0,1,4,0,0,0,0,0,0,0,0
94,63,4,0,0,0,0,0,0,2,7,0,0,0,0,0,0,0,0
94,64,7,0,100,60,11,4,0,4,16,0,328,437,75,19,0,160,765
95,21,4,0,0,0,0,0,0,2,9,0,0,0,0,0,0,0,0
95,22,40,48,24,629,165,33,32,17,95,273,146,4611,1509,233,183,653,4757
95,23,3,0,0,0,0,0,0,2,10,0,0,0,0,0,0,0,0
95,24,13,0,0,0,0,0,0,6,32,0,0,0,0,0,0,0,0
95,45,12,0,0,0,0,0,0,1,43,0,0,0,0,0,0,0,0
95,56,5,0,0,0,0,0,0,1,10,0,0,0,0,0,0,0,0
95,65,1,0,0,0,0,0,0,1,4,0,0,0,0,0,0,0,0
96,32,3,0,0,0,0,0,0,1,6,0,0,0,0,0,0,0,0
96,33,10,0,0,0,0,0,0,4,19,0,0,0,0,0,0,0,0
96,45,3,0,0,0,0,0,0,2,8,0,0,0,0,0,0,0,0
96,53,3,0,0,0,0,0,0,1,6,0,0,0,0,0,0,0,0
96,61,3,0,0,0,0,0,0,2,6,0,0,0,0,0,0,0,0
96,65,6,0,0,0,0,0,0,3,11,0,0,0,0,0,0,0,0
97,16,2,0,0,0,0,0,0,1,4,0,0,0,0,0,0,0,0
97,17,119,85,35,1780,448,267,94,13,338,523,210,9788,2890,1284,480,1815,9998
97,46,10,0,54,11,3,2,0,5,30,0,244,69,21,12,0,65,313
97,60,10,0,0,0,0,0,0,4,51,0,0,0,0,0,0,0,0
97,66,1,0,0,0,0,0,0,1,2,0,0,0,0,0,0,0,0
97,67,2,0,0,0,0,0,0,1,4,0,0,0,0,0,0,0,0
98,13,4,0,0,0,0,0,0,3,10,0,0,0,0,0,0,0,0
98,14,14,21,5,449,89,19,11,5,35,116,5,2517,636,98,58,454,2522
98,15,68,94,8,1471,524,138,48,14,205,496,33,7465,3227,607,176,1479,7498
98,16,2,0,0,0,0,0,0,1,8,0,0,0,0,0,0,0,0
98,46,15,7,356,95,14,14,6,4,27,8,850,416,147,21,9,451,1266
98,65,1,0,0,0,0,0,0,1,5,0,0,0,0,0,0,0,0
99,11,998,2589,1124,43864,10394,4487,918,501,2894,8765,3506,189137,62224,15114,3580,44988,192643
99,12,4,6,0,106,65,2,11,4,11,28,0,870,650,6,53,106,870
99,13,32,65,3,599,238,42,11,14,103,414,5,4902,2461,236,69,602,4907
99,14,7,0,0,0,0,0,0,4,26,0,0,0,0,0,0,0,0
99,24,5,8,0,73,44,0,0,3,12,53,0,706,500,0,0,73,706
99,53,1,0,0,0,0,0,0,1,3,0,0,0,0,0,0,0,0
99,57,5,0,0,0,0,0,0,2,9,0,0,0,0,0,0,0,0
99,69,5,0,0,0,0,0,0,2,10,0,0,0,0,0,0,0,0
100,10,2,0,0,0,0,0,0,1,4,0,0,0,0,0,0,0,0
100,11,28,88,37,1607,273,170,36,15,78,239,146,5730,1336,540,140,1644,5876
100,53,63,77,1666,3113,219,576,41,15,147,116,3777,3774,320,694,92,4779,7551
100,54,4,0,0,0,0,0,0,1,10,0,0,0,0,0,0,0,0
100,55,1,0,0,0,0,0,0,1,4,0,0,0,0,0,0,0,0
100,59,3,0,0,0,0,0,0,2,8,0,0,0,0,0,0,0,0
101,4,12,20,3,324,64,34,12,8,40,131,4,1979,549,216,91,327,1983
101,5,442,953,651,17097,5085,1110,635,133,1305,3963,1553,75705,27280,4174,2915,17748,77258
101,9,6,0,0,0,0,0,0,2,18,0,0,0,0,0,0,0,0
101,14,1,0,0,0,0,0,0,1,6,0,0,0,0,0,0,0,0
101,20,1,0,0,0,0,0,0,1,2,0,0,0,0,0,0,0,0
102,5,8,12,0,298,131,20,5,4,24,104,0,2487,1474,124,30,298,2487
102,7,15,18,10,700,155,45,18,4,48,72,18,3826,1220,275,73,710,3844
102,8,2,0,0,0,0,0,0,1,4,0,0,0,0,0,0,0,0
102,15,5,3,4,129,83,7,6,5,18,21,8,1011,697,32,36,133,1019
102,18,1,0,0,0,0,0,0,1,6,0,0,0,0,0,0,0,0
102,64,1,0,0,0,0,0,0,1,4,0,0,0,0,0,0,0,0
103,12,4,0,0,0,0,0,0,2,10,0,0,0,0,0,0,0,0
104,2,2,0,0,0,0,0,0,2,10,0,0,0,0,0,0,0,0
104,59,3,0,0,0,0,0,0,1,6,0,0,0,0,0,0,0,0
104,62,4,0,0,0,0,0,0,1,8,0,0,0,0,0,0,0,0
104,63,2,0,0,0,0,0,0,1,4,0,0,0,0,0,0,0,0
105,9,5,0,0,0,0,0,0,1,10,0,0,0,0,0,0,0,0
105,54,18,0,0,0,0,0,0,4,118,0,0,0,0,0,0,0,0
106,6,3,0,0,0,0,0,0,2,10,0,0,0,0,0,0,0,0
106,8,2,0,0,0,0,0,0,1,4,0,0,0,0,0,0,0,0
106,16,1,0,0,0,0,0,0,1,5,0,0,0,0,0,0,0,0
106,41,3,0,0,0,0,0,0,1,6,0,0,0,0,0,0,0,0
106,59,1,0,0,0,0,0,0,1,4,0,0,0,0,0,0,0,0
107,10,4,0,0,0,0,0,0,1,8,0,0,0,0,0,0,0,0
107,40,19,3,113,64,25,28,4,7,37,8,445,381,284,55,21,177,826
107,59,1,0,0,0,0,0,0,1,3,0,0,0,0,0,0,0,0
108,4,2,0,0,0,0,0,0,1,5,0,0,0,0,0,0,0,0
108,38,2,0,0,0,0,0,0,1,7,0,0,0,0,0,0,0,0
108,56,2,0,0,0,0,0,0,1,4,0,0,0,0,0,0,0,0
109,33,2,0,0,0,0,0,0,1,6,0,0,0,0,0,0,0,0
109,39,4,0,32,21,4,6,0,3,12,0,86,91,20,12,0,53,177
109,54,8,0,0,0,0,0,0,1,24,0,0,0,0,0,0,0,0
109,67,6,0,0,0,0,0,0,3,16,0,0,0,0,0,0,0,0
110,65,2,0,0,0,0,0,0,1,4,0,0,0,0,0,0,0,0
110,66,2,0,0,0,0,0,0,1,4,0,0,0,0,0,0,0,0
111,55,9,0,0,0,0,0,0,4,23,0,0,0,0,0,0,0,0
111,57,2,0,0,0,0,0,0,1,4,0,0,0,0,0,0,0,0
113,61,3,0,0,0,0,0,0,1,6,0,0,0,0,0,0,0,0
114,5,13,0,0,0,0,0,0,2,28,0,0,0,0,0,0,0,0
114,51,3,0,0,0,0,0,0,2,10,0,0,0,0,0,0,0,0
114,61,1,0,0,0,0,0,0,1,2,0,0,0,0,0,0,0,0
116,13,23,0,0,0,0,0,0,3,28,0,0,0,0,0,0,0,0
117,7,1,0,0,0,0,0,0,1,4,0,0,0,0,0,0,0,0
117,40,11,0,0,0,0,0,0,4,34,0,0,0,0,0,0,0,0
117,46,1,0,0,0,0,0,0,1,4,0,0,0,0,0,0,0,0
117,60,9,0,0,0,0,0,0,2,23,0,0,0,0,0,0,0,0
118,44,1,0,0,0,0,0,0,1,4,0,0,0,0,0,0,0,0
119,12,2,0,0,0,0,0,0,1,4,0,0,0,0,0,0,0,0
119,48,3,0,0,0,0,0,0,2,8,0,0,0,0,0,0,0,0
119,61,4,0,0,0,0,0,0,2,8,0,0,0,0,0,0,0,0
121,43,3,0,0,0,0,0,0,2,11,0,0,0,0,0,0,0,0
122,42,2,0,0,0,0,0,0,2,8,0,0,0,0,0,0,0,0
122,43,1,0,0,0,0,0,0,1,5,0,0,0,0,0,0,0,0
122,63,1,0,0,0,0,0,0,1,4,0,0,0,0,0,0,0,0
123,36,1,0,0,0,0,0,0,1,4,0,0,0,0,0,0,0,0
123,37,2,0,0,0,0,0,0,2,8,0,0,0,0,0,0,0,0
123,38,4,18,121,593,77,66,1,4,16,100,190,1151,147,71,1,714,1341
123,39,1,0,0,0,0,0,0,1,6,0,0,0,0,0,0,0,0
123,40,40,0,0,0,0,0,0,5,106,0,0,0,0,0,0,0,0
123,43,9,0,0,0,0,0,0,1,18,0,0,0,0,0,0,0,0
123,44,33,142,1477,5567,282,443,32,7,74,195,2329,6256,393,632,37,7044,8585
123,64,1,0,0,0,0,0,0,1,5,0,0,0,0,0,0,0,0
124,0,3,0,0,0,0,0,0,2,6,0,0,0,0,0,0,0,0
124,39,2,0,0,0,0,0,0,1,9,0,0,0,0,0,0,0,0
124,40,1,0,0,0,0,0,0,1,4,0,0,0,0,0,0,0,0
124,42,2,0,0,0,0,0,0,1,4,0,0,0,0,0,0,0,0
124,43,1,0,0,0,0,0,0,1,4,0,0,0,0,0,0,0,0
124,64,1,0,0,0,0,0,0,1,3,0,0,0,0,0,0,0,0
124,65,3,0,0,0,0,0,0,1,8,0,0,0,0,0,0,0,0
125,39,21,0,0,0,0,0,0,5,70,0,0,0,0,0,0,0,0
125,41,7,0,0,0,0,0,0,2,19,0,0,0,0,0,0,0,0
125,63,5,0,0,0,0,0,0,1,10,0,0,0,0,0,0,0,0
125,66,1,0,0,0,0,0,0,1,6,0,0,0,0,0,0,0,0
126,0,4,8,42,237,7,39,7,3,13,12,90,526,25,93,12,279,616
126,2,2,0,0,0,0,0,0,1,4,0,0,0,0,0,0,0,0
126,31,1,0,0,0,0,0,0,1,3,0,0,0,0,0,0,0,0
126,50,1,0,0,0,0,0,0,1,4,0,0,0,0,0,0,0,0
126,94,2,0,0,0,0,0,0,1,4,0,0,0,0,0,0,0,0
127,0,116,138,712,17687,638,517,58,5,262,141,924,18434,785,588,69,18399,19358
127,39,1,0,0,0,0,0,0,1,2,0,0,0,0,0,0,0,0
