x,y,ACCOMMODATION UNITS (ROOMS APARTMENTS CAMPING SITES) - TOTAL,A_AUSTRIAN TOURISTS,A_DOMESTIC TOURISTS - TOTAL,A_FOREIGN TOURISTS - TOTAL,A_GERMAN TOURISTS,A_ITALIAN TOURISTS,A_SLOVENIAN TOURISTS,ESTABLISHMENTS - TOTAL,NUMBER OF PERMANENT BEDS,N_AUSTRIAN TOURISTS,N_DOMESTIC TOURISTS - TOTAL,N_FOREIGN TOURISTS - TOTAL,N_GERMAN TOURISTS,N_ITALIAN TOURISTS,N_SLOVENIAN TOURISTS,TOTAL ARRIVALS,TOTAL NIGHTS
41,124,44,53,191,563,63,32,273,25,119,477,1474,5151,799,191,2578,754,6625
42,124,2,0,0,0,0,0,0,1,4,0,0,0,0,0,0,0,0
43,124,1,0,0,0,0,0,0,1,2,0,0,0,0,0,0,0,0
62,127,908,890,2626,19768,2757,594,1440,402,2496,6368,13400,147477,26071,4056,10155,22394,160877
63,117,35,30,52,769,107,29,9,19,94,197,380,5649,922,204,63,821,6029
63,118,415,0,0,0,0,0,0,30,942,0,0,0,0,0,0,0,0
63,119,21,10,3,520,90,5,23,6,49,100,20,3936,816,59,159,523,3956
63,120,34,54,102,1326,85,18,118,9,86,420,440,9457,686,82,778,1428,9897
63,122,461,599,394,10356,1407,347,334,165,1366,4391,2378,80968,13179,2679,2390,10750,83346
64,118,1718,4476,2832,52997,9666,1754,3843,475,5163,30125,17902,364800,69758,9067,31557,55829,382702
64,119,126,175,109,2506,273,30,73,45,359,1157,772,18094,2273,161,584,2615,18866
64,120,6,0,0,0,0,0,0,2,22,0,0,0,0,0,0,0,0
64,121,19,27,22,518,33,26,10,9,63,222,139,3984,312,170,58,540,4123
64,123,1,0,0,0,0,0,0,1,2,0,0,0,0,0,0,0,0
64,126,8,2,0,54,4,1,0,3,24,12,0,526,28,7,0,54,526
65,113,1,0,0,0,0,0,0,1,4,0,0,0,0,0,0,0,0
65,114,32,19,32,646,48,3,31,16,85,169,235,5410,503,29,215,678,5645
65,118,7,0,0,0,0,0,0,2,18,0,0,0,0,0,0,0,0
65,123,58,43,75,1137,143,11,196,26,186,365,666,10739,1906,117,1797,1212,11405
65,126,78,105,164,1804,450,69,303,24,255,887,1102,13887,4306,349,2509,1968,14989
66,113,356,483,408,9487,1070,171,505,147,1125,3263,2358,73309,9480,1075,3971,9895,75667
66,114,17,0,0,0,0,0,0,11,48,0,0,0,0,0,0,0,0
66,117,11,13,46,83,6,14,7,5,22,112,298,588,63,67,46,129,886
66,118,16,47,29,358,46,16,5,6,52,336,232,2811,411,104,32,387,3043
66,119,4,2,15,73,16,4,4,4,10,6,93,557,119,12,28,88,650
66,123,765,622,1448,14831,1651,366,2103,303,2252,6058,11847,126877,17844,2925,19780,16279,138724
66,124,4,0,5,65,0,2,5,3,12,0,24,394,0,8,5,70,418
67,112,161,99,214,3388,255,56,148,57,445,687,1859,28887,2987,429,1139,3602,30746
67,113,192,242,235,4429,297,62,237,82,590,2024,2154,37291,2905,458,1898,4664,39445
67,122,1,0,0,0,0,0,0,1,2,0,0,0,0,0,0,0,0
68,108,37,0,0,0,0,0,0,14,92,0,0,0,0,0,0,0,0
68,109,190,218,149,4502,697,63,308,81,598,1705,1114,39090,7320,485,2872,4651,40204
68,110,53,33,30,1182,170,22,81,28,173,229,325,9934,1770,173,592,1212,10259
68,111,80,121,78,2236,126,22,159,23,230,727,431,14966,1055,130,1174,2314,15397
68,112,778,1093,2078,17987,1743,369,763,297,2279,6320,13675,132092,13133,2125,5742,20065,145767
68,113,60,25,133,1358,117,29,64,23,177,232,847,10651,1098,247,474,1491,11498
68,115,6,0,0,0,0,0,0,2,15,0,0,0,0,0,0,0,0
68,121,2,0,0,0,0,0,0,2,8,0,0,0,0,0,0,0,0
69,109,3,0,0,0,0,0,0,1,6,0,0,0,0,0,0,0,0
69,110,361,328,303,8294,1310,94,427,142,1146,2828,2181,71455,14023,738,3839,8597,73636
69,111,39,35,32,987,160,29,24,16,108,379,178,8379,1617,110,176,1019,8557
69,112,180,345,153,4021,659,38,293,67,498,2820,1198,35987,7255,385,2604,4174,37185
69,113,238,173,333,6106,758,43,297,102,790,1431,2345,50515,7839,269,2401,6439,52860
69,117,2,0,0,0,0,0,0,1,7,0,0,0,0,0,0,0,0
70,108,152,147,181,3449,487,53,238,66,480,1194,1282,31177,4819,538,2151,3630,32459
70,109,3,0,0,0,0,0,0,3,11,0,0,0,0,0,0,0,0
70,111,18,3,27,339,21,0,26,6,50,13,155,2331,196,0,183,366,2486
70,113,4,0,0,0,0,0,0,3,14,0,0,0,0,0,0,0,0
70,114,1,0,0,0,0,0,0,1,2,0,0,0,0,0,0,0,0
71,108,46,34,61,797,97,26,56,25,133,264,546,6997,1190,186,471,858,7543
71,109,6,7,3,127,45,0,13,4,17,67,36,1190,461,0,98,130,1226
71,110,19,30,3,458,134,10,15,9,56,307,19,4180,1344,113,101,461,4199
71,114,1,0,0,0,0,0,0,1,6,0,0,0,0,0,0,0,0
71,119,4,0,0,0,0,0,0,2,8,0,0,0,0,0,0,0,0
73,112,3,0,0,0,0,0,0,2,10,0,0,0,0,0,0,0,0
73,118,2,0,0,0,0,0,0,1,9,0,0,0,0,0,0,0,0
74,109,511,514,275,11028,1306,127,728,226,1612,4173,2020,98022,13850,1122,7060,11303,100042
75,52,7,2,11,71,6,8,24,6,24,18,55,722,52,33,437,82,777
76,119,5,0,0,0,0,0,0,1,10,0,0,0,0,0,0,0,0
77,103,14,61,5,259,26,2,17,6,37,472,60,2039,180,20,160,264,2099
77,104,1,0,0,0,0,0,0,1,4,0,0,0,0,0,0,0,0
77,107,4,0,0,54,16,0,4,3,17,0,0,429,127,0,36,54,429
78,102,1,0,0,0,0,0,0,1,4,0,0,0,0,0,0,0,0
78,103,47,69,112,784,121,25,113,23,120,728,943,7257,1137,257,949,896,8200
78,104,12,53,12,268,79,4,21,7,44,455,90,2537,805,56,234,280,2627
78,109,4,0,0,0,0,0,0,2,7,0,0,0,0,0,0,0,0
78,112,7,0,0,0,0,0,0,3,16,0,0,0,0,0,0,0,0
78,113,4,7,4,99,60,0,0,4,12,37,20,885,640,0,0,103,905
78,119,2,0,0,0,0,0,0,1,6,0,0,0,0,0,0,0,0
78,120,1,0,0,0,0,0,0,1,6,0,0,0,0,0,0,0,0
78,126,3,0,0,0,0,0,0,1,6,0,0,0,0,0,0,0,0
79,103,3,0,0,0,0,0,0,2,8,0,0,0,0,0,0,0,0
79,108,53,45,42,1173,115,8,46,26,172,451,279,10482,1333,31,400,1215,10761
79,111,134,38,128,2776,289,39,74,59,406,283,750,23498,3007,291,554,2904,24248
79,112,1,0,0,0,0,0,0,1,6,0,0,0,0,0,0,0,0
79,113,5,0,0,0,0,0,0,3,11,0,0,0,0,0,0,0,0
79,114,1,0,0,0,0,0,0,1,4,0,0,0,0,0,0,0,0
80,102,4,0,0,0,0,0,0,1,8,0,0,0,0,0,0,0,0
80,107,2,0,0,0,0,0,0,2,8,0,0,0,0,0,0,0,0
80,108,349,344,250,7588,1672,124,454,161,1110,2787,1835,68439,18529,1075,4073,7838,70274
80,109,15,10,11,298,88,0,10,9,42,115,88,2732,1024,0,66,309,2820
80,111,310,165,310,6040,727,126,315,100,855,1191,1950,45997,6960,712,2198,6350,47947
80,112,22,4,60,333,43,7,27,9,51,15,365,2656,437,37,210,393,3021
80,114,1,0,0,0,0,0,0,1,4,0,0,0,0,0,0,0,0
81,59,58,37,376,1228,94,51,116,21,140,320,2257,8184,774,282,1062,1604,10441
81,103,5,0,0,0,0,0,0,1,10,0,0,0,0,0,0,0,0
81,108,36,81,5,828,199,6,44,13,105,685,50,7135,2063,72,276,833,7185
81,111,33,8,41,795,57,11,53,16,108,40,308,6692,570,113,486,836,7000
81,112,228,96,229,3874,464,41,183,98,664,830,1829,33384,4838,320,1584,4103,35213
81,123,2,0,0,0,0,0,0,2,5,0,0,0,0,0,0,0,0
82,59,584,367,5201,10402,662,394,1648,168,1650,2875,28693,67179,4549,2613,11793,15603,95872
82,102,1,0,0,0,0,0,0,1,4,0,0,0,0,0,0,0,0
82,104,42,80,4,618,183,26,60,23,126,695,42,5765,2010,292,608,622,5807
82,111,25,40,1,678,214,15,9,9,74,313,7,5007,1385,222,53,679,5014
82,112,50,19,52,907,127,13,54,23,154,184,377,8240,1586,159,457,959,8617
82,113,14,0,12,258,53,15,0,10,44,0,56,2258,669,61,0,270,2314
83,103,1,0,0,0,0,0,0,1,4,0,0,0,0,0,0,0,0
83,104,9,11,0,116,22,5,11,7,31,77,0,985,254,20,114,116,985
83,112,2,0,0,0,0,0,0,2,5,0,0,0,0,0,0,0,0
83,113,1,0,0,0,0,0,0,1,6,0,0,0,0,0,0,0,0
83,117,3,0,0,0,0,0,0,1,6,0,0,0,0,0,0,0,0
83,125,2,0,0,0,0,0,0,1,8,0,0,0,0,0,0,0,0
84,56,1,0,0,0,0,0,0,1,4,0,0,0,0,0,0,0,0
84,57,4,0,0,0,0,0,0,3,10,0,0,0,0,0,0,0,0
84,60,1,0,0,0,0,0,0,1,2,0,0,0,0,0,0,0,0
84,62,5,0,0,0,0,0,0,3,10,0,0,0,0,0,0,0,0
85,57,5,0,0,0,0,0,0,2,10,0,0,0,0,0,0,0,0
85,111,1145,2223,568,43313,10685,1352,1365,227,3365,17059,4394,330807,90979,7955,9267,43881,335201
85,112,28,19,24,645,72,11,14,13,70,93,191,4512,580,65,106,669,4703
85,121,4,0,0,0,0,0,0,2,10,0,0,0,0,0,0,0,0
85,125,5,12,0,78,17,0,0,3,15,98,0,679,146,0,0,78,679
86,57,11,0,0,0,0,0,0,5,27,0,0,0,0,0,0,0,0
86,111,100,50,77,2419,509,46,41,28,252,253,408,13673,2752,216,212,2496,14081
86,112,10,8,7,148,44,8,6,4,27,62,27,1223,460,35,30,155,1250
86,122,4,0,0,0,0,0,0,1,8,0,0,0,0,0,0,0,0
86,125,2,0,0,0,0,0,0,2,12,0,0,0,0,0,0,0,0
87,58,6,0,0,0,0,0,0,2,16,0,0,0,0,0,0,0,0
87,61,1,0,0,0,0,0,0,1,2,0,0,0,0,0,0,0,0
87,109,66,110,17,1631,366,22,64,32,221,836,119,14347,3710,131,568,1648,14466
87,110,39,72,20,831,252,4,12,18,117,642,86,7056,2534,32,100,851,7142
87,112,45,19,44,966,113,31,15,21,139,133,261,7475,1096,136,117,1010,7736
88,57,1,0,0,0,0,0,0,1,4,0,0,0,0,0,0,0,0
88,63,1,0,0,0,0,0,0,1,6,0,0,0,0,0,0,0,0
88,98,22,37,22,296,41,5,68,11,53,313,162,3025,418,35,679,318,3187
88,99,126,224,354,2801,453,81,245,59,376,2028,2947,20924,4022,654,2222,3155,23871
88,110,275,283,207,5343,858,119,248,112,770,2241,1467,43865,8453,710,2002,5550,45332
88,112,1648,1792,17544,88877,8506,2337,3457,204,4042,9402,56938,327953,54524,7738,20842,106421,384891
88,113,1,0,0,0,0,0,0,1,5,0,0,0,0,0,0,0,0
88,114,6,0,0,0,0,0,0,3,15,0,0,0,0,0,0,0,0
88,122,4,0,0,0,0,0,0,1,8,0,0,0,0,0,0,0,0
89,57,2,0,0,0,0,0,0,1,4,0,0,0,0,0,0,0,0
89,58,12,16,37,238,29,14,7,8,34,154,495,1459,196,119,49,275,1954
89,61,470,158,5045,11790,517,525,1841,161,1126,958,22565,55853,2707,2324,11498,16835,78418
89,62,24,4,194,690,40,28,26,12,61,15,876,2940,206,153,223,884,3816
89,63,16,15,66,288,7,35,77,9,43,133,630,2654,71,374,1036,354,3284
89,99,10,5,23,194,43,26,12,4,27,45,99,1810,468,334,157,217,1909
89,110,32,12,53,806,136,13,27,12,99,65,328,6917,1463,122,212,859,7245
89,112,25,27,8,711,125,13,12,14,86,215,24,5507,1391,62,77,719,5531
89,113,14,0,0,0,0,0,0,10,47,0,0,0,0,0,0,0,0
90,57,1,0,0,0,0,0,0,1,4,0,0,0,0,0,0,0,0
90,61,87,46,351,2073,104,98,58,53,244,342,2472,11086,531,730,326,2424,13558
90,62,3,0,0,0,0,0,0,2,6,0,0,0,0,0,0,0,0
90,98,1,0,0,0,0,0,0,1,2,0,0,0,0,0,0,0,0
90,112,327,501,748,18803,1978,870,182,135,761,1201,1972,48194,6399,2101,511,19551,50166
90,113,93,69,102,2906,351,147,38,51,269,433,439,15291,2476,598,206,3008,15730
91,57,28,0,0,0,0,0,0,12,77,0,0,0,0,0,0,0,0
91,58,163,133,538,3130,247,356,634,75,474,1099,4017,25373,1987,2870,6809,3668,29390
91,62,13,9,56,169,11,31,48,5,30,96,483,1583,126,320,520,225,2066
91,109,159,99,106,3596,388,37,149,70,506,836,780,29606,4161,285,1304,3702,30386
91,110,206,225,142,6739,883,225,225,80,629,1693,983,44616,7426,852,1809,6881,45599
91,111,403,311,227,9965,1178,163,284,157,1160,1959,1556,74180,11262,1206,2240,10192,75736
91,112,974,1452,1915,51803,5699,2304,697,376,2480,5102,5381,170105,22969,5966,3135,53718,175486
91,113,78,49,47,2245,384,91,75,50,273,326,205,15083,3775,415,589,2292,15288
91,117,5,0,1,94,55,1,0,4,18,0,13,975,687,18,0,95,988
92,58,27,23,102,396,39,28,70,19,90,162,957,3165,398,190,876,498,4122
92,59,1,0,0,0,0,0,0,1,2,0,0,0,0,0,0,0,0
92,99,20,18,42,386,85,8,70,16,69,140,268,3518,804,148,615,428,3786
92,100,1,0,0,0,0,0,0,1,2,0,0,0,0,0,0,0,0
92,109,1453,1476,1306,36354,7259,1024,1683,543,4499,10710,9584,272115,62364,5148,12351,37660,281699
92,110,572,616,797,13613,1663,169,249,222,1705,4249,5170,99627,16060,1255,1732,14410,104797
92,111,154,100,182,3977,380,66,102,61,457,687,1200,29171,3299,439,663,4159,30371
92,112,44,28,28,741,84,22,42,20,126,166,191,5296,851,188,305,769,5487
92,113,55,36,429,1030,107,48,74,19,136,239,872,6560,976,231,463,1459,7432
92,114,7,0,0,0,0,0,0,2,19,0,0,0,0,0,0,0,0
92,116,19,0,15,315,74,4,7,12,82,0,100,2534,704,8,47,330,2634
92,117,6,0,0,150,26,0,0,6,24,0,0,1084,216,0,0,150,1084
93,58,1,0,0,0,0,0,0,1,4,0,0,0,0,0,0,0,0
93,59,5,0,0,0,0,0,0,2,10,0,0,0,0,0,0,0,0
93,100,5,7,18,75,20,0,10,5,17,53,176,841,273,0,113,93,1017
93,101,5,0,0,0,0,0,0,3,14,0,0,0,0,0,0,0,0
93,109,101,70,83,2252,659,21,34,48,302,672,741,20578,7099,129,269,2335,21319
93,110,140,124,97,3241,576,56,76,61,425,911,647,26836,5961,411,613,3338,27483
93,112,394,270,398,9227,1372,169,423,179,1194,1923,2760,70707,13260,961,3356,9625,73467
93,114,6,0,0,0,0,0,0,2,15,0,0,0,0,0,0,0,0
93,115,4,17,0,100,29,0,0,4,19,140,0,956,351,0,0,100,956
93,116,2,0,0,0,0,0,0,1,6,0,0,0,0,0,0,0,0
94,60,126,91,298,1909,154,123,445,44,377,853,3377,17164,1408,1314,4926,2207,20541
94,99,16,13,6,229,59,17,1,9,48,88,59,1856,508,158,8,235,1915
94,111,10,11,17,220,33,9,6,4,22,92,121,1736,345,51,60,237,1857
94,112,546,594,1334,27726,2761,552,950,177,1622,3218,5028,120487,19020,1839,6195,29060,125515
94,114,4,0,0,0,0,0,0,1,9,0,0,0,0,0,0,0,0
94,118,4,0,0,0,0,0,0,1,8,0,0,0,0,0,0,0,0
94,121,9,0,0,0,0,0,0,4,24,0,0,0,0,0,0,0,0
95,96,2,0,0,0,0,0,0,1,4,0,0,0,0,0,0,0,0
95,98,2,0,0,0,0,0,0,2,5,0,0,0,0,0,0,0,0
95,99,35,26,149,647,118,21,43,19,104,148,650,4834,1019,156,374,796,5484
95,112,79,96,51,1965,415,18,128,34,257,865,359,17030,4314,144,1073,2016,17389
95,114,5,0,0,0,0,0,0,2,12,0,0,0,0,0,0,0,0
95,115,8,0,28,282,18,3,16,3,28,0,64,2057,127,25,93,310,2121
95,116,4,0,0,0,0,0,0,2,8,0,0,0,0,0,0,0,0
95,117,8,18,0,219,41,0,0,5,29,158,0,2079,405,0,0,219,2079
95,118,13,13,7,366,63,11,0,5,41,89,71,2879,761,77,0,373,2950
96,98,2,0,0,0,0,0,0,1,4,0,0,0,0,0,0,0,0
96,99,103,75,717,1176,205,41,142,32,451,647,4906,10599,2367,418,1377,1893,15505
96,100,5,16,7,79,10,0,13,3,19,161,7,711,112,0,128,86,718
96,111,48,0,0,0,0,0,0,20,162,0,0,0,0,0,0,0,0
96,112,113,72,65,2737,362,44,165,54,373,482,512,24107,3726,307,1483,2802,24619
96,116,89,54,154,2125,196,31,185,49,270,351,1155,15551,1797,174,1997,2279,16706
96,117,29,46,9,644,144,0,17,19,105,353,84,5581,1515,0,109,653,5665
96,118,20,53,28,505,146,1,3,11,69,405,29,4245,1457,7,30,533,4274
97,97,2,0,0,0,0,0,0,1,4,0,0,0,0,0,0,0,0
97,98,16,20,61,205,26,3,82,13,57,173,468,1788,257,24,821,266,2256
97,110,5,0,0,0,0,0,0,1,16,0,0,0,0,0,0,0,0
97,111,150,97,48,3659,344,32,147,51,414,730,359,30382,3085,249,1290,3707,30741
97,116,702,397,1922,21747,1937,414,1983,195,1958,2629,7449,124673,14937,1230,13970,23669,132122
97,117,204,161,292,4692,933,163,90,125,650,1332,1775,34961,9257,658,652,4984,36736
97,118,16,27,1,435,96,5,0,12,66,195,3,3627,984,35,0,436,3630
97,119,6,0,9,167,31,0,1,5,28,0,45,1130,317,0,6,176,1175
97,127,5,0,0,0,0,0,0,2,14,0,0,0,0,0,0,0,0
98,98,221,90,765,2851,222,131,569,73,652,671,6676,25467,2402,1226,6029,3616,32143
98,99,40,54,76,821,61,31,233,18,117,418,532,7200,599,298,2297,897,7732
98,110,65,17,77,1404,50,7,156,25,174,116,606,11733,520,77,1255,1481,12339
98,111,309,299,94,6705,632,82,436,120,873,2608,717,55834,6490,524,3676,6799,56551
98,116,19,11,17,868,124,5,60,11,53,48,95,4337,710,30,377,885,4432
98,117,295,125,320,6862,776,213,233,146,878,743,1630,43103,6331,785,1541,7182,44733
98,118,29,15,13,736,175,15,9,17,107,105,40,5987,1723,122,39,749,6027
99,94,2,0,0,0,0,0,0,2,10,0,0,0,0,0,0,0,0
99,95,32,56,73,636,184,21,22,18,106,475,438,5856,1811,196,248,709,6294
99,110,107,67,57,2693,248,3,177,49,341,597,419,21975,2426,11,1541,2750,22394
99,117,368,359,1200,11627,1134,383,287,153,1022,1815,3871,61683,8081,1344,1705,12827,65554
99,118,13,4,0,358,82,15,3,9,48,19,0,3231,928,194,12,358,3231
100,95,1,0,0,0,0,0,0,1,3,0,0,0,0,0,0,0,0
100,96,33,24,50,453,103,19,55,10,100,184,396,4044,1265,157,428,503,4440
100,97,183,117,369,2793,316,90,775,80,513,1019,2801,23686,2685,778,7167,3162,26487
100,117,73,166,474,3598,447,86,114,35,228,824,1162,16240,2425,280,614,4072,17402
100,118,7,0,0,0,0,0,0,5,30,0,0,0,0,0,0,0,0
101,93,2,0,0,0,0,0,0,2,9,0,0,0,0,0,0,0,0
101,95,5,22,15,124,28,0,33,4,22,220,164,1265,318,0,383,139,1429
101,96,1,0,0,0,0,0,0,1,4,0,0,0,0,0,0,0,0
101,97,17,19,18,273,32,1,93,8,48,233,107,2656,348,2,972,291,2763
101,117,317,562,1825,11859,1279,364,399,171,980,1993,5297,57654,9465,1570,1921,13684,62951
101,118,20,57,4,572,107,10,0,14,64,401,32,4487,991,69,0,576,4519
101,119,2,0,0,0,0,0,0,1,8,0,0,0,0,0,0,0,0
102,117,129,96,103,3248,445,82,48,95,442,683,528,23360,4494,398,373,3351,23888
102,118,18,37,4,539,28,17,6,12,68,245,16,3758,171,155,12,543,3774
103,117,14,0,0,0,0,0,0,12,49,0,0,0,0,0,0,0,0
103,118,2,0,0,0,0,0,0,1,10,0,0,0,0,0,0,0,0
103,122,2,0,0,0,0,0,0,1,4,0,0,0,0,0,0,0,0
104,112,46,57,23,1688,164,42,7,40,138,341,92,9441,1014,292,27,1711,9533
104,113,1,0,0,0,0,0,0,1,3,0,0,0,0,0,0,0,0
104,117,124,95,252,3224,460,137,67,83,394,605,912,21447,4189,651,294,3476,22359
104,118,12,0,22,470,69,14,23,8,47,0,97,2907,660,98,79,492,3004
104,125,2,0,0,0,0,0,0,1,3,0,0,0,0,0,0,0,0
105,74,1,0,0,0,0,0,0,1,2,0,0,0,0,0,0,0,0
105,112,226,178,345,12912,809,336,86,174,566,536,999,44023,3260,933,360,13257,45022
105,113,524,207,731,28079,1569,941,131,403,1337,563,2586,95917,6286,2950,367,28810,98503
105,114,7,5,26,357,7,26,4,7,24,7,65,1277,26,84,8,383,1342
105,117,7,0,1,257,12,17,1,6,31,0,1,1926,65,178,20,258,1927
105,118,1,0,0,0,0,0,0,1,4,0,0,0,0,0,0,0,0
106,112,590,411,1892,47958,2200,1365,216,386,1385,1045,3705,126704,6667,3228,511,49850,130409
106,113,4599,3576,26625,351243,17152,12406,2750,2346,11491,9094,54352,898268,54422,29885,6436,377868,952620
106,114,46,14,128,1874,127,60,6,44,134,65,624,7265,519,171,18,2002,7889
106,117,6,0,4,113,34,9,0,5,23,0,84,767,308,54,0,117,851
107,91,27,53,22,494,47,26,73,13,81,538,171,4165,460,174,699,516,4336
107,92,8,2,17,110,10,9,24,4,23,12,127,1071,202,98,197,127,1198
107,93,35,33,48,896,86,49,35,8,93,302,308,6569,812,295,274,944,6877
107,112,467,525,3755,36808,2005,1144,318,249,1200,1596,7116,107384,6677,3474,756,40563,114500
107,113,355,218,5034,21226,1076,869,387,201,863,738,8535,60400,3522,2339,760,26260,68935
107,114,172,85,4706,29016,518,640,215,71,377,206,7523,46242,1724,1528,452,33722,53765
107,115,12,0,7,264,22,16,5,9,30,0,29,1694,128,58,36,271,1723
107,116,1,0,0,0,0,0,0,1,3,0,0,0,0,0,0,0,0
107,123,10,0,0,0,0,0,0,5,27,0,0,0,0,0,0,0,0
108,75,32,9,33,1523,61,39,19,8,84,74,219,6343,293,206,125,1556,6562
108,76,42,31,28,1309,69,59,2,15,119,182,176,5958,573,391,10,1337,6134
108,77,3,0,0,0,0,0,0,1,8,0,0,0,0,0,0,0,0
108,78,10,0,0,0,0,0,0,2,24,0,0,0,0,0,0,0,0
108,91,5,0,12,123,16,0,5,4,20,0,90,1110,197,0,63,135,1200
108,92,27,25,44,562,56,61,34,10,80,223,202,3628,446,438,180,606,3830
108,93,451,700,1044,10990,1126,313,999,138,1216,4392,5845,78316,10420,1760,7615,12034,84161
108,96,23,145,0,198,7,0,3,12,49,1626,0,2103,74,0,19,198,2103
108,112,300,714,5873,29748,1876,677,392,39,628,2295,9746,80704,6386,1650,801,35621,90450
108,113,88,30,137,2840,179,208,20,78,244,135,638,11644,776,898,76,2977,12282
108,114,46,22,104,1567,119,131,17,44,140,68,537,5908,729,434,57,1671,6445
108,115,4,0,7,95,1,12,0,4,11,0,17,656,3,109,0,102,673
108,116,2,0,0,0,0,0,0,2,7,0,0,0,0,0,0,0,0
108,117,209,104,3677,15183,596,388,374,44,554,334,7358,33461,2983,1047,802,18860,40819
108,127,4,0,0,0,0,0,0,1,8,0,0,0,0,0,0,0,0
109,75,3305,2615,6673,173816,6718,6451,3938,748,7895,14110,22166,586722,36612,30127,27191,180489,608888
109,76,27,30,11,761,43,30,9,9,61,233,55,3617,367,146,101,772,3672
109,78,1,0,0,0,0,0,0,1,6,0,0,0,0,0,0,0,0
109,92,5,0,0,0,0,0,0,2,12,0,0,0,0,0,0,0,0
109,93,5,0,0,0,0,0,0,2,12,0,0,0,0,0,0,0,0
109,95,52,62,38,849,115,47,66,27,156,568,343,6447,1013,311,483,887,6790
109,96,8,0,0,0,0,0,0,2,20,0,0,0,0,0,0,0,0
109,98,2,0,0,0,0,0,0,2,12,0,0,0,0,0,0,0,0
109,99,28,4,7,683,3,2,13,7,77,56,44,5493,38,26,124,690,5537
109,112,179,174,291,7489,620,193,75,117,487,817,831,37792,4244,689,376,7780,38623
109,113,181,81,514,6894,481,502,89,134,505,243,1660,27056,2565,1600,340,7408,28716
109,114,34,4,45,714,52,82,8,25,87,7,121,3093,350,315,9,759,3214
109,115,3,0,0,0,0,0,0,2,10,0,0,0,0,0,0,0,0
109,116,1,0,0,0,0,0,0,1,3,0,0,0,0,0,0,0,0
109,117,7,4,88,278,4,15,12,6,30,20,145,1327,15,84,34,366,1472
110,75,19,21,7,580,15,59,1,6,51,69,132,2397,59,329,1,587,2529
110,95,10,0,0,0,0,0,0,7,34,0,0,0,0,0,0,0,0
110,99,629,868,1147,12156,1038,320,932,244,1762,6350,8093,98152,9862,2508,9417,13303,106245
110,112,208,0,0,0,0,0,0,27,482,0,0,0,0,0,0,0,0
110,113,104,65,267,3760,320,213,35,87,289,231,902,16391,1938,752,192,4027,17293
110,114,18,2,45,532,55,23,6,17,48,6,212,2354,279,138,39,577,2566
110,115,1,0,0,0,0,0,0,1,2,0,0,0,0,0,0,0,0
110,116,6,0,15,72,4,6,0,5,20,0,211,366,12,28,0,87,577
110,117,8,5,7,182,29,9,0,7,29,45,61,1401,279,34,0,189,1462
110,118,4,0,0,0,0,0,0,2,10,0,0,0,0,0,0,0,0
110,119,9,0,2,271,65,8,0,5,35,0,16,2359,635,50,0,273,2375
111,95,14,0,0,0,0,0,0,5,32,0,0,0,0,0,0,0,0
111,99,5,0,0,0,0,0,0,1,14,0,0,0,0,0,0,0,0
111,112,5,13,0,268,32,11,10,3,16,35,0,1611,240,48,38,268,1611
111,113,28,18,11,1109,88,43,1,14,97,45,47,5358,425,179,1,1120,5405
111,114,20,3,31,683,31,44,12,18,70,6,67,3205,170,167,25,714,3272
111,115,8,0,0,0,0,0,0,3,21,0,0,0,0,0,0,0,0
111,116,8,0,63,140,43,6,0,8,33,0,468,950,401,36,0,203,1418
111,118,17,20,51,453,88,14,4,12,52,103,141,3049,783,49,40,504,3190
111,119,5,2,1,83,17,0,0,3,14,12,2,708,128,0,0,84,710
111,122,5,0,0,0,0,0,0,2,12,0,0,0,0,0,0,0,0
112,99,2,0,0,0,0,0,0,2,8,0,0,0,0,0,0,0,0
112,112,97,74,70,2764,302,125,38,47,258,473,355,15566,2242,568,186,2834,15921
112,113,82,74,104,2431,245,102,59,53,264,455,740,15745,1848,463,304,2535,16485
112,115,1,0,0,0,0,0,0,1,2,0,0,0,0,0,0,0,0
112,116,15,10,5,518,91,0,0,8,51,80,25,3658,809,0,0,523,3683
112,119,6,25,5,162,22,7,2,5,27,152,18,1061,230,22,7,167,1079
112,121,1,0,0,0,0,0,0,1,4,0,0,0,0,0,0,0,0
113,74,150,201,119,3787,324,250,346,29,328,1679,612,18892,2816,1686,3074,3906,19504
113,75,72,60,24,1159,117,72,140,13,193,465,121,7539,972,434,1470,1183,7660
113,78,38,38,19,752,73,62,28,17,98,358,112,5118,628,362,263,771,5230
113,99,4,0,0,0,0,0,0,3,10,0,0,0,0,0,0,0,0
113,112,555,1705,586,34998,10064,2072,1175,86,1627,8686,1975,155106,49451,5737,5624,35584,157081
113,113,83,28,272,2491,225,134,38,40,239,173,879,13800,1631,703,159,2763,14679
113,114,9,0,0,0,0,0,0,7,34,0,0,0,0,0,0,0,0
113,115,12,15,4,392,28,3,7,9,45,148,26,2624,209,19,7,396,2650
113,116,24,46,0,726,193,0,6,13,71,319,0,5876,1770,0,30,726,5876
113,119,2,0,0,0,0,0,0,1,9,0,0,0,0,0,0,0,0
113,120,5,0,0,0,0,0,0,2,10,0,0,0,0,0,0,0,0
114,99,147,132,183,3159,400,101,239,58,463,1019,1547,26284,4042,730,2244,3342,27831
114,111,206,158,239,6041,523,129,123,72,594,1131,1201,42575,4572,763,741,6280,43776
114,112,452,536,1942,15001,1534,473,300,196,1247,2680,5059,86453,11129,2013,1303,16943,91512
114,113,108,97,210,2991,400,106,62,61,339,574,1031,19138,3182,608,295,3201,20169
114,114,34,24,71,894,142,44,17,25,122,127,501,5922,1403,167,163,965,6423
114,115,44,14,17,834,154,12,2,25,128,124,96,5993,1434,75,24,851,6089
114,124,13,0,0,0,0,0,0,5,40,0,0,0,0,0,0,0,0
115,74,27,0,0,0,0,0,0,13,71,0,0,0,0,0,0,0,0
115,94,11,5,16,106,23,2,0,7,32,70,117,953,238,28,0,122,1070
115,99,131,58,258,2834,397,123,163,61,388,388,1965,20270,3244,805,1410,3092,22235
115,100,230,262,1328,8477,953,203,1433,10,474,1904,4966,56350,6893,869,8710,9805,61316
115,111,1211,1664,7038,68737,4920,999,1097,233,2869,7393,15256,287817,25849,3812,4114,75775,303073
115,112,29,49,20,795,108,4,0,18,111,408,132,6262,995,16,0,815,6394
115,114,4,0,0,0,0,0,0,2,13,0,0,0,0,0,0,0,0
115,115,11,0,0,252,25,11,0,8,35,0,0,1937,290,73,0,252,1937
116,76,2,0,0,0,0,0,0,2,6,0,0,0,0,0,0,0,0
116,87,24,16,23,512,80,26,61,14,69,138,167,4366,878,192,549,535,4533
116,99,1314,1867,3841,49396,6809,829,2818,273,3378,10836,16580,365999,58924,4866,19392,53237,382579
116,100,169,127,508,4399,292,269,238,53,443,846,2626,25151,1642,1709,1766,4907,27777
116,110,18,18,12,335,53,9,6,9,55,94,81,2246,441,31,48,347,2327
116,111,31,32,47,910,105,19,37,13,80,245,214,6474,812,117,257,957,6688
116,112,27,27,43,806,107,39,7,11,70,155,230,4967,1110,164,21,849,5197
116,115,1,0,0,0,0,0,0,1,4,0,0,0,0,0,0,0,0
117,87,4,0,0,0,0,0,0,1,10,0,0,0,0,0,0,0,0
117,95,19,10,17,301,42,26,0,8,57,20,98,2154,459,133,0,318,2252
117,96,1,0,0,0,0,0,0,1,4,0,0,0,0,0,0,0,0
117,97,1,0,0,0,0,0,0,1,2,0,0,0,0,0,0,0,0
117,99,96,41,190,1870,241,152,131,48,318,293,872,14478,2273,998,1211,2060,15350
117,100,35,58,65,868,117,19,43,17,107,452,252,6285,1173,38,370,933,6537
117,109,269,205,453,6887,612,149,269,71,713,1255,1708,42747,4155,793,1664,7340,44455
117,110,374,258,393,9285,967,172,362,130,956,1581,1848,65667,8147,763,2821,9678,67515
117,111,7,15,2,112,23,0,0,4,17,154,15,845,212,0,0,114,860
117,122,208,0,0,0,0,0,0,13,445,0,0,0,0,0,0,0,0
117,126,15,0,0,0,0,0,0,4,36,0,0,0,0,0,0,0,0
118,94,7,19,18,147,50,10,0,6,30,158,68,1092,485,78,0,165,1160
118,109,21,13,4,337,43,8,3,7,56,93,11,2372,378,34,6,341,2383
118,110,8,23,21,457,44,11,13,3,24,112,59,2483,314,45,47,478,2542
118,111,2,0,0,0,0,0,0,2,6,0,0,0,0,0,0,0,0
118,114,1,0,0,0,0,0,0,1,6,0,0,0,0,0,0,0,0
118,127,1,0,0,0,0,0,0,1,6,0,0,0,0,0,0,0,0
119,30,2,0,0,0,0,0,0,1,4,0,0,0,0,0,0,0,0
119,94,14,1,21,238,16,3,0,3,30,3,115,1020,167,12,0,259,1135
119,108,19,0,0,0,0,0,0,2,37,0,0,0,0,0,0,0,0
119,111,1,0,0,0,0,0,0,1,4,0,0,0,0,0,0,0,0
119,112,23,59,2,794,304,0,1,16,98,509,10,7136,3152,0,14,796,7146
119,113,6,4,11,204,37,3,0,5,22,56,55,1214,296,4,0,215,1269
119,115,1,0,0,0,0,0,0,1,6,0,0,0,0,0,0,0,0
120,77,1,0,0,0,0,0,0,1,4,0,0,0,0,0,0,0,0
120,87,22,28,21,463,65,31,66,8,53,208,222,3375,589,189,494,484,3597
120,96,6,0,0,0,0,0,0,2,12,0,0,0,0,0,0,0,0
120,97,2,0,0,0,0,0,0,2,10,0,0,0,0,0,0,0,0
120,99,161,167,151,2871,432,211,199,80,469,1498,1081,22558,4519,1573,1729,3022,23639
120,108,9,4,6,235,11,6,6,5,29,50,24,1798,93,20,28,241,1822
120,111,2,0,0,0,0,0,0,2,9,0,0,0,0,0,0,0,0
120,112,1,0,0,0,0,0,0,1,5,0,0,0,0,0,0,0,0
120,115,12,11,0,259,89,0,0,6,36,77,0,2239,964,0,0,259,2239
121,72,125,114,59,1999,208,29,255,29,307,842,482,16564,1832,152,2324,2058,17046
121,73,26,13,19,393,30,6,21,8,70,126,171,3204,254,72,277,412,3375
121,77,5,0,0,0,0,0,0,2,14,0,0,0,0,0,0,0,0
121,78,26,7,72,406,47,69,23,14,71,59,456,2670,498,389,199,478,3126
121,80,28,14,20,631,98,39,10,16,89,103,109,4672,872,286,64,651,4781
121,87,7,9,1,148,8,4,12,3,20,45,16,1077,70,38,65,149,1093
121,97,28,14,32,517,71,65,14,8,68,64,130,2988,526,370,99,549,3118
121,99,31,18,37,512,112,41,46,20,104,137,226,4503,1242,357,381,549,4729
121,100,19,24,4,156,34,9,0,5,45,203,29,1447,381,96,0,160,1476
121,108,344,208,238,7063,752,135,198,149,1035,1430,1600,51063,6710,945,1479,7301,52663
121,109,1,0,0,0,0,0,0,1,4,0,0,0,0,0,0,0,0
121,111,1,0,0,0,0,0,0,1,4,0,0,0,0,0,0,0,0
121,124,2,0,0,0,0,0,0,1,10,0,0,0,0,0,0,0,0
122,77,1,0,0,0,0,0,0,1,2,0,0,0,0,0,0,0,0
122,78,1050,426,5567,27688,1242,1313,2577,213,2541,3146,31423,164995,9203,7591,17927,33255,196418
122,87,10,0,0,0,0,0,0,1,30,0,0,0,0,0,0,0,0
122,96,7,0,0,0,0,0,0,7,27,0,0,0,0,0,0,0,0
122,97,3,0,0,0,0,0,0,1,6,0,0,0,0,0,0,0,0
122,99,462,452,1980,12493,1921,392,953,175,1260,3589,12198,89400,18552,2506,8064,14473,101598
122,107,28,29,18,806,177,21,7,15,97,199,109,5772,1695,107,49,824,5881
122,108,4,0,0,0,0,0,0,1,8,0,0,0,0,0,0,0,0
122,110,2,0,0,0,0,0,0,1,10,0,0,0,0,0,0,0,0
122,113,1,0,0,0,0,0,0,1,6,0,0,0,0,0,0,0,0
122,125,6,3,2,99,19,0,0,3,18,15,18,879,187,0,0,101,897
123,72,80,246,86,3257,849,83,352,20,265,1839,742,24866,5966,489,3416,3343,25608
123,76,18,12,7,370,91,31,12,10,46,78,37,2397,904,188,88,377,2434
123,77,2,0,0,0,0,0,0,1,4,0,0,0,0,0,0,0,0
123,86,2,0,0,0,0,0,0,1,4,0,0,0,0,0,0,0,0
123,99,152,113,311,2769,334,150,363,73,482,1249,2595,26044,3471,1338,3683,3080,28639
123,106,50,0,0,0,0,0,0,15,130,0,0,0,0,0,0,0,0
123,107,318,242,244,6234,669,114,187,146,929,1774,1685,47270,6374,671,1416,6478,48955
123,110,7,0,1,160,68,2,0,3,18,0,7,1680,803,14,0,161,1687
123,113,1,0,0,0,0,0,0,1,6,0,0,0,0,0,0,0,0
123,120,2,0,0,0,0,0,0,2,12,0,0,0,0,0,0,0,0
123,123,1,0,0,0,0,0,0,1,6,0,0,0,0,0,0,0,0
123,127,3,0,0,0,0,0,0,1,6,0,0,0,0,0,0,0,0
124,76,4,0,0,0,0,0,0,3,9,0,0,0,0,0,0,0,0
124,80,1,0,0,0,0,0,0,1,2,0,0,0,0,0,0,0,0
124,81,1,0,0,0,0,0,0,1,2,0,0,0,0,0,0,0,0
124,86,1,0,0,0,0,0,0,1,6,0,0,0,0,0,0,0,0
124,87,324,7612,216,11291,1883,122,493,11,675,56352,1099,86847,17577,816,2979,11507,87946
124,107,6,0,0,0,0,0,0,1,12,0,0,0,0,0,0,0,0
124,109,3,0,0,117,39,0,0,3,16,0,0,1019,422,0,0,117,1019
125,72,25,10,18,409,13,8,36,10,74,77,173,4579,124,77,627,427,4752
125,76,4,0,0,0,0,0,0,2,12,0,0,0,0,0,0,0,0
125,80,5,0,0,0,0,0,0,2,10,0,0,0,0,0,0,0,0
125,86,45,30,96,644,42,8,149,17,109,205,970,5772,362,84,1699,740,6742
125,87,2217,2447,5781,74324,8514,4600,3112,421,5520,15953,24183,448997,61537,24964,22974,80105,473180
125,107,7,0,11,152,12,0,13,3,21,0,69,1138,141,0,77,163,1207
125,108,1,0,0,0,0,0,0,1,6,0,0,0,0,0,0,0,0
125,109,20,0,0,440,117,0,14,7,52,0,0,3814,1220,0,98,440,3814
125,122,1,0,0,0,0,0,0,1,6,0,0,0,0,0,0,0,0
125,123,6,0,0,0,0,0,0,1,11,0,0,0,0,0,0,0,0
125,126,2,0,0,0,0,0,0,1,4,0,0,0,0,0,0,0,0
126,72,266,94,212,5872,248,94,964,72,832,913,1809,53363,2819,698,9769,6084,55172
126,75,13,19,0,157,18,6,12,7,35,169,0,1763,253,102,72,157,1763
126,76,15,13,29,246,17,20,41,6,51,92,445,2220,196,136,543,275,2665
126,80,2,0,0,0,0,0,0,1,6,0,0,0,0,0,0,0,0
126,87,302,363,646,8641,933,921,273,122,819,2626,3865,47700,6728,5043,2435,9287,51565
126,107,1793,1503,1324,35252,4673,331,641,491,4890,8908,6953,244287,39648,1613,3998,36576,251240
126,108,5,0,0,0,0,0,0,2,14,0,0,0,0,0,0,0,0
126,109,3,0,0,0,0,0,0,3,16,0,0,0,0,0,0,0,0
126,124,1,0,0,0,0,0,0,1,4,0,0,0,0,0,0,0,0
127,75,5,0,0,0,0,0,0,2,13,0,0,0,0,0,0,0,0
127,78,57,39,93,1085,130,76,71,22,152,382,732,8189,1239,490,640,1178,8921
127,80,127,92,84,1921,277,73,299,46,365,835,810,18234,3209,641,3384,2005,19044
127,81,2,0,0,0,0,0,0,1,8,0,0,0,0,0,0,0,0
127,107,1404,2499,3465,52657,9572,1097,2656,345,3926,13848,11698,296947,64750,4243,13884,56122,308645
127,108,57,15,60,1056,87,11,66,13,166,40,320,6151,500,29,378,1116,6471
127,109,1,0,0,0,0,0,0,1,4,0,0,0,0,0,0,0,0
127,110,10,0,7,270,71,12,0,7,38,0,7,2291,735,54,0,277,2298
127,120,4,0,0,0,0,0,0,1,8,0,0,0,0,0,0,0,0
