x,y,TOTAL_ESTA,ARRIVALS_T,ARRIVALS_D,ARRIVALS_F,ARRIVALS_G,ARRIVALS_S,ARRIVALS_I,ARRIVALS_A,NIGHTS_TOT,NIGHTS_DOM,NIGHTS_FOR,NIGHTS_Ger,NIGHTS_Slo,NIGHTS_Ita,NIGHTS_Aus
4594000,2492000,60,20549,359,20190,1946,8448,2274,2204,112872,1191,111681,14947,44284,8877,10500
4595000,2491000,116,15420,702,14718,1839,4520,2430,2603,79343,1788,77555,13288,24667,9044,11517
4595000,2492000,41,44962,2175,42787,8813,19245,4333,3548,228824,8847,219977,57005,93917,16452,17736
4596000,2485000,1,0,0,0,0,0,0,0,0,0,0,0,0,0,0
4596000,2486000,2,0,0,0,0,0,0,0,0,0,0,0,0,0,0
4596000,2487000,469,95314,4774,90540,16835,16370,10844,19448,546475,16519,529956,148725,71245,47787,89738
4596000,2488000,35,58856,3143,55713,11296,12384,5578,10853,331346,8081,323265,86815,50224,23244,57408
4596000,2489000,16,146467,15410,131057,17858,26648,20889,33282,658938,44252,614686,124310,85143,71117,143438
4596000,2490000,7,263,1,262,54,37,14,45,1745,4,1741,388,239,86,234
4596000,2491000,3,0,0,0,0,0,0,0,0,0,0,0,0,0,0
4597000,2483000,37,3443,106,3337,505,1690,327,203,23355,429,22926,4371,11324,1867,1094
4597000,2486000,15,610,61,549,37,96,80,80,3295,226,3069,225,385,484,344
4597000,2487000,3,63,13,50,6,9,16,4,273,35,238,43,35,54,26
4597000,2493000,71,30616,1949,28667,4222,5441,1984,6636,145302,4902,140400,27340,27083,6760,25731
4598000,2475000,1,0,0,0,0,0,0,0,0,0,0,0,0,0,0
4598000,2481000,71,6871,65,6806,1130,1796,1151,1139,43205,201,43004,9573,9175,7455,6464
4598000,2482000,42,16290,224,16066,3669,5279,1306,1487,76106,503,75603,18934,26965,4772,6726
4598000,2483000,18,948,51,897,176,97,185,84,5628,449,5179,1474,388,960,428
4598000,2485000,31,2518,148,2370,352,365,560,287,11506,521,10985,2372,1189,2187,1338
4598000,2489000,58,3648,267,3381,727,594,689,314,20469,958,19511,6039,2555,2995,1707
4599000,2474000,4,1405,31,1374,229,192,118,483,7964,121,7843,1761,993,664,2393
4599000,2475000,2,0,0,0,0,0,0,0,0,0,0,0,0,0,0
4599000,2476000,116,8794,112,8682,1096,5046,551,467,56736,436,56300,9999,31405,3045,2680
4599000,2477000,2,0,0,0,0,0,0,0,0,0,0,0,0,0,0
4599000,2478000,46,0,0,0,0,0,0,0,0,0,0,0,0,0,0
4599000,2491000,2,0,0,0,0,0,0,0,0,0,0,0,0,0,0
4600000,2473000,19,743,18,725,153,65,110,113,4699,94,4605,1213,270,824,549
4600000,2474000,464,193505,7421,186084,38399,53406,14908,44049,1014351,20493,993858,275379,249335,59234,201740
4600000,2475000,11,529,14,515,171,56,52,90,3567,70,3497,1327,343,367,466
4600000,2478000,27,1464,31,1433,496,138,87,351,11307,239,11068,4160,811,475,2777
4600000,2482000,22,1319,68,1251,335,108,219,186,7889,171,7718,2752,334,1277,1263
4600000,2485000,14,0,0,0,0,0,0,0,0,0,0,0,0,0,0
4600000,2488000,7,366,43,323,56,51,100,34,1654,91,1563,369,133,425,197
4600000,2489000,9,380,12,368,69,29,93,48,2125,52,2073,478,81,483,224
4600000,2490000,17,1714,88,1626,333,182,397,192,8058,234,7824,2774,531,1315,810
4600000,2491000,2,0,0,0,0,0,0,0,0,0,0,0,0,0,0
4600000,2492000,2,0,0,0,0,0,0,0,0,0,0,0,0,0,0
4601000,2474000,5,95,10,85,16,13,17,0,711,70,641,113,120,103,0
4601000,2475000,14,422,11,411,189,26,25,58,3435,70,3365,1729,72,193,450
4601000,2476000,3,164,0,164,45,29,14,47,991,0,991,403,82,57,310
4601000,2478000,1,0,0,0,0,0,0,0,0,0,0,0,0,0,0
4601000,2480000,2,0,0,0,0,0,0,0,0,0,0,0,0,0,0
4601000,2483000,10,675,48,627,291,25,101,62,4840,140,4700,2708,88,464,446
4601000,2487000,28,1859,129,1730,459,152,293,243,10842,600,10242,3700,507,1188,1337
4601000,2488000,7,0,0,0,0,0,0,0,0,0,0,0,0,0,0
4602000,2467000,1,0,0,0,0,0,0,0,0,0,0,0,0,0,0
4602000,2471000,1,0,0,0,0,0,0,0,0,0,0,0,0,0,0
4602000,2474000,15,894,31,863,159,115,202,82,4486,133,4353,1141,367,950,334
4602000,2475000,4,195,6,189,75,10,8,46,1298,8,1290,566,52,22,305
4602000,2476000,47,2693,210,2483,927,257,320,305,17958,699,17259,8934,1016,1616,1799
4602000,2477000,2,0,0,0,0,0,0,0,0,0,0,0,0,0,0
4602000,2478000,11,0,0,0,0,0,0,0,0,0,0,0,0,0,0
4602000,2481000,7,343,24,319,64,20,12,37,2256,53,2203,567,54,33,266
4602000,2483000,5,180,16,164,67,13,18,9,1566,52,1514,739,94,117,84
4602000,2486000,1,0,0,0,0,0,0,0,0,0,0,0,0,0,0
4602000,2487000,1,0,0,0,0,0,0,0,0,0,0,0,0,0,0
4603000,2461000,1,0,0,0,0,0,0,0,0,0,0,0,0,0,0
4603000,2462000,9,469,7,462,159,9,74,67,4630,73,4557,1627,42,806,596
4603000,2463000,76,21819,2098,19721,4121,1251,3324,4539,97265,4451,92814,26007,3793,12322,20185
4603000,2464000,53,172752,16859,155893,27430,10344,22565,44891,779824,39999,739825,170400,27456,74146,191489
4603000,2465000,6,466,1,465,181,4,51,89,3673,2,3671,1735,21,543,506
4603000,2466000,25,6010,73,5937,1747,377,533,1155,44834,308,44526,15547,1495,3001,7162
4603000,2467000,17,755,8,747,254,50,153,75,6012,31,5981,2521,332,1087,490
4603000,2468000,4,0,0,0,0,0,0,0,0,0,0,0,0,0,0
4603000,2469000,143,0,0,0,0,0,0,0,0,0,0,0,0,0,0
4603000,2470000,1,0,0,0,0,0,0,0,0,0,0,0,0,0,0
4603000,2471000,1,0,0,0,0,0,0,0,0,0,0,0,0,0,0
4603000,2475000,2,0,0,0,0,0,0,0,0,0,0,0,0,0,0
4603000,2476000,1,0,0,0,0,0,0,0,0,0,0,0,0,0,0
4603000,2481000,3,0,0,0,0,0,0,0,0,0,0,0,0,0,0
4603000,2483000,9,534,30,504,196,20,40,154,3831,127,3704,1674,81,215,1055
4603000,2485000,2,0,0,0,0,0,0,0,0,0,0,0,0,0,0
4604000,2455000,82,4564,274,4290,1004,289,663,966,27830,1341,26489,8175,1519,3744,4710
4604000,2457000,15,0,0,0,0,0,0,0,0,0,0,0,0,0,0
4604000,2458000,167,219360,7147,212213,55614,33893,20866,18969,1654693,29902,1624791,541934,175739,109806,129015
4604000,2461000,11,806,52,754,141,62,215,128,4405,141,4264,1115,230,1341,597
4604000,2462000,48,2626,98,2528,871,139,362,319,18731,370,18361,8073,536,2154,1774
4604000,2463000,50,2874,85,2789,670,158,376,382,19457,350,19107,5465,697,2070,2044
4604000,2464000,534,224282,11783,212499,51756,24742,22994,43203,1237732,31884,1205848,364832,107598,91199,205833
4604000,2465000,172,18664,603,18061,5678,1157,1721,2917,126249,3196,123053,48330,4877,9063,16064
4604000,2466000,160,10150,277,9873,2950,580,1554,1278,63195,1384,61811,24791,2024,7656,6603
4604000,2467000,3,138,0,138,71,0,4,22,1137,0,1137,672,0,24,100
4604000,2469000,5,216,0,216,86,120,2,6,1541,0,1541,770,713,6,46
4604000,2470000,1,0,0,0,0,0,0,0,0,0,0,0,0,0,0
4604000,2471000,77,4171,143,4028,1358,159,475,768,30824,610,30214,12417,796,2897,5351
4604000,2472000,1,0,0,0,0,0,0,0,0,0,0,0,0,0,0
4604000,2478000,2,0,0,0,0,0,0,0,0,0,0,0,0,0,0
4604000,2482000,1,0,0,0,0,0,0,0,0,0,0,0,0,0,0
4604000,2483000,2,0,0,0,0,0,0,0,0,0,0,0,0,0,0
4604000,2488000,1,0,0,0,0,0,0,0,0,0,0,0,0,0,0
4605000,2454000,11,607,18,589,158,49,82,119,4861,124,4737,1747,437,454,821
4605000,2455000,156,203481,3925,199556,60818,31740,23679,34634,1539737,14564,1525173,593285,177946,131132,227895
4605000,2457000,12,886,40,846,312,36,174,60,5842,116,5726,2323,179,974,354
4605000,2458000,10,0,0,0,0,0,0,0,0,0,0,0,0,0,0
4605000,2461000,1,0,0,0,0,0,0,0,0,0,0,0,0,0,0
4605000,2462000,3,0,0,0,0,0,0,0,0,0,0,0,0,0,0
4605000,2463000,6,0,0,0,0,0,0,0,0,0,0,0,0,0,0
4605000,2464000,9,823,24,799,133,38,147,44,4706,85,4621,928,108,795,203
4605000,2465000,13,676,45,631,173,36,76,54,4633,305,4328,1656,119,321,294
4605000,2466000,105,6461,293,6168,2009,288,991,808,41976,1244,40732,17128,1177,4917,4409
4605000,2467000,47,2820,57,2763,1351,83,309,216,22747,191,22556,13042,396,1948,1279
4605000,2468000,19,1607,33,1574,655,40,203,261,11640,162,11478,5926,196,1031,1783
4605000,2471000,35,2126,101,2025,866,63,221,253,17213,438,16775,8663,268,1622,1803
4605000,2472000,77,115766,2583,113183,31881,13327,11994,28712,773463,9793,763670,263375,67669,64321,182732
4605000,2479000,2,0,0,0,0,0,0,0,0,0,0,0,0,0,0
4605000,2480000,19,2402,341,2061,297,189,317,576,7524,681,6843,1414,335,1054,1841
4605000,2485000,3,122,0,122,77,0,0,14,1217,0,1217,860,0,0,98
4605000,2488000,8,1243,67,1176,269,53,221,131,4479,111,4368,2206,71,448,392
4606000,2450000,2,0,0,0,0,0,0,0,0,0,0,0,0,0,0
4606000,2451000,1,0,0,0,0,0,0,0,0,0,0,0,0,0,0
4606000,2454000,1,0,0,0,0,0,0,0,0,0,0,0,0,0,0
4606000,2462000,1,0,0,0,0,0,0,0,0,0,0,0,0,0,0
4606000,2463000,44,2145,65,2080,735,138,380,207,15088,380,14708,6784,557,2260,1162
4606000,2464000,3,0,0,0,0,0,0,0,0,0,0,0,0,0,0
4606000,2467000,4,0,0,0,0,0,0,0,0,0,0,0,0,0,0
4606000,2468000,34,2251,142,2109,708,123,417,198,14052,595,13457,6342,338,1989,1006
4606000,2469000,3,0,0,0,0,0,0,0,0,0,0,0,0,0,0
4606000,2471000,2,0,0,0,0,0,0,0,0,0,0,0,0,0,0
4606000,2472000,4,141,2,139,74,9,4,19,1088,8,1080,653,42,44,125
4606000,2478000,1,0,0,0,0,0,0,0,0,0,0,0,0,0,0
4606000,2479000,6,246,6,240,117,6,15,4,2224,26,2198,1221,21,85,20
4606000,2486000,2,0,0,0,0,0,0,0,0,0,0,0,0,0,0
4606000,2487000,1,0,0,0,0,0,0,0,0,0,0,0,0,0,0
4606000,2488000,12,556,8,548,402,0,1,69,6024,84,5940,4667,0,14,476
4606000,2489000,7,5172,229,4943,176,197,3983,150,13060,342,12718,1079,276,9335,479
4607000,2447000,1,0,0,0,0,0,0,0,0,0,0,0,0,0,0
4607000,2448000,12,668,18,650,111,9,113,94,3254,59,3195,739,56,607,377
4607000,2450000,13,648,15,633,290,2,38,93,5218,56,5162,2862,56,327,607
4607000,2460000,35,1720,65,1655,621,62,258,154,13113,322,12791,5816,265,1570,962
4607000,2461000,3,0,0,0,0,0,0,0,0,0,0,0,0,0,0
4607000,2462000,27,1294,38,1256,598,35,164,97,9785,160,9625,5584,137,828,477
4607000,2463000,16,855,27,828,327,25,155,76,6588,105,6483,3358,111,820,505
4607000,2465000,13,719,20,699,231,50,116,90,4421,56,4365,2124,153,493,517
4607000,2468000,32,1847,78,1769,645,88,256,223,12989,286,12703,5788,224,1279,1404
4607000,2469000,11,380,15,365,154,16,71,23,3148,85,3063,1568,90,443,129
4607000,2471000,11,0,0,0,0,0,0,0,0,0,0,0,0,0,0
4607000,2473000,12,0,0,0,0,0,0,0,0,0,0,0,0,0,0
4607000,2474000,1,0,0,0,0,0,0,0,0,0,0,0,0,0,0
4607000,2483000,2,0,0,0,0,0,0,0,0,0,0,0,0,0,0
4607000,2484000,16,1394,369,1025,140,49,332,180,3526,653,2873,726,86,695,358
4607000,2487000,1,0,0,0,0,0,0,0,0,0,0,0,0,0,0
4607000,2488000,9,714,37,677,280,25,170,68,4072,97,3975,2471,137,561,271
4607000,2489000,1,0,0,0,0,0,0,0,0,0,0,0,0,0,0
4608000,2446000,6,610,2,608,113,12,165,118,4167,14,4153,979,52,1149,703
4608000,2447000,2031,573169,43435,529734,123279,43478,70478,94244,3328922,124902,3204020,1064931,160618,338316,507702
4608000,2451000,1,0,0,0,0,0,0,0,0,0,0,0,0,0,0
4608000,2458000,8,303,2,301,125,1,36,11,2724,8,2716,1353,9,246,107
4608000,2459000,25,1096,22,1074,635,17,23,136,9077,74,9003,5809,95,106,825
4608000,2460000,5,145,0,145,78,0,4,27,997,0,997,593,0,14,176
4608000,2462000,3,0,0,0,0,0,0,0,0,0,0,0,0,0,0
4608000,2463000,30,2200,130,2070,661,96,363,185,12660,282,12378,6000,221,1274,1061
4608000,2464000,14,0,0,0,0,0,0,0,0,0,0,0,0,0,0
4608000,2465000,2,0,0,0,0,0,0,0,0,0,0,0,0,0,0
4608000,2466000,8,0,0,0,0,0,0,0,0,0,0,0,0,0,0
4608000,2467000,13,544,11,533,330,12,15,56,4903,62,4841,3228,53,91,426
4608000,2468000,18,806,8,798,454,14,59,84,6958,41,6917,4605,86,392,589
4608000,2469000,14,419,13,406,224,13,71,7,4259,61,4198,2391,61,474,41
4608000,2480000,9,526,8,518,175,10,0,80,4353,23,4330,1784,27,0,514
4608000,2483000,1,0,0,0,0,0,0,0,0,0,0,0,0,0,0
4608000,2487000,19,794,20,774,511,20,40,53,6856,68,6788,5120,52,113,393
4609000,2446000,3,145,3,142,87,0,0,16,1251,21,1230,824,0,0,112
4609000,2447000,2,0,0,0,0,0,0,0,0,0,0,0,0,0,0
4609000,2457000,11,0,0,0,0,0,0,0,0,0,0,0,0,0,0
4609000,2459000,36,0,0,0,0,0,0,0,0,0,0,0,0,0,0
4609000,2462000,2,0,0,0,0,0,0,0,0,0,0,0,0,0,0
4609000,2463000,25,1802,68,1734,664,154,226,153,11130,192,10938,5946,462,772,825
4609000,2464000,2,0,0,0,0,0,0,0,0,0,0,0,0,0,0
4609000,2465000,6,399,62,337,214,33,27,7,2990,195,2795,2031,123,169,43
4609000,2466000,4,0,0,0,0,0,0,0,0,0,0,0,0,0,0
4609000,2467000,4,205,11,194,96,5,15,24,1510,51,1459,893,18,99,92
4609000,2468000,5,204,2,202,150,0,9,8,2081,12,2069,1608,0,108,56
4609000,2471000,1,0,0,0,0,0,0,0,0,0,0,0,0,0,0
4609000,2472000,15,0,0,0,0,0,0,0,0,0,0,0,0,0,0
4609000,2473000,9,0,0,0,0,0,0,0,0,0,0,0,0,0,0
4609000,2484000,7,0,0,0,0,0,0,0,0,0,0,0,0,0,0
4609000,2485000,3,158,9,149,34,8,10,24,1149,24,1125,382,54,88,129
4610000,2446000,5,0,0,0,0,0,0,0,0,0,0,0,0,0,0
4610000,2447000,3,346,21,325,68,13,49,19,1353,40,1313,417,37,187,71
4610000,2459000,13,0,0,0,0,0,0,0,0,0,0,0,0,0,0
4610000,2461000,19,1055,38,1017,435,32,94,122,8144,103,8041,4223,108,420,840
4610000,2462000,25,1202,56,1146,585,23,150,116,9638,207,9431,5830,141,682,744
4610000,2463000,1,0,0,0,0,0,0,0,0,0,0,0,0,0,0
4610000,2467000,3,0,0,0,0,0,0,0,0,0,0,0,0,0,0
4610000,2468000,3,0,0,0,0,0,0,0,0,0,0,0,0,0,0
4610000,2471000,10,451,23,428,244,26,30,63,3244,81,3163,2210,50,118,429
4610000,2472000,82,0,0,0,0,0,0,0,0,0,0,0,0,0,0
4610000,2473000,11,0,0,0,0,0,0,0,0,0,0,0,0,0,0
4610000,2475000,1,0,0,0,0,0,0,0,0,0,0,0,0,0,0
4610000,2478000,1,0,0,0,0,0,0,0,0,0,0,0,0,0,0
4610000,2479000,2,0,0,0,0,0,0,0,0,0,0,0,0,0,0
4610000,2481000,9,881,28,853,207,15,113,168,4343,82,4261,1848,17,232,587
4610000,2484000,2,0,0,0,0,0,0,0,0,0,0,0,0,0,0
4610000,2486000,2,0,0,0,0,0,0,0,0,0,0,0,0,0,0
4610000,2488000,3,0,0,0,0,0,0,0,0,0,0,0,0,0,0
4611000,2444000,1,0,0,0,0,0,0,0,0,0,0,0,0,0,0
4611000,2445000,1,0,0,0,0,0,0,0,0,0,0,0,0,0,0
4611000,2446000,1,0,0,0,0,0,0,0,0,0,0,0,0,0,0
4611000,2456000,1,0,0,0,0,0,0,0,0,0,0,0,0,0,0
4611000,2457000,2,0,0,0,0,0,0,0,0,0,0,0,0,0,0
4611000,2461000,1,0,0,0,0,0,0,0,0,0,0,0,0,0,0
4611000,2462000,8,380,5,375,162,13,43,36,3229,17,3212,1667,73,250,230
4611000,2465000,4,0,0,0,0,0,0,0,0,0,0,0,0,0,0
4611000,2469000,4,0,0,0,0,0,0,0,0,0,0,0,0,0,0
4611000,2471000,1,0,0,0,0,0,0,0,0,0,0,0,0,0,0
4611000,2472000,4,0,0,0,0,0,0,0,0,0,0,0,0,0,0
4611000,2473000,6,0,0,0,0,0,0,0,0,0,0,0,0,0,0
4611000,2480000,4,0,0,0,0,0,0,0,0,0,0,0,0,0,0
4611000,2487000,18,1052,66,986,370,53,65,166,6298,219,6079,3148,108,191,837
4611000,2488000,3,100,0,100,78,0,0,0,935,0,935,737,0,0,0
4612000,2443000,2,0,0,0,0,0,0,0,0,0,0,0,0,0,0
4612000,2444000,2,0,0,0,0,0,0,0,0,0,0,0,0,0,0
4612000,2445000,1,0,0,0,0,0,0,0,0,0,0,0,0,0,0
4612000,2446000,3,216,0,216,127,0,0,36,1766,0,1766,1123,0,0,254
4612000,2451000,1,0,0,0,0,0,0,0,0,0,0,0,0,0,0
4612000,2454000,1,0,0,0,0,0,0,0,0,0,0,0,0,0,0
4612000,2455000,5,0,0,0,0,0,0,0,0,0,0,0,0,0,0
4612000,2456000,15,0,0,0,0,0,0,0,0,0,0,0,0,0,0
4612000,2458000,1,0,0,0,0,0,0,0,0,0,0,0,0,0,0
4612000,2460000,4,0,0,0,0,0,0,0,0,0,0,0,0,0,0
4612000,2462000,5,0,0,0,0,0,0,0,0,0,0,0,0,0,0
4612000,2464000,2,0,0,0,0,0,0,0,0,0,0,0,0,0,0
4612000,2465000,3,0,0,0,0,0,0,0,0,0,0,0,0,0,0
4612000,2467000,7,511,16,495,239,15,33,17,3820,21,3799,2427,42,116,103
4612000,2468000,3,0,0,0,0,0,0,0,0,0,0,0,0,0,0
4612000,2469000,11,528,4,524,248,0,36,56,4669,4,4665,2352,0,221,431
4612000,2471000,5,0,0,0,0,0,0,0,0,0,0,0,0,0,0
4612000,2474000,8,0,0,0,0,0,0,0,0,0,0,0,0,0,0
4612000,2476000,1,0,0,0,0,0,0,0,0,0,0,0,0,0,0
4612000,2481000,25,2292,309,1983,324,228,295,354,9244,1340,7904,1991,656,713,1133
4612000,2483000,1,0,0,0,0,0,0,0,0,0,0,0,0,0,0
4613000,2443000,1,0,0,0,0,0,0,0,0,0,0,0,0,0,0
4613000,2444000,1,0,0,0,0,0,0,0,0,0,0,0,0,0,0
4613000,2445000,2,0,0,0,0,0,0,0,0,0,0,0,0,0,0
4613000,2446000,2,0,0,0,0,0,0,0,0,0,0,0,0,0,0
4613000,2450000,10,1562,54,1508,305,26,199,230,8826,201,8625,2439,106,984,1118
4613000,2451000,86,5137,260,4877,1571,114,918,476,32294,1055,31239,13607,373,4123,3162
4613000,2458000,2,0,0,0,0,0,0,0,0,0,0,0,0,0,0
4613000,2459000,4,0,0,0,0,0,0,0,0,0,0,0,0,0,0
4613000,2460000,4,0,0,0,0,0,0,0,0,0,0,0,0,0,0
4613000,2462000,4,306,28,278,57,26,70,35,1375,41,1334,527,101,157,171
4613000,2468000,33,1060,66,994,224,82,49,183,6834,175,6659,1882,137,249,870
4613000,2469000,23,1711,154,1557,501,63,87,186,10171,432,9739,4569,204,262,1155
4613000,2470000,9,0,0,0,0,0,0,0,0,0,0,0,0,0,0
4613000,2472000,1,0,0,0,0,0,0,0,0,0,0,0,0,0,0
4613000,2473000,2,0,0,0,0,0,0,0,0,0,0,0,0,0,0
4613000,2474000,7,0,0,0,0,0,0,0,0,0,0,0,0,0,0
4613000,2475000,1,0,0,0,0,0,0,0,0,0,0,0,0,0,0
4613000,2476000,8,527,14,513,163,1,0,68,4158,50,4108,1416,7,0,410
4613000,2481000,3,79,2,77,14,0,0,2,698,4,694,151,0,0,12
4613000,2482000,1,0,0,0,0,0,0,0,0,0,0,0,0,0,0
4613000,2485000,4,213,23,190,31,15,36,27,796,33,763,279,29,73,83
4614000,2443000,1,0,0,0,0,0,0,0,0,0,0,0,0,0,0
4614000,2445000,2,0,0,0,0,0,0,0,0,0,0,0,0,0,0
4614000,2450000,10,555,41,514,166,10,116,44,3686,220,3466,1581,27,550,244
4614000,2451000,7,305,8,297,136,7,49,27,2271,26,2245,1223,26,317,200
4614000,2456000,1,0,0,0,0,0,0,0,0,0,0,0,0,0,0
4614000,2460000,2,0,0,0,0,0,0,0,0,0,0,0,0,0,0
4614000,2461000,4,0,0,0,0,0,0,0,0,0,0,0,0,0,0
4614000,2463000,7,297,9,288,191,0,4,18,2939,35,2904,1909,0,28,187
4614000,2465000,1,0,0,0,0,0,0,0,0,0,0,0,0,0,0
4614000,2470000,2,0,0,0,0,0,0,0,0,0,0,0,0,0,0
4614000,2471000,2,0,0,0,0,0,0,0,0,0,0,0,0,0,0
4614000,2473000,2,0,0,0,0,0,0,0,0,0,0,0,0,0,0
4614000,2474000,1,0,0,0,0,0,0,0,0,0,0,0,0,0,0
4614000,2475000,1,0,0,0,0,0,0,0,0,0,0,0,0,0,0
4614000,2476000,5,0,0,0,0,0,0,0,0,0,0,0,0,0,0
4614000,2477000,1,0,0,0,0,0,0,0,0,0,0,0,0,0,0
4614000,2478000,1,0,0,0,0,0,0,0,0,0,0,0,0,0,0
4614000,2482000,1,0,0,0,0,0,0,0,0,0,0,0,0,0,0
4615000,2451000,1,0,0,0,0,0,0,0,0,0,0,0,0,0,0
4615000,2452000,4,0,0,0,0,0,0,0,0,0,0,0,0,0,0
4615000,2455000,5,187,12,175,109,7,3,9,1739,84,1655,1089,79,12,61
4615000,2456000,4,0,0,0,0,0,0,0,0,0,0,0,0,0,0
4615000,2457000,9,0,0,0,0,0,0,0,0,0,0,0,0,0,0
4615000,2458000,16,549,46,503,120,24,19,87,3622,67,3555,1099,69,261,442
4615000,2459000,6,286,2,284,175,4,17,29,2518,6,2512,1808,20,100,184
4615000,2465000,1,0,0,0,0,0,0,0,0,0,0,0,0,0,0
4615000,2466000,2,0,0,0,0,0,0,0,0,0,0,0,0,0,0
4615000,2467000,3,0,0,0,0,0,0,0,0,0,0,0,0,0,0
4615000,2468000,1,0,0,0,0,0,0,0,0,0,0,0,0,0,0
4615000,2470000,1,0,0,0,0,0,0,0,0,0,0,0,0,0,0
4615000,2471000,1,0,0,0,0,0,0,0,0,0,0,0,0,0,0
4615000,2472000,7,0,0,0,0,0,0,0,0,0,0,0,0,0,0
4615000,2473000,1,0,0,0,0,0,0,0,0,0,0,0,0,0,0
4615000,2474000,5,0,0,0,0,0,0,0,0,0,0,0,0,0,0
4615000,2475000,3,0,0,0,0,0,0,0,0,0,0,0,0,0,0
4615000,2476000,10,0,0,0,0,0,0,0,0,0,0,0,0,0,0
4615000,2479000,3,0,0,0,0,0,0,0,0,0,0,0,0,0,0
4615000,2482000,1,0,0,0,0,0,0,0,0,0,0,0,0,0,0
4615000,2483000,1,0,0,0,0,0,0,0,0,0,0,0,0,0,0
4615000,2485000,2,0,0,0,0,0,0,0,0,0,0,0,0,0,0
4616000,2438000,5,272,6,266,38,119,46,17,1711,46,1665,254,777,281,112
4616000,2450000,1,0,0,0,0,0,0,0,0,0,0,0,0,0,0
4616000,2451000,19,0,0,0,0,0,0,0,0,0,0,0,0,0,0
4616000,2452000,15,0,0,0,0,0,0,0,0,0,0,0,0,0,0
4616000,2455000,2,0,0,0,0,0,0,0,0,0,0,0,0,0,0
4616000,2456000,4,148,0,148,116,0,4,9,1645,0,1645,1264,0,28,161
4616000,2459000,2,0,0,0,0,0,0,0,0,0,0,0,0,0,0
4616000,2460000,32,1109,24,1085,345,6,35,175,8750,75,8675,2976,18,225,1102
4616000,2461000,22,975,29,946,582,6,13,180,8172,149,8023,5395,32,50,1208
4616000,2462000,10,361,8,353,225,0,5,56,3583,43,3540,2371,0,39,441
4616000,2463000,1,0,0,0,0,0,0,0,0,0,0,0,0,0,0
4616000,2465000,6,0,0,0,0,0,0,0,0,0,0,0,0,0,0
4616000,2466000,1,0,0,0,0,0,0,0,0,0,0,0,0,0,0
4616000,2469000,4,0,0,0,0,0,0,0,0,0,0,0,0,0,0
4616000,2471000,4,0,0,0,0,0,0,0,0,0,0,0,0,0,0
4616000,2476000,12,0,0,0,0,0,0,0,0,0,0,0,0,0,0
4616000,2481000,1,0,0,0,0,0,0,0,0,0,0,0,0,0,0
4616000,2483000,6,226,4,222,111,0,0,72,1741,28,1713,928,0,0,482
4617000,2438000,34,1579,30,1549,900,44,74,178,14108,168,13940,9307,238,520,1357
4617000,2439000,22,1534,63,1471,495,106,175,143,11277,326,10951,4851,451,1033,911
4617000,2451000,21,1192,34,1158,598,19,108,91,9262,196,9066,5436,32,580,528
4617000,2452000,1,0,0,0,0,0,0,0,0,0,0,0,0,0,0
4617000,2454000,1,0,0,0,0,0,0,0,0,0,0,0,0,0,0
4617000,2456000,2,0,0,0,0,0,0,0,0,0,0,0,0,0,0
4617000,2457000,9,408,0,408,206,0,3,45,3487,0,3487,1777,0,57,277
4617000,2458000,1,0,0,0,0,0,0,0,0,0,0,0,0,0,0
4617000,2459000,7,0,0,0,0,0,0,0,0,0,0,0,0,0,0
4617000,2460000,18,0,0,0,0,0,0,0,0,0,0,0,0,0,0
4617000,2462000,9,0,0,0,0,0,0,0,0,0,0,0,0,0,0
4617000,2463000,1,0,0,0,0,0,0,0,0,0,0,0,0,0,0
4617000,2464000,5,0,0,0,0,0,0,0,0,0,0,0,0,0,0
4617000,2465000,2,0,0,0,0,0,0,0,0,0,0,0,0,0,0
4617000,2466000,7,0,0,0,0,0,0,0,0,0,0,0,0,0,0
4617000,2468000,13,758,8,750,460,19,27,105,6937,41,6896,4424,75,178,848
4617000,2469000,3,0,0,0,0,0,0,0,0,0,0,0,0,0,0
4617000,2470000,7,387,6,381,204,2,15,66,2661,12,2649,1356,26,97,525
4617000,2471000,1,0,0,0,0,0,0,0,0,0,0,0,0,0,0
4617000,2472000,2,0,0,0,0,0,0,0,0,0,0,0,0,0,0
4617000,2473000,3,0,0,0,0,0,0,0,0,0,0,0,0,0,0
4617000,2483000,3,41,5,36,19,2,0,0,347,37,310,223,8,0,0
4618000,2436000,1,0,0,0,0,0,0,0,0,0,0,0,0,0,0
4618000,2437000,2,0,0,0,0,0,0,0,0,0,0,0,0,0,0
4618000,2438000,2,0,0,0,0,0,0,0,0,0,0,0,0,0,0
4618000,2439000,2,0,0,0,0,0,0,0,0,0,0,0,0,0,0
4618000,2448000,10,904,74,830,283,21,175,53,4988,153,4835,2372,31,460,330
4618000,2453000,7,261,7,254,156,0,14,44,2430,47,2383,1634,0,68,295
4618000,2456000,1,0,0,0,0,0,0,0,0,0,0,0,0,0,0
4618000,2457000,1,0,0,0,0,0,0,0,0,0,0,0,0,0,0
4618000,2458000,8,413,3,410,200,0,29,79,3463,8,3455,2012,0,196,648
4618000,2459000,5,0,0,0,0,0,0,0,0,0,0,0,0,0,0
4618000,2460000,3,0,0,0,0,0,0,0,0,0,0,0,0,0,0
4618000,2467000,2,0,0,0,0,0,0,0,0,0,0,0,0,0,0
4618000,2468000,2,0,0,0,0,0,0,0,0,0,0,0,0,0,0
4618000,2471000,6,0,0,0,0,0,0,0,0,0,0,0,0,0,0
4618000,2474000,3,144,1,143,44,0,1,6,1132,10,1122,448,0,14,42
4618000,2475000,3,140,16,124,65,1,6,8,922,54,868,653,1,12,16
4618000,2476000,8,251,0,251,120,2,10,9,2137,0,2137,1211,6,40,39
4618000,2481000,2,0,0,0,0,0,0,0,0,0,0,0,0,0,0
4618000,2485000,1,0,0,0,0,0,0,0,0,0,0,0,0,0,0
4619000,2434000,2,0,0,0,0,0,0,0,0,0,0,0,0,0,0
4619000,2443000,9,500,30,470,108,28,168,62,2804,93,2711,987,115,710,356
4619000,2444000,87,46239,1804,44435,12181,11525,7406,5626,287683,5716,281967,104357,69025,37267,33734
4619000,2451000,18,945,188,757,235,37,61,60,4873,417,4456,1950,65,237,346
4619000,2453000,2,0,0,0,0,0,0,0,0,0,0,0,0,0,0
4619000,2455000,1,0,0,0,0,0,0,0,0,0,0,0,0,0,0
4619000,2456000,1,0,0,0,0,0,0,0,0,0,0,0,0,0,0
4619000,2458000,5,0,0,0,0,0,0,0,0,0,0,0,0,0,0
4619000,2459000,3,210,0,210,104,0,0,21,1889,0,1889,864,0,0,139
4619000,2460000,3,152,3,149,96,3,5,18,1286,9,1277,868,21,54,121
4619000,2461000,3,172,0,172,114,0,0,6,1547,0,1547,1101,0,0,42
4619000,2462000,2,0,0,0,0,0,0,0,0,0,0,0,0,0,0
4619000,2463000,11,680,10,670,422,7,1,55,6744,55,6689,4481,29,21,493
4619000,2464000,5,253,4,249,148,4,0,24,2419,28,2391,1414,28,0,211
4619000,2465000,1,0,0,0,0,0,0,0,0,0,0,0,0,0,0
4619000,2466000,1,0,0,0,0,0,0,0,0,0,0,0,0,0,0
4619000,2473000,7,281,8,273,179,0,7,21,2670,46,2624,1890,0,49,155
4619000,2474000,2,0,0,0,0,0,0,0,0,0,0,0,0,0,0
4619000,2475000,4,141,7,134,36,4,4,14,915,19,896,287,12,13,113
4619000,2476000,11,1032,167,865,197,79,108,50,5007,324,4683,1473,131,162,282
4619000,2479000,6,0,0,0,0,0,0,0,0,0,0,0,0,0,0
4619000,2483000,1,0,0,0,0,0,0,0,0,0,0,0,0,0,0
4620000,2433000,21,993,18,975,488,40,93,60,8162,84,8078,4749,216,723,410
4620000,2434000,37,1716,21,1695,797,80,73,164,15201,110,15091,8140,689,587,1048
4620000,2435000,1,0,0,0,0,0,0,0,0,0,0,0,0,0,0
4620000,2438000,2,0,0,0,0,0,0,0,0,0,0,0,0,0,0
4620000,2451000,3,0,0,0,0,0,0,0,0,0,0,0,0,0,0
4620000,2453000,1,0,0,0,0,0,0,0,0,0,0,0,0,0,0
4620000,2454000,1,0,0,0,0,0,0,0,0,0,0,0,0,0,0
4620000,2457000,8,563,3,560,339,4,0,74,5193,21,5172,3424,56,0,542
4620000,2458000,12,466,13,453,185,2,4,42,3974,52,3922,1744,4,12,336
4620000,2460000,5,218,0,218,110,0,0,0,1745,0,1745,895,0,0,0
4620000,2462000,6,368,0,368,280,0,0,18,3640,0,3640,2942,0,0,215
4620000,2463000,2,0,0,0,0,0,0,0,0,0,0,0,0,0,0
4620000,2464000,3,112,3,109,44,0,0,8,1024,6,1018,349,0,0,112
4620000,2466000,7,518,45,473,212,1,35,62,3975,85,3890,2323,2,124,462
4620000,2473000,6,341,6,335,169,0,0,40,3125,62,3063,1613,0,0,295
4620000,2475000,1,0,0,0,0,0,0,0,0,0,0,0,0,0,0
4620000,2476000,2,0,0,0,0,0,0,0,0,0,0,0,0,0,0
4620000,2480000,1,0,0,0,0,0,0,0,0,0,0,0,0,0,0
4620000,2481000,1,0,0,0,0,0,0,0,0,0,0,0,0,0,0
4620000,2482000,8,610,71,539,138,58,14,95,2765,119,2646,1141,87,18,242
4621000,2431000,362,49299,3018,46281,10467,12319,4513,3484,317014,17306,299708,86777,76872,23669,20448
4621000,2433000,24,952,13,939,438,65,43,76,8419,123,8296,4708,456,316,572
4621000,2434000,143,15606,1534,14072,2290,5680,622,538,91374,6377,84997,21338,37223,2522,3314
4621000,2435000,1,0,0,0,0,0,0,0,0,0,0,0,0,0,0
4621000,2440000,2,0,0,0,0,0,0,0,0,0,0,0,0,0,0
4621000,2448000,3,0,0,0,0,0,0,0,0,0,0,0,0,0,0
4621000,2449000,2,0,0,0,0,0,0,0,0,0,0,0,0,0,0
4621000,2455000,4,0,0,0,0,0,0,0,0,0,0,0,0,0,0
4621000,2456000,4,302,23,279,152,2,6,20,2326,113,2213,1354,8,28,172
4621000,2460000,8,380,6,374,212,7,11,20,3613,12,3601,2132,49,33,178
4621000,2463000,4,291,0,291,160,0,0,81,2766,0,2766,1650,0,0,681
4621000,2466000,1,0,0,0,0,0,0,0,0,0,0,0,0,0,0
4621000,2472000,3,0,0,0,0,0,0,0,0,0,0,0,0,0,0
4621000,2474000,3,124,8,116,66,0,0,12,1129,24,1105,623,0,0,119
4621000,2476000,22,4421,291,4130,1117,213,341,394,10060,566,9494,2877,408,506,852
4621000,2477000,27,0,0,0,0,0,0,0,0,0,0,0,0,0,0
4621000,2479000,11,0,0,0,0,0,0,0,0,0,0,0,0,0,0
4621000,2480000,4,87,0,87,51,0,0,13,883,0,883,531,0,0,103
4621000,2482000,1,0,0,0,0,0,0,0,0,0,0,0,0,0,0
4622000,2427000,18,1415,131,1284,298,36,179,246,9006,553,8453,2386,240,1084,1741
4622000,2430000,346,84711,4249,80462,27241,6988,9957,4325,675238,25161,650077,245223,30967,68827,30827
4622000,2448000,13,581,2,579,439,2,5,68,5728,20,5708,4674,8,33,507
4622000,2449000,4,69,1,68,21,0,19,3,439,7,432,195,0,137,12
4622000,2454000,3,330,14,316,170,0,0,55,2838,98,2740,1475,0,0,461
4622000,2455000,2,0,0,0,0,0,0,0,0,0,0,0,0,0,0
4622000,2458000,3,0,0,0,0,0,0,0,0,0,0,0,0,0,0
4622000,2459000,12,676,7,669,278,0,6,50,6612,11,6601,2838,0,21,532
4622000,2460000,8,347,9,338,157,0,12,27,3239,76,3163,1755,0,56,206
4622000,2463000,3,453,46,407,207,0,16,57,3668,117,3551,2079,0,48,385
4622000,2464000,4,192,42,150,69,5,19,6,1083,94,989,710,12,74,15
4622000,2465000,3,83,9,74,46,0,1,6,838,36,802,587,0,7,46
4622000,2468000,1,0,0,0,0,0,0,0,0,0,0,0,0,0,0
4622000,2470000,1,0,0,0,0,0,0,0,0,0,0,0,0,0,0
4622000,2471000,1,0,0,0,0,0,0,0,0,0,0,0,0,0,0
4622000,2472000,1,0,0,0,0,0,0,0,0,0,0,0,0,0,0
4622000,2473000,4,225,0,225,137,0,0,6,2408,0,2408,1438,0,0,42
4622000,2479000,2,0,0,0,0,0,0,0,0,0,0,0,0,0,0
4622000,2481000,2,0,0,0,0,0,0,0,0,0,0,0,0,0,0
4623000,2424000,2,0,0,0,0,0,0,0,0,0,0,0,0,0,0
4623000,2427000,14,625,12,613,191,14,62,41,5118,51,5067,1781,90,626,285
4623000,2428000,31,1651,56,1595,489,121,121,143,12230,337,11893,4453,843,766,927
4623000,2439000,2,0,0,0,0,0,0,0,0,0,0,0,0,0,0
4623000,2440000,27,1967,59,1908,1154,18,43,336,17413,180,17233,11599,31,336,2393
4623000,2449000,4,273,2,271,197,0,0,33,2517,5,2512,1956,0,0,222
4623000,2450000,8,0,0,0,0,0,0,0,0,0,0,0,0,0,0
4623000,2451000,2,0,0,0,0,0,0,0,0,0,0,0,0,0,0
4623000,2452000,9,435,0,435,224,10,12,14,3688,0,3688,2256,29,66,94
4623000,2453000,20,971,52,919,419,37,87,48,7227,179,7048,4387,286,439,375
4623000,2455000,1,0,0,0,0,0,0,0,0,0,0,0,0,0,0
4623000,2458000,1,0,0,0,0,0,0,0,0,0,0,0,0,0,0
4623000,2463000,1,0,0,0,0,0,0,0,0,0,0,0,0,0,0
4623000,2465000,1,0,0,0,0,0,0,0,0,0,0,0,0,0,0
4623000,2466000,1,0,0,0,0,0,0,0,0,0,0,0,0,0,0
4623000,2468000,4,153,16,137,50,0,8,3,1281,72,1209,532,0,56,21
4623000,2469000,1,0,0,0,0,0,0,0,0,0,0,0,0,0,0
4623000,2470000,6,256,9,247,161,0,1,17,2700,59,2641,1688,0,11,195
4623000,2474000,1,0,0,0,0,0,0,0,0,0,0,0,0,0,0
4623000,2476000,1,0,0,0,0,0,0,0,0,0,0,0,0,0,0
4623000,2477000,1,0,0,0,0,0,0,0,0,0,0,0,0,0,0
4623000,2481000,1,0,0,0,0,0,0,0,0,0,0,0,0,0,0
4624000,2423000,11,217,0,217,43,0,40,0,1526,0,1526,347,0,275,0
4624000,2424000,6,227,6,221,23,5,34,6,960,55,905,111,22,142,22
4624000,2425000,1,0,0,0,0,0,0,0,0,0,0,0,0,0,0
4624000,2427000,9,723,14,709,139,48,95,53,4167,21,4146,1052,133,476,378
4624000,2428000,31,1817,66,1751,390,47,303,59,11220,226,10994,3655,148,1671,372
4624000,2429000,5,291,20,271,91,16,28,23,2052,81,1971,725,50,167,161
4624000,2449000,17,818,66,752,351,28,12,67,6579,150,6429,3512,95,63,451
4624000,2450000,2,0,0,0,0,0,0,0,0,0,0,0,0,0,0
4624000,2452000,4,0,0,0,0,0,0,0,0,0,0,0,0,0,0
4624000,2455000,3,0,0,0,0,0,0,0,0,0,0,0,0,0,0
4624000,2456000,3,171,18,153,77,0,8,5,1045,43,1002,707,0,23,23
4624000,2457000,2,0,0,0,0,0,0,0,0,0,0,0,0,0,0
4624000,2459000,6,321,16,305,175,0,4,7,3086,91,2995,1745,0,28,98
4624000,2460000,26,1161,46,1115,725,16,17,119,11230,344,10886,7872,71,86,810
4624000,2464000,6,341,1,340,230,0,11,26,3319,14,3305,2311,0,61,275
4624000,2467000,1,0,0,0,0,0,0,0,0,0,0,0,0,0,0
4624000,2468000,2,0,0,0,0,0,0,0,0,0,0,0,0,0,0
4624000,2469000,6,908,149,759,280,32,43,48,3748,277,3471,1680,46,98,127
4624000,2474000,3,0,0,0,0,0,0,0,0,0,0,0,0,0,0
4624000,2479000,3,0,0,0,0,0,0,0,0,0,0,0,0,0,0
4624000,2483000,1,0,0,0,0,0,0,0,0,0,0,0,0,0,0
4624000,2484000,4,0,0,0,0,0,0,0,0,0,0,0,0,0,0
4625000,2420000,7,0,0,0,0,0,0,0,0,0,0,0,0,0,0
4625000,2421000,204,17591,628,16963,4475,923,1567,1443,112356,1984,110372,37453,5460,8642,8073
4625000,2422000,1,0,0,0,0,0,0,0,0,0,0,0,0,0,0
4625000,2423000,42,2376,98,2278,474,112,331,165,13552,452,13100,3631,417,1945,905
4625000,2424000,5,209,1,208,8,0,13,18,982,2,980,56,0,102,48
4625000,2425000,2123,363885,36821,327064,61903,21398,38607,24935,1764373,94144,1670229,415031,92874,177880,119016
4625000,2426000,8,307,28,279,35,6,30,29,1539,107,1432,180,16,153,212
4625000,2427000,3,83,2,81,32,5,11,0,593,14,579,290,25,64,0
4625000,2428000,16,1319,49,1270,205,34,205,29,6436,229,6207,1602,126,997,136
4625000,2429000,6,174,8,166,72,0,0,16,1465,34,1431,742,0,0,117
4625000,2430000,104,5020,229,4791,1847,149,565,374,38028,815,37213,17864,670,3664,2699
4625000,2435000,162,7949,371,7578,2749,1198,522,656,63852,2185,61667,26883,7787,3785,4574
4625000,2442000,12,802,4,798,573,1,0,136,7918,12,7906,6129,3,0,1081
4625000,2443000,4,0,0,0,0,0,0,0,0,0,0,0,0,0,0
4625000,2447000,5,253,10,243,136,0,0,26,2354,44,2310,1346,0,0,210
4625000,2449000,3,151,1,150,119,0,0,1,1316,5,1311,1064,0,0,7
4625000,2450000,1,0,0,0,0,0,0,0,0,0,0,0,0,0,0
4625000,2451000,2,0,0,0,0,0,0,0,0,0,0,0,0,0,0
4625000,2452000,4,310,4,306,182,3,0,12,2790,16,2774,1751,14,0,80
4625000,2453000,6,283,0,283,205,0,6,10,3035,0,3035,2284,0,42,91
4625000,2454000,7,382,16,366,171,3,25,45,3287,58,3229,1849,13,97,353
4625000,2455000,6,367,13,354,163,25,18,23,2891,39,2852,1535,114,153,167
4625000,2456000,2,0,0,0,0,0,0,0,0,0,0,0,0,0,0
4625000,2460000,10,563,11,552,291,13,0,65,5768,45,5723,3114,54,0,675
4625000,2461000,2,0,0,0,0,0,0,0,0,0,0,0,0,0,0
4625000,2463000,2,0,0,0,0,0,0,0,0,0,0,0,0,0,0
4625000,2467000,1,0,0,0,0,0,0,0,0,0,0,0,0,0,0
4625000,2468000,1,0,0,0,0,0,0,0,0,0,0,0,0,0,0
4625000,2469000,1,0,0,0,0,0,0,0,0,0,0,0,0,0,0
4625000,2476000,2,0,0,0,0,0,0,0,0,0,0,0,0,0,0
4625000,2479000,2,0,0,0,0,0,0,0,0,0,0,0,0,0,0
4626000,2419000,6,376,2,374,139,52,33,23,3057,14,3043,1267,372,282,173
4626000,2420000,146,24775,2464,22311,6945,4733,1565,2190,169026,9093,159933,57972,35195,9726,13542
4626000,2421000,42,2818,63,2755,1012,131,308,274,19102,127,18975,9130,470,1607,1572
4626000,2422000,10,0,0,0,0,0,0,0,0,0,0,0,0,0,0
4626000,2423000,26,1206,29,1177,410,31,119,80,9021,64,8957,3933,91,686,546
4626000,2424000,6,341,11,330,120,7,27,16,2566,316,2250,1181,7,187,112
4626000,2425000,3,62,4,58,9,4,8,2,228,14,214,56,10,42,4
4626000,2426000,3,106,0,106,24,0,14,4,684,0,684,180,0,54,28
4626000,2429000,1,0,0,0,0,0,0,0,0,0,0,0,0,0,0
4626000,2432000,5,196,4,192,92,2,8,10,1736,9,1727,838,4,40,70
4626000,2439000,2,0,0,0,0,0,0,0,0,0,0,0,0,0,0
4626000,2441000,4,0,0,0,0,0,0,0,0,0,0,0,0,0,0
4626000,2442000,6,288,1,287,214,0,0,3,3155,7,3148,2325,0,0,49
4626000,2443000,34,1101,11,1090,720,12,6,137,10263,31,10232,7209,60,56,1018
4626000,2444000,2,0,0,0,0,0,0,0,0,0,0,0,0,0,0
4626000,2446000,2,0,0,0,0,0,0,0,0,0,0,0,0,0,0
4626000,2447000,2,0,0,0,0,0,0,0,0,0,0,0,0,0,0
4626000,2449000,12,441,45,396,167,10,13,43,3407,139,3268,1687,24,41,364
4626000,2450000,2,0,0,0,0,0,0,0,0,0,0,0,0,0,0
4626000,2452000,3,0,0,0,0,0,0,0,0,0,0,0,0,0,0
4626000,2453000,3,0,0,0,0,0,0,0,0,0,0,0,0,0,0
4626000,2454000,1,0,0,0,0,0,0,0,0,0,0,0,0,0,0
4626000,2455000,3,135,0,135,83,0,0,13,1296,0,1296,889,0,0,126
4626000,2456000,1,0,0,0,0,0,0,0,0,0,0,0,0,0,0
4626000,2457000,2,0,0,0,0,0,0,0,0,0,0,0,0,0,0
4626000,2458000,2,0,0,0,0,0,0,0,0,0,0,0,0,0,0
4626000,2460000,1,0,0,0,0,0,0,0,0,0,0,0,0,0,0
4626000,2462000,1,0,0,0,0,0,0,0,0,0,0,0,0,0,0
4626000,2463000,2,0,0,0,0,0,0,0,0,0,0,0,0,0,0
4626000,2464000,1,0,0,0,0,0,0,0,0,0,0,0,0,0,0
4626000,2467000,1,0,0,0,0,0,0,0,0,0,0,0,0,0,0
4626000,2479000,2,0,0,0,0,0,0,0,0,0,0,0,0,0,0
4627000,2419000,18,1005,2,1003,539,2,109,124,9101,4,9097,5771,22,782,872
4627000,2420000,108,25517,337,25180,7035,545,2195,2634,175221,1273,173948,62993,2998,12448,15482
4627000,2421000,71,4313,66,4247,1407,71,530,393,33712,376,33336,13811,315,3267,2672
4627000,2422000,2,0,0,0,0,0,0,0,0,0,0,0,0,0,0
4627000,2423000,31,1121,43,1078,379,27,141,35,8398,272,8126,3449,179,872,281
4627000,2424000,19,764,35,729,201,24,136,58,5495,287,5208,1900,99,752,369
4627000,2425000,4,595,41,554,106,11,107,14,2565,152,2413,808,28,359,18
4627000,2427000,1,0,0,0,0,0,0,0,0,0,0,0,0,0,0
4627000,2439000,2,0,0,0,0,0,0,0,0,0,0,0,0,0,0
4627000,2440000,7,259,14,245,63,5,3,51,1765,59,1706,528,15,15,230
4627000,2441000,6,311,6,305,198,0,0,53,2910,42,2868,2039,0,0,362
4627000,2442000,18,1114,11,1103,684,37,16,119,10872,178,10694,7418,207,91,952
4627000,2443000,1,0,0,0,0,0,0,0,0,0,0,0,0,0,0
4627000,2445000,11,681,10,671,357,20,6,74,5975,19,5956,3606,73,20,513
4627000,2446000,1,0,0,0,0,0,0,0,0,0,0,0,0,0,0
4627000,2447000,6,0,0,0,0,0,0,0,0,0,0,0,0,0,0
4627000,2448000,1,0,0,0,0,0,0,0,0,0,0,0,0,0,0
4627000,2449000,6,189,2,187,91,0,0,0,1728,2,1726,738,0,0,0
4627000,2450000,1,0,0,0,0,0,0,0,0,0,0,0,0,0,0
4627000,2451000,2,0,0,0,0,0,0,0,0,0,0,0,0,0,0
4627000,2453000,4,242,0,242,208,0,0,16,2835,0,2835,2454,0,0,161
4627000,2454000,3,0,0,0,0,0,0,0,0,0,0,0,0,0,0
4627000,2456000,2,0,0,0,0,0,0,0,0,0,0,0,0,0,0
4627000,2457000,6,0,0,0,0,0,0,0,0,0,0,0,0,0,0
4627000,2459000,1,0,0,0,0,0,0,0,0,0,0,0,0,0,0
4627000,2460000,2,0,0,0,0,0,0,0,0,0,0,0,0,0,0
4627000,2462000,1,0,0,0,0,0,0,0,0,0,0,0,0,0,0
4627000,2463000,3,201,0,201,136,0,0,13,2016,0,2016,1378,0,0,91
4627000,2465000,1,0,0,0,0,0,0,0,0,0,0,0,0,0,0
4627000,2466000,9,361,50,311,123,6,14,17,2496,133,2363,1270,21,66,95
4627000,2467000,1,0,0,0,0,0,0,0,0,0,0,0,0,0,0
4627000,2468000,2,0,0,0,0,0,0,0,0,0,0,0,0,0,0
4627000,2469000,1,0,0,0,0,0,0,0,0,0,0,0,0,0,0
4627000,2482000,2,0,0,0,0,0,0,0,0,0,0,0,0,0,0
4628000,2419000,25,1566,17,1549,570,124,191,214,11768,37,11731,5625,849,1042,1335
4628000,2420000,24,1254,14,1240,508,13,131,220,9857,77,9780,4930,63,771,1606
4628000,2421000,2,0,0,0,0,0,0,0,0,0,0,0,0,0,0
4628000,2423000,2,0,0,0,0,0,0,0,0,0,0,0,0,0,0
4628000,2424000,13,590,16,574,179,11,75,34,3610,35,3575,1492,24,355,223
4628000,2425000,1,0,0,0,0,0,0,0,0,0,0,0,0,0,0
4628000,2428000,2,0,0,0,0,0,0,0,0,0,0,0,0,0,0
4628000,2442000,26,1323,0,1323,826,25,39,135,12674,0,12674,8328,140,267,1119
4628000,2445000,8,420,0,420,234,2,33,49,3713,0,3713,2344,14,209,399
4628000,2448000,18,778,32,746,451,0,26,43,7727,120,7607,5087,0,230,361
4628000,2453000,5,0,0,0,0,0,0,0,0,0,0,0,0,0,0
4628000,2455000,1,0,0,0,0,0,0,0,0,0,0,0,0,0,0
4628000,2456000,10,344,36,308,162,14,29,16,2876,183,2693,1588,89,83,134
4628000,2459000,3,125,7,118,72,3,0,10,1241,16,1225,869,15,0,64
4628000,2460000,5,379,0,379,225,0,11,52,3534,0,3534,2252,0,77,376
4628000,2461000,3,103,14,89,55,0,0,14,858,48,810,484,0,0,133
4628000,2463000,2,0,0,0,0,0,0,0,0,0,0,0,0,0,0
4628000,2464000,6,274,14,260,156,0,5,35,2294,80,2214,1420,0,37,246
4628000,2465000,3,628,160,468,54,4,84,51,2679,232,2447,188,4,215,202
4628000,2471000,1,0,0,0,0,0,0,0,0,0,0,0,0,0,0
4628000,2482000,7,0,0,0,0,0,0,0,0,0,0,0,0,0,0
4628000,2484000,4,0,0,0,0,0,0,0,0,0,0,0,0,0,0
4628000,2488000,1,0,0,0,0,0,0,0,0,0,0,0,0,0,0
4628000,2490000,1,0,0,0,0,0,0,0,0,0,0,0,0,0,0
4629000,2420000,82,11299,119,11180,3511,2871,928,1184,74544,509,74035,27692,18014,5522,7698
4629000,2423000,3,103,3,100,9,2,38,6,585,15,570,92,6,185,72
4629000,2424000,14,599,6,593,265,4,64,51,4888,28,4860,2634,4,433,329
4629000,2425000,4,89,6,83,36,0,4,18,862,80,782,370,0,20,174
4629000,2426000,3,125,6,119,58,0,8,11,917,12,905,552,0,56,42
4629000,2429000,1,0,0,0,0,0,0,0,0,0,0,0,0,0,0
4629000,2430000,45,2062,62,2000,1144,2,93,221,17781,224,17557,11282,10,649,1788
4629000,2431000,7,317,4,313,219,2,5,29,3015,28,2987,2266,14,19,197
4629000,2436000,1,0,0,0,0,0,0,0,0,0,0,0,0,0,0
4629000,2438000,1,0,0,0,0,0,0,0,0,0,0,0,0,0,0
4629000,2440000,2,0,0,0,0,0,0,0,0,0,0,0,0,0,0
4629000,2441000,4,167,7,160,123,0,0,15,1642,49,1593,1265,0,0,105
4629000,2444000,2,0,0,0,0,0,0,0,0,0,0,0,0,0,0
4629000,2445000,6,0,0,0,0,0,0,0,0,0,0,0,0,0,0
4629000,2447000,8,0,0,0,0,0,0,0,0,0,0,0,0,0,0
4629000,2450000,3,0,0,0,0,0,0,0,0,0,0,0,0,0,0
4629000,2452000,9,723,19,704,411,2,0,99,6766,125,6641,4183,16,11,779
4629000,2453000,2,0,0,0,0,0,0,0,0,0,0,0,0,0,0
4629000,2455000,1,0,0,0,0,0,0,0,0,0,0,0,0,0,0
4629000,2457000,1,0,0,0,0,0,0,0,0,0,0,0,0,0,0
4629000,2464000,3,109,1,108,67,0,0,0,1229,7,1222,774,0,0,0
4629000,2467000,1,0,0,0,0,0,0,0,0,0,0,0,0,0,0
4629000,2471000,1,0,0,0,0,0,0,0,0,0,0,0,0,0,0
4629000,2478000,2,0,0,0,0,0,0,0,0,0,0,0,0,0,0
4629000,2480000,2,0,0,0,0,0,0,0,0,0,0,0,0,0,0
4629000,2483000,1,0,0,0,0,0,0,0,0,0,0,0,0,0,0
4630000,2417000,18,800,6,794,101,56,146,266,4230,32,4198,764,170,602,1462
4630000,2418000,90,8705,129,8576,1721,750,2068,1407,55391,466,54925,15414,3405,10436,8285
4630000,2420000,1,0,0,0,0,0,0,0,0,0,0,0,0,0,0
4630000,2421000,4,171,9,162,57,19,13,40,1315,40,1275,481,146,92,287
4630000,2423000,4,148,0,148,74,6,19,22,1118,0,1118,620,36,81,155
4630000,2424000,8,191,9,182,67,3,16,10,1318,44,1274,610,15,77,70
4630000,2425000,9,368,1,367,204,1,20,41,3619,3,3616,2147,2,123,393
4630000,2430000,4,282,3,279,113,3,22,41,2364,30,2334,1261,6,164,244
4630000,2431000,3,178,0,178,114,1,2,19,1811,0,1811,1298,7,14,133
4630000,2440000,10,414,17,397,228,10,20,12,3998,89,3909,2554,87,150,58
4630000,2443000,1,0,0,0,0,0,0,0,0,0,0,0,0,0,0
4630000,2454000,3,0,0,0,0,0,0,0,0,0,0,0,0,0,0
4630000,2456000,8,621,2,619,443,0,11,13,6126,10,6116,4486,0,82,101
4630000,2459000,2,0,0,0,0,0,0,0,0,0,0,0,0,0,0
4630000,2461000,2,0,0,0,0,0,0,0,0,0,0,0,0,0,0
4630000,2462000,2,0,0,0,0,0,0,0,0,0,0,0,0,0,0
4630000,2466000,12,3779,2236,1543,171,111,401,78,9414,4370,5044,447,165,800,210
4630000,2471000,1,0,0,0,0,0,0,0,0,0,0,0,0,0,0
4630000,2482000,2,0,0,0,0,0,0,0,0,0,0,0,0,0,0
4630000,2485000,4,202,6,196,55,8,2,26,1691,12,1679,573,13,20,203
4630000,2487000,4,366,8,358,184,2,0,36,2893,16,2877,1553,2,0,351
4631000,2417000,17,0,0,0,0,0,0,0,0,0,0,0,0,0,0
4631000,2418000,314,82643,1087,81556,14323,22242,16068,11739,482088,5860,476228,103020,123221,82428,67451
4631000,2420000,54,2992,53,2939,741,86,379,330,21990,886,21104,7081,354,2388,1954
4631000,2421000,21,1265,9,1256,612,59,55,243,10599,32,10567,5633,359,377,1846
4631000,2422000,1,0,0,0,0,0,0,0,0,0,0,0,0,0,0
4631000,2423000,9,257,3,254,104,13,44,16,2104,27,2077,1207,46,249,153
4631000,2424000,3,85,0,85,16,16,9,11,681,0,681,101,144,60,75
4631000,2425000,11,625,9,616,278,3,39,52,4727,37,4690,2648,10,202,403
4631000,2429000,4,156,0,156,72,0,11,0,1371,0,1371,745,0,66,0
4631000,2432000,1,0,0,0,0,0,0,0,0,0,0,0,0,0,0
4631000,2433000,2,0,0,0,0,0,0,0,0,0,0,0,0,0,0
4631000,2436000,5,177,0,177,75,0,0,18,1638,0,1638,838,0,0,116
4631000,2438000,1,0,0,0,0,0,0,0,0,0,0,0,0,0,0
4631000,2439000,12,678,29,649,304,5,49,62,5347,77,5270,3258,34,201,394
4631000,2442000,4,191,0,191,127,0,0,14,2048,0,2048,1477,0,0,86
4631000,2443000,1,0,0,0,0,0,0,0,0,0,0,0,0,0,0
4631000,2447000,2,0,0,0,0,0,0,0,0,0,0,0,0,0,0
4631000,2451000,4,322,26,296,135,8,20,32,2003,38,1965,1156,14,79,259
4631000,2452000,4,205,15,190,73,2,14,16,1684,44,1640,823,4,48,128
4631000,2453000,1,0,0,0,0,0,0,0,0,0,0,0,0,0,0
4631000,2455000,1,0,0,0,0,0,0,0,0,0,0,0,0,0,0
4631000,2456000,5,0,0,0,0,0,0,0,0,0,0,0,0,0,0
4631000,2462000,3,170,7,163,83,4,0,13,1275,18,1257,861,8,0,74
4631000,2464000,2,0,0,0,0,0,0,0,0,0,0,0,0,0,0
4631000,2474000,2,0,0,0,0,0,0,0,0,0,0,0,0,0,0
4631000,2475000,1,0,0,0,0,0,0,0,0,0,0,0,0,0,0
4631000,2477000,1,0,0,0,0,0,0,0,0,0,0,0,0,0,0
4631000,2480000,1,0,0,0,0,0,0,0,0,0,0,0,0,0,0
4631000,2485000,17,7389,1749,5640,599,328,587,643,18155,3514,14641,1865,436,1047,1464
4632000,2419000,59,50331,906,49425,11694,5352,6582,8550,338709,4598,334111,93185,31734,38198,53189
4632000,2420000,532,75311,1946,73365,27163,4767,9502,11416,566781,9299,557482,251730,25484,61211,79310
4632000,2421000,16,821,13,808,416,51,79,70,7487,137,7350,4619,268,776,392
4632000,2422000,3,77,0,77,20,7,0,2,893,0,893,219,49,0,14
4632000,2423000,5,263,9,254,144,0,25,30,2231,31,2200,1396,0,174,214
4632000,2424000,82,5588,396,5192,2574,140,608,616,41269,769,40500,24740,538,3190,3917
4632000,2429000,6,282,5,277,67,1,12,61,2128,31,2097,679,3,82,438
4632000,2431000,15,753,10,743,400,12,58,51,6476,83,6393,4028,36,419,379
4632000,2432000,5,0,0,0,0,0,0,0,0,0,0,0,0,0,0
4632000,2434000,3,94,3,91,47,3,9,4,747,21,726,496,6,40,24
4632000,2435000,1,0,0,0,0,0,0,0,0,0,0,0,0,0,0
4632000,2436000,1,0,0,0,0,0,0,0,0,0,0,0,0,0,0
4632000,2438000,4,0,0,0,0,0,0,0,0,0,0,0,0,0,0
4632000,2442000,1,0,0,0,0,0,0,0,0,0,0,0,0,0,0
4632000,2443000,9,450,0,450,284,0,4,69,4467,0,4467,3111,0,48,490
4632000,2445000,5,228,0,228,93,0,7,53,1976,0,1976,951,0,56,353
4632000,2447000,16,1395,235,1160,656,70,15,173,10835,334,10501,6789,190,90,1089
4632000,2452000,3,0,0,0,0,0,0,0,0,0,0,0,0,0,0
4632000,2453000,5,0,0,0,0,0,0,0,0,0,0,0,0,0,0
4632000,2455000,1,0,0,0,0,0,0,0,0,0,0,0,0,0,0
4632000,2456000,1,0,0,0,0,0,0,0,0,0,0,0,0,0,0
4632000,2459000,3,0,0,0,0,0,0,0,0,0,0,0,0,0,0
4632000,2466000,4,299,132,167,43,2,29,7,1630,588,1042,318,2,243,40
4632000,2468000,2,0,0,0,0,0,0,0,0,0,0,0,0,0,0
4632000,2477000,1,0,0,0,0,0,0,0,0,0,0,0,0,0,0
4632000,2481000,1,0,0,0,0,0,0,0,0,0,0,0,0,0,0
4632000,2482000,1,0,0,0,0,0,0,0,0,0,0,0,0,0,0
4632000,2483000,1,0,0,0,0,0,0,0,0,0,0,0,0,0,0
4632000,2485000,3,0,0,0,0,0,0,0,0,0,0,0,0,0,0
4632000,2486000,2,0,0,0,0,0,0,0,0,0,0,0,0,0,0
4632000,2487000,3,0,0,0,0,0,0,0,0,0,0,0,0,0,0
4633000,2418000,14,880,7,873,282,108,68,130,6850,68,6782,2697,715,368,770
4633000,2419000,178,43263,2916,40347,8214,4524,3371,11129,234478,9185,225293,61217,17949,15240,52886
4633000,2420000,145,9698,195,9503,3299,461,1350,1367,72052,985,71067,30474,2445,9122,8658
4633000,2421000,34,2025,6,2019,996,52,211,242,16864,24,16840,9824,188,1219,1653
4633000,2423000,2,0,0,0,0,0,0,0,0,0,0,0,0,0,0
4633000,2429000,13,428,5,423,218,0,45,61,3576,9,3567,2182,0,308,437
4633000,2430000,10,455,4,451,189,6,43,55,3943,21,3922,1985,10,208,393
4633000,2431000,9,286,4,282,173,0,28,14,2387,42,2345,1726,0,85,91
4633000,2432000,2,0,0,0,0,0,0,0,0,0,0,0,0,0,0
4633000,2435000,43,2061,21,2040,1327,25,126,120,19454,103,19351,13960,67,834,844
4633000,2439000,1,0,0,0,0,0,0,0,0,0,0,0,0,0,0
4633000,2440000,11,768,43,725,429,0,20,143,6585,271,6314,4292,0,119,908
4633000,2442000,8,0,0,0,0,0,0,0,0,0,0,0,0,0,0
4633000,2447000,1,0,0,0,0,0,0,0,0,0,0,0,0,0,0
4633000,2449000,4,0,0,0,0,0,0,0,0,0,0,0,0,0,0
4633000,2450000,15,953,19,934,359,51,57,165,7453,142,7311,3082,145,286,1040
4633000,2451000,1,0,0,0,0,0,0,0,0,0,0,0,0,0,0
4633000,2452000,3,104,0,104,75,0,11,0,989,0,989,830,0,54,0
4633000,2453000,1,0,0,0,0,0,0,0,0,0,0,0,0,0,0
4633000,2469000,2,0,0,0,0,0,0,0,0,0,0,0,0,0,0
4633000,2483000,1,0,0,0,0,0,0,0,0,0,0,0,0,0,0
4633000,2484000,2,0,0,0,0,0,0,0,0,0,0,0,0,0,0
4633000,2486000,1,0,0,0,0,0,0,0,0,0,0,0,0,0,0
4634000,2419000,1,0,0,0,0,0,0,0,0,0,0,0,0,0,0
4634000,2420000,108,4947,99,4848,2277,210,571,371,40257,508,39749,21836,1058,3655,2784
4634000,2421000,165,8339,189,8150,3743,297,826,831,67792,902,66890,35813,1577,5883,5326
4634000,2422000,1,0,0,0,0,0,0,0,0,0,0,0,0,0,0
4634000,2427000,2,0,0,0,0,0,0,0,0,0,0,0,0,0,0
4634000,2429000,19,1130,20,1110,670,9,52,187,10923,134,10789,7456,52,274,1400
4634000,2430000,13,480,6,474,252,4,37,47,3828,22,3806,2184,20,244,388
4634000,2435000,1,0,0,0,0,0,0,0,0,0,0,0,0,0,0
4634000,2440000,8,656,45,611,174,19,92,74,3389,85,3304,1223,41,481,482
4634000,2441000,19,960,50,910,524,8,29,109,7580,132,7448,4894,50,127,605
4634000,2446000,3,111,16,95,43,0,22,0,933,52,881,495,0,100,0
4634000,2447000,12,579,1,578,444,0,10,36,5909,1,5908,4840,0,70,302
4634000,2449000,1,0,0,0,0,0,0,0,0,0,0,0,0,0,0
4634000,2453000,2,0,0,0,0,0,0,0,0,0,0,0,0,0,0
4634000,2461000,1,0,0,0,0,0,0,0,0,0,0,0,0,0,0
4634000,2462000,1,0,0,0,0,0,0,0,0,0,0,0,0,0,0
4634000,2464000,1,0,0,0,0,0,0,0,0,0,0,0,0,0,0
4634000,2467000,1,0,0,0,0,0,0,0,0,0,0,0,0,0,0
4634000,2473000,2,0,0,0,0,0,0,0,0,0,0,0,0,0,0
4634000,2478000,2,0,0,0,0,0,0,0,0,0,0,0,0,0,0
4634000,2480000,2,0,0,0,0,0,0,0,0,0,0,0,0,0,0
4634000,2481000,3,0,0,0,0,0,0,0,0,0,0,0,0,0,0
4635000,2420000,21,1015,35,980,467,50,58,92,8646,305,8341,4519,272,412,675
4635000,2421000,1,0,0,0,0,0,0,0,0,0,0,0,0,0,0
4635000,2435000,3,0,0,0,0,0,0,0,0,0,0,0,0,0,0
4635000,2436000,2,0,0,0,0,0,0,0,0,0,0,0,0,0,0
4635000,2440000,2,0,0,0,0,0,0,0,0,0,0,0,0,0,0
4635000,2441000,4,0,0,0,0,0,0,0,0,0,0,0,0,0,0
4635000,2443000,1,0,0,0,0,0,0,0,0,0,0,0,0,0,0
4635000,2447000,8,259,3,256,180,0,0,5,2541,9,2532,1829,0,0,27
4635000,2449000,2,0,0,0,0,0,0,0,0,0,0,0,0,0,0
4635000,2450000,2,0,0,0,0,0,0,0,0,0,0,0,0,0,0
4635000,2451000,5,0,0,0,0,0,0,0,0,0,0,0,0,0,0
4635000,2454000,2,0,0,0,0,0,0,0,0,0,0,0,0,0,0
4635000,2459000,2,0,0,0,0,0,0,0,0,0,0,0,0,0,0
4635000,2464000,1,0,0,0,0,0,0,0,0,0,0,0,0,0,0
4635000,2465000,1,0,0,0,0,0,0,0,0,0,0,0,0,0,0
4635000,2470000,1,0,0,0,0,0,0,0,0,0,0,0,0,0,0
4635000,2471000,2,0,0,0,0,0,0,0,0,0,0,0,0,0,0
4635000,2477000,4,0,0,0,0,0,0,0,0,0,0,0,0,0,0
4635000,2481000,7,75,0,75,38,0,0,0,602,0,602,364,0,0,0
4635000,2485000,1,0,0,0,0,0,0,0,0,0,0,0,0,0,0
4636000,2430000,11,556,3,553,378,0,6,75,5015,12,5003,3843,0,42,436
4636000,2431000,3,101,36,65,22,4,11,0,785,310,475,170,10,83,0
4636000,2433000,8,473,12,461,343,0,10,30,4681,54,4627,3800,0,59,213
4636000,2435000,7,260,15,245,183,0,10,23,2767,81,2686,2165,0,83,161
4636000,2436000,1,0,0,0,0,0,0,0,0,0,0,0,0,0,0
4636000,2440000,15,750,2,748,460,12,38,64,6605,6,6599,4432,45,182,486
4636000,2441000,15,645,39,606,371,0,9,71,5970,51,5919,3753,0,57,560
4636000,2447000,4,0,0,0,0,0,0,0,0,0,0,0,0,0,0
4636000,2448000,12,616,1,615,418,9,23,42,5765,13,5752,4333,58,122,311
4636000,2449000,1,0,0,0,0,0,0,0,0,0,0,0,0,0,0
4636000,2450000,2,0,0,0,0,0,0,0,0,0,0,0,0,0,0
4636000,2455000,4,197,5,192,95,18,9,10,1647,63,1584,1005,38,23,70
4636000,2459000,1,0,0,0,0,0,0,0,0,0,0,0,0,0,0
4636000,2460000,4,347,4,343,207,0,4,68,2710,11,2699,1891,0,24,286
4636000,2462000,1,0,0,0,0,0,0,0,0,0,0,0,0,0,0
4636000,2464000,9,528,78,450,112,20,78,24,2404,178,2226,889,32,257,104
4636000,2473000,2,0,0,0,0,0,0,0,0,0,0,0,0,0,0
4636000,2474000,1,0,0,0,0,0,0,0,0,0,0,0,0,0,0
4636000,2484000,2,0,0,0,0,0,0,0,0,0,0,0,0,0,0
4636000,2486000,1,0,0,0,0,0,0,0,0,0,0,0,0,0,0
4636000,2487000,1,0,0,0,0,0,0,0,0,0,0,0,0,0,0
4636000,2490000,1,0,0,0,0,0,0,0,0,0,0,0,0,0,0
4637000,2430000,23,1281,24,1257,679,32,48,112,11177,87,11090,6771,127,294,720
4637000,2432000,30,1655,88,1567,711,35,85,191,13394,616,12778,6499,188,503,1504
4637000,2433000,15,634,1,633,342,6,66,36,5999,14,5985,3775,10,425,284
4637000,2434000,6,198,0,198,128,6,2,27,2215,0,2215,1637,84,16,181
4637000,2437000,2,0,0,0,0,0,0,0,0,0,0,0,0,0,0
4637000,2442000,8,388,6,382,288,1,8,57,3735,37,3698,2883,7,56,496
4637000,2443000,5,146,1,145,87,0,0,43,1512,1,1511,941,0,0,395
4637000,2447000,6,163,0,163,85,3,9,17,1548,0,1548,948,21,34,133
4637000,2455000,2,0,0,0,0,0,0,0,0,0,0,0,0,0,0
4637000,2458000,1,0,0,0,0,0,0,0,0,0,0,0,0,0,0
4637000,2459000,2,0,0,0,0,0,0,0,0,0,0,0,0,0,0
4637000,2461000,3,123,1,122,94,0,0,8,1336,5,1331,1066,0,0,56
4637000,2462000,9,370,65,305,182,4,6,4,2819,254,2565,1812,10,38,28
4637000,2463000,1,0,0,0,0,0,0,0,0,0,0,0,0,0,0
4637000,2481000,1,0,0,0,0,0,0,0,0,0,0,0,0,0,0
4637000,2483000,1,0,0,0,0,0,0,0,0,0,0,0,0,0,0
4637000,2484000,5,0,0,0,0,0,0,0,0,0,0,0,0,0,0
4638000,2434000,36,1318,29,1289,763,22,43,104,11391,190,11201,7531,102,347,624
4638000,2435000,1,0,0,0,0,0,0,0,0,0,0,0,0,0,0
4638000,2436000,1,0,0,0,0,0,0,0,0,0,0,0,0,0,0
4638000,2437000,95,13383,3357,10026,1764,2455,976,569,84325,18966,65359,16161,14782,5711,2964
4638000,2442000,20,864,1,863,596,6,14,70,8314,7,8307,6118,39,98,544
4638000,2443000,13,536,0,536,349,2,2,81,5309,0,5309,3942,14,14,515
4638000,2446000,11,974,36,938,397,31,24,141,6145,86,6059,3574,61,97,690
4638000,2452000,1,0,0,0,0,0,0,0,0,0,0,0,0,0,0
4638000,2460000,6,285,0,285,149,4,3,65,2262,0,2262,1481,28,9,261
4638000,2461000,2,0,0,0,0,0,0,0,0,0,0,0,0,0,0
4638000,2462000,1,0,0,0,0,0,0,0,0,0,0,0,0,0,0
4638000,2463000,2,0,0,0,0,0,0,0,0,0,0,0,0,0,0
4638000,2467000,1,0,0,0,0,0,0,0,0,0,0,0,0,0,0
4638000,2469000,1,0,0,0,0,0,0,0,0,0,0,0,0,0,0
4638000,2479000,9,916,104,812,160,22,84,73,2147,178,1969,620,46,130,193
4638000,2481000,1,0,0,0,0,0,0,0,0,0,0,0,0,0,0
4638000,2484000,18,0,0,0,0,0,0,0,0,0,0,0,0,0,0
4638000,2485000,2,0,0,0,0,0,0,0,0,0,0,0,0,0,0
4638000,2489000,1,0,0,0,0,0,0,0,0,0,0,0,0,0,0
4639000,2434000,2,0,0,0,0,0,0,0,0,0,0,0,0,0,0
4639000,2435000,3,64,0,64,17,37,6,0,731,0,731,183,410,82,0
4639000,2449000,10,461,8,453,303,0,5,21,4697,53,4644,3307,0,10,253
4639000,2450000,6,0,0,0,0,0,0,0,0,0,0,0,0,0,0
4639000,2451000,2,0,0,0,0,0,0,0,0,0,0,0,0,0,0
4639000,2452000,7,314,7,307,193,0,5,35,3161,49,3112,2015,0,35,337
4639000,2453000,5,0,0,0,0,0,0,0,0,0,0,0,0,0,0
4639000,2454000,1,0,0,0,0,0,0,0,0,0,0,0,0,0,0
4639000,2456000,2,0,0,0,0,0,0,0,0,0,0,0,0,0,0
4639000,2461000,3,73,0,73,57,0,0,0,849,0,849,672,0,0,0
4639000,2462000,3,196,0,196,124,0,0,17,1767,0,1767,1136,0,0,203
4639000,2465000,1,0,0,0,0,0,0,0,0,0,0,0,0,0,0
4639000,2467000,1,0,0,0,0,0,0,0,0,0,0,0,0,0,0
4639000,2474000,3,0,0,0,0,0,0,0,0,0,0,0,0,0,0
4639000,2480000,2,0,0,0,0,0,0,0,0,0,0,0,0,0,0
4640000,2433000,1,0,0,0,0,0,0,0,0,0,0,0,0,0,0
4640000,2437000,3,271,0,271,157,6,38,45,2376,0,2376,1590,40,143,325
4640000,2438000,63,2989,3,2986,1925,32,109,315,28147,10,28137,19792,212,743,2316
4640000,2439000,10,585,0,585,328,0,123,56,5168,0,5168,3392,0,747,381
4640000,2443000,3,97,0,97,36,3,9,22,843,0,843,445,21,43,150
4640000,2450000,3,0,0,0,0,0,0,0,0,0,0,0,0,0,0
4640000,2451000,3,111,0,111,53,5,0,8,1156,0,1156,540,70,0,56
4640000,2452000,5,301,15,286,138,11,10,48,2520,67,2453,1456,51,26,279
4640000,2453000,2,0,0,0,0,0,0,0,0,0,0,0,0,0,0
4640000,2455000,17,841,27,814,417,21,91,59,6063,91,5972,3985,21,418,276
4640000,2456000,16,796,2,794,526,9,14,55,7826,14,7812,5632,57,113,467
4640000,2459000,1,0,0,0,0,0,0,0,0,0,0,0,0,0,0
4640000,2460000,1,0,0,0,0,0,0,0,0,0,0,0,0,0,0
4640000,2461000,1,0,0,0,0,0,0,0,0,0,0,0,0,0,0
4640000,2462000,2,0,0,0,0,0,0,0,0,0,0,0,0,0,0
4640000,2463000,2,0,0,0,0,0,0,0,0,0,0,0,0,0,0
4640000,2464000,4,674,19,655,222,40,29,116,4029,49,3980,2054,70,64,523
4640000,2466000,1,0,0,0,0,0,0,0,0,0,0,0,0,0,0
4640000,2481000,6,562,56,506,27,41,187,49,1727,153,1574,137,86,361,217
4640000,2482000,2,0,0,0,0,0,0,0,0,0,0,0,0,0,0
4640000,2484000,2,0,0,0,0,0,0,0,0,0,0,0,0,0,0
4641000,2438000,3,247,14,233,73,0,40,4,1800,96,1704,696,0,228,28
4641000,2442000,14,692,37,655,296,2,16,107,5293,143,5150,2797,2,96,719
4641000,2443000,11,488,3,485,296,0,7,79,4335,11,4324,2910,0,81,575
4641000,2445000,19,843,0,843,633,0,12,47,8539,0,8539,6818,0,94,406
4641000,2449000,1,0,0,0,0,0,0,0,0,0,0,0,0,0,0
4641000,2450000,14,596,11,585,413,2,20,52,6150,65,6085,4560,10,189,379
4641000,2451000,5,0,0,0,0,0,0,0,0,0,0,0,0,0,0
4641000,2452000,6,197,0,197,105,11,29,4,1676,0,1676,1058,33,180,20
4641000,2453000,7,237,0,237,140,4,8,48,2277,0,2277,1482,28,31,382
4641000,2455000,3,0,0,0,0,0,0,0,0,0,0,0,0,0,0
4641000,2456000,2,0,0,0,0,0,0,0,0,0,0,0,0,0,0
4641000,2458000,1,0,0,0,0,0,0,0,0,0,0,0,0,0,0
4641000,2459000,23,1407,42,1365,760,59,26,181,11979,102,11877,7398,174,245,1152
4641000,2461000,2,0,0,0,0,0,0,0,0,0,0,0,0,0,0
4641000,2462000,2,0,0,0,0,0,0,0,0,0,0,0,0,0,0
4641000,2466000,1,0,0,0,0,0,0,0,0,0,0,0,0,0,0
4641000,2474000,2,0,0,0,0,0,0,0,0,0,0,0,0,0,0
4641000,2476000,1,0,0,0,0,0,0,0,0,0,0,0,0,0,0
4641000,2479000,1,0,0,0,0,0,0,0,0,0,0,0,0,0,0
4641000,2488000,1,0,0,0,0,0,0,0,0,0,0,0,0,0,0
4642000,2438000,3,242,0,242,66,4,53,32,1940,0,1940,711,24,430,218
4642000,2442000,1,0,0,0,0,0,0,0,0,0,0,0,0,0,0
4642000,2444000,3,120,0,120,71,1,0,29,1020,0,1020,735,7,0,176
4642000,2447000,5,0,0,0,0,0,0,0,0,0,0,0,0,0,0
4642000,2448000,1,0,0,0,0,0,0,0,0,0,0,0,0,0,0
4642000,2449000,5,0,0,0,0,0,0,0,0,0,0,0,0,0,0
4642000,2450000,6,277,26,251,150,4,18,19,2046,93,1953,1471,10,85,89
4642000,2451000,21,811,55,756,415,15,61,97,6637,115,6522,4086,69,320,514
4642000,2452000,1,0,0,0,0,0,0,0,0,0,0,0,0,0,0
4642000,2454000,2,0,0,0,0,0,0,0,0,0,0,0,0,0,0
4642000,2456000,8,421,0,421,267,0,7,30,3898,0,3898,2816,0,33,205
4642000,2457000,1,0,0,0,0,0,0,0,0,0,0,0,0,0,0
4642000,2458000,2,0,0,0,0,0,0,0,0,0,0,0,0,0,0
4642000,2462000,1,0,0,0,0,0,0,0,0,0,0,0,0,0,0
4642000,2464000,2,0,0,0,0,0,0,0,0,0,0,0,0,0,0
4642000,2466000,2,0,0,0,0,0,0,0,0,0,0,0,0,0,0
4642000,2467000,1,0,0,0,0,0,0,0,0,0,0,0,0,0,0
4642000,2473000,2,0,0,0,0,0,0,0,0,0,0,0,0,0,0
4642000,2479000,1,0,0,0,0,0,0,0,0,0,0,0,0,0,0
4642000,2481000,1,0,0,0,0,0,0,0,0,0,0,0,0,0,0
4643000,2443000,1,0,0,0,0,0,0,0,0,0,0,0,0,0,0
4643000,2445000,1,0,0,0,0,0,0,0,0,0,0,0,0,0,0
4643000,2446000,4,119,0,119,60,4,4,8,1151,0,1151,658,28,32,48
4643000,2447000,11,589,58,531,370,2,36,33,5260,209,5051,3991,8,230,200
4643000,2448000,19,825,20,805,528,20,27,53,8322,162,8160,5652,77,232,382
4643000,2449000,22,860,11,849,529,3,42,35,8613,52,8561,5988,21,357,229
4643000,2450000,2,0,0,0,0,0,0,0,0,0,0,0,0,0,0
4643000,2451000,19,975,10,965,622,7,24,75,9272,82,9190,6717,37,204,566
4643000,2452000,2,0,0,0,0,0,0,0,0,0,0,0,0,0,0
4643000,2456000,2,0,0,0,0,0,0,0,0,0,0,0,0,0,0
4643000,2460000,2,0,0,0,0,0,0,0,0,0,0,0,0,0,0
4643000,2461000,1,0,0,0,0,0,0,0,0,0,0,0,0,0,0
4643000,2463000,2,0,0,0,0,0,0,0,0,0,0,0,0,0,0
4643000,2465000,1,0,0,0,0,0,0,0,0,0,0,0,0,0,0
4643000,2467000,1,0,0,0,0,0,0,0,0,0,0,0,0,0,0
4643000,2472000,1,0,0,0,0,0,0,0,0,0,0,0,0,0,0
4643000,2486000,2,0,0,0,0,0,0,0,0,0,0,0,0,0,0
4644000,2437000,17,0,0,0,0,0,0,0,0,0,0,0,0,0,0
4644000,2442000,7,0,0,0,0,0,0,0,0,0,0,0,0,0,0
4644000,2444000,6,141,8,133,90,4,12,8,1242,36,1206,780,40,144,77
4644000,2448000,4,323,16,307,115,9,54,45,1958,103,1855,763,23,342,288
4644000,2449000,9,627,16,611,169,32,56,26,4089,55,4034,1336,166,387,189
4644000,2450000,10,0,0,0,0,0,0,0,0,0,0,0,0,0,0
4644000,2451000,32,1039,45,994,450,31,78,75,8555,328,8227,4330,94,530,497
4644000,2452000,18,793,82,711,423,0,32,59,7126,587,6539,4296,0,134,541
4644000,2454000,11,394,16,378,203,0,12,56,3719,78,3641,2131,0,69,503
4644000,2455000,22,990,23,967,678,3,36,91,9494,205,9289,6903,15,265,699
4644000,2456000,20,844,30,814,503,9,42,59,7988,183,7805,5444,32,267,428
4644000,2457000,7,388,11,377,227,19,5,31,3849,72,3777,2581,97,23,217
4644000,2459000,2,0,0,0,0,0,0,0,0,0,0,0,0,0,0
4644000,2460000,4,182,0,182,134,0,0,26,1841,0,1841,1384,0,0,244
4644000,2461000,1,0,0,0,0,0,0,0,0,0,0,0,0,0,0
4644000,2473000,1,0,0,0,0,0,0,0,0,0,0,0,0,0,0
4644000,2474000,1,0,0,0,0,0,0,0,0,0,0,0,0,0,0
4645000,2439000,18,0,0,0,0,0,0,0,0,0,0,0,0,0,0
4645000,2446000,8,224,2,222,113,7,11,13,1810,8,1802,1081,31,32,83
4645000,2448000,8,356,4,352,190,4,26,31,3165,8,3157,2267,8,94,165
4645000,2449000,33,1716,48,1668,935,38,152,129,14796,118,14678,9939,166,673,907
4645000,2450000,14,871,44,827,294,31,151,32,5863,108,5755,2829,128,690,124
4645000,2451000,5,128,0,128,58,9,22,9,1049,0,1049,549,63,158,86
4645000,2452000,57,4525,635,3890,1082,128,893,299,18883,1613,17270,8352,263,2305,901
4645000,2454000,22,1080,84,996,522,5,109,154,9002,404,8598,5516,15,522,962
4645000,2457000,5,0,0,0,0,0,0,0,0,0,0,0,0,0,0
4645000,2459000,10,0,0,0,0,0,0,0,0,0,0,0,0,0,0
4645000,2460000,11,0,0,0,0,0,0,0,0,0,0,0,0,0,0
4645000,2463000,4,0,0,0,0,0,0,0,0,0,0,0,0,0,0
4645000,2464000,3,102,17,85,64,0,0,6,1161,303,858,713,0,0,56
4645000,2471000,1,0,0,0,0,0,0,0,0,0,0,0,0,0,0
4645000,2474000,2,0,0,0,0,0,0,0,0,0,0,0,0,0,0
4645000,2478000,4,0,0,0,0,0,0,0,0,0,0,0,0,0,0
4646000,2437000,10,477,33,444,145,13,57,58,3391,188,3203,1238,90,486,309
4646000,2438000,7,418,4,414,222,0,17,68,3901,8,3893,2251,0,111,527
4646000,2439000,3,128,0,128,73,0,6,0,1105,0,1105,653,0,60,0
4646000,2446000,1,0,0,0,0,0,0,0,0,0,0,0,0,0,0
4646000,2448000,11,496,2,494,275,4,16,53,4535,2,4533,3081,16,113,406
4646000,2449000,5,370,0,370,225,0,0,71,3155,0,3155,2143,0,0,440
4646000,2450000,5,319,8,311,116,13,30,25,1674,26,1648,939,22,119,106
4646000,2451000,11,758,34,724,293,19,110,56,5016,95,4921,2670,61,469,294
4646000,2452000,3,0,0,0,0,0,0,0,0,0,0,0,0,0,0
4646000,2460000,19,949,53,896,387,13,46,74,8181,174,8007,3973,68,271,580
4646000,2464000,4,92,0,92,35,0,2,6,901,0,901,383,0,14,76
4646000,2465000,4,0,0,0,0,0,0,0,0,0,0,0,0,0,0
4646000,2467000,1,0,0,0,0,0,0,0,0,0,0,0,0,0,0
4646000,2468000,3,205,0,205,128,0,22,19,2000,0,2000,1460,0,127,157
4646000,2472000,1,0,0,0,0,0,0,0,0,0,0,0,0,0,0
4646000,2476000,1,0,0,0,0,0,0,0,0,0,0,0,0,0,0
4647000,2443000,7,601,19,582,259,7,67,53,4283,80,4203,2263,24,354,324
4647000,2444000,12,585,2,583,419,0,2,118,5503,14,5489,4215,0,12,961
4647000,2446000,1,0,0,0,0,0,0,0,0,0,0,0,0,0,0
4647000,2448000,8,238,0,238,158,2,12,6,2157,0,2157,1553,14,74,52
4647000,2449000,1,0,0,0,0,0,0,0,0,0,0,0,0,0,0
4647000,2450000,9,762,25,737,264,13,87,33,5445,190,5255,2600,42,258,174
4647000,2451000,2,0,0,0,0,0,0,0,0,0,0,0,0,0,0
4647000,2452000,4,140,7,133,22,6,28,11,698,19,679,115,28,142,52
4647000,2453000,10,485,1,484,257,16,43,62,3459,1,3458,2294,29,163,378
4647000,2456000,1,0,0,0,0,0,0,0,0,0,0,0,0,0,0
4647000,2457000,4,0,0,0,0,0,0,0,0,0,0,0,0,0,0
4647000,2468000,1,0,0,0,0,0,0,0,0,0,0,0,0,0,0
4647000,2477000,2,0,0,0,0,0,0,0,0,0,0,0,0,0,0
4647000,2478000,1,0,0,0,0,0,0,0,0,0,0,0,0,0,0
4647000,2491000,1,0,0,0,0,0,0,0,0,0,0,0,0,0,0
4648000,2439000,1,0,0,0,0,0,0,0,0,0,0,0,0,0,0
4648000,2442000,8,940,8,932,487,2,10,212,8176,41,8135,4878,14,80,1514
4648000,2443000,5,242,4,238,130,0,11,11,1986,12,1974,1269,0,69,69
4648000,2444000,3,0,0,0,0,0,0,0,0,0,0,0,0,0,0
4648000,2445000,34,0,0,0,0,0,0,0,0,0,0,0,0,0,0
4648000,2446000,19,0,0,0,0,0,0,0,0,0,0,0,0,0,0
4648000,2447000,1,0,0,0,0,0,0,0,0,0,0,0,0,0,0
4648000,2448000,12,140381,6661,133720,33332,13014,11260,26754,832915,18815,814100,249741,47382,50084,135676
4648000,2449000,71,5077,212,4865,1344,222,773,630,31779,726,31053,10996,1171,3865,3184
4648000,2450000,334,40522,1065,39457,12071,1793,3267,7136,264586,3549,261037,105009,7947,17695,36645
4648000,2452000,23,1597,17,1580,985,7,77,228,13019,66,12953,8890,33,263,1595
4648000,2453000,1,0,0,0,0,0,0,0,0,0,0,0,0,0,0
4648000,2458000,16,775,127,648,161,4,142,47,3985,559,3426,1144,9,702,204
4648000,2466000,2,0,0,0,0,0,0,0,0,0,0,0,0,0,0
4648000,2468000,1,0,0,0,0,0,0,0,0,0,0,0,0,0,0
4649000,2439000,1,0,0,0,0,0,0,0,0,0,0,0,0,0,0
4649000,2440000,30,0,0,0,0,0,0,0,0,0,0,0,0,0,0
4649000,2441000,53,2951,44,2907,1333,81,202,336,23843,271,23572,13276,393,1168,2270
4649000,2442000,27,2620,73,2547,1007,107,196,405,17517,253,17264,8733,619,876,2224
4649000,2449000,9,797,21,776,146,110,76,67,5613,166,5447,1183,745,597,323
4649000,2450000,1,0,0,0,0,0,0,0,0,0,0,0,0,0,0
4649000,2456000,9,0,0,0,0,0,0,0,0,0,0,0,0,0,0
4649000,2459000,1,0,0,0,0,0,0,0,0,0,0,0,0,0,0
4649000,2460000,11,449,4,445,209,10,26,54,4262,45,4217,2357,63,124,292
4649000,2461000,1,0,0,0,0,0,0,0,0,0,0,0,0,0,0
4650000,2452000,18,658,4,654,401,7,8,98,5899,16,5883,3814,49,56,751
4650000,2456000,5,1121,152,969,273,36,238,141,2584,289,2295,650,48,406,319
4650000,2461000,1,0,0,0,0,0,0,0,0,0,0,0,0,0,0
4650000,2475000,1,0,0,0,0,0,0,0,0,0,0,0,0,0,0
4652000,2455000,15,530,2,528,339,6,29,13,4588,14,4574,3442,42,93,77
4652000,2456000,2,0,0,0,0,0,0,0,0,0,0,0,0,0,0
4652000,2457000,2,0,0,0,0,0,0,0,0,0,0,0,0,0,0
4652000,2495000,2,0,0,0,0,0,0,0,0,0,0,0,0,0,0
4652000,2496000,3,0,0,0,0,0,0,0,0,0,0,0,0,0,0
4653000,2458000,1,0,0,0,0,0,0,0,0,0,0,0,0,0,0
4653000,2459000,9,583,6,577,286,0,29,66,4478,55,4423,2737,0,95,437
4653000,2460000,1,0,0,0,0,0,0,0,0,0,0,0,0,0,0
4653000,2461000,1,0,0,0,0,0,0,0,0,0,0,0,0,0,0
4653000,2462000,11,621,10,611,226,11,76,29,4205,11,4194,2145,45,312,128
4653000,2463000,7,0,0,0,0,0,0,0,0,0,0,0,0,0,0
4653000,2464000,16,625,11,614,330,10,59,48,5074,22,5052,3291,40,351,298
4653000,2466000,9,280,3,277,176,4,17,27,2288,15,2273,1578,28,95,211
4653000,2468000,3,95,0,95,58,0,3,15,812,0,812,496,0,12,140
4653000,2494000,2,0,0,0,0,0,0,0,0,0,0,0,0,0,0
4654000,2461000,38,2844,30,2814,685,90,389,327,16931,88,16843,5437,368,1600,1591
4654000,2464000,1,0,0,0,0,0,0,0,0,0,0,0,0,0,0
4654000,2466000,3,0,0,0,0,0,0,0,0,0,0,0,0,0,0
4654000,2467000,6,241,6,235,69,4,27,41,1529,31,1498,572,8,136,176
4654000,2468000,17,1554,64,1490,266,67,176,181,9589,322,9267,2476,412,1033,838
4654000,2469000,4,150,8,142,43,2,4,25,807,16,791,265,4,40,113
4654000,2472000,2,0,0,0,0,0,0,0,0,0,0,0,0,0,0
4655000,2466000,32,1624,21,1603,465,61,166,239,10214,86,10128,3829,254,752,1284
4655000,2467000,52,23337,1235,22102,3359,1835,3091,6238,95612,3534,92078,20687,6750,11477,26667
4655000,2468000,106,18013,361,17652,4250,2278,2395,2785,85356,1665,83691,22120,10115,10985,12955
4655000,2469000,28,1663,32,1631,624,46,183,223,10298,112,10186,5123,240,758,1260
4655000,2470000,3,0,0,0,0,0,0,0,0,0,0,0,0,0,0
4655000,2471000,1,0,0,0,0,0,0,0,0,0,0,0,0,0,0
4655000,2472000,11,0,0,0,0,0,0,0,0,0,0,0,0,0,0
4655000,2473000,11,0,0,0,0,0,0,0,0,0,0,0,0,0,0
4655000,2474000,13,0,0,0,0,0,0,0,0,0,0,0,0,0,0
4655000,2475000,22,1090,117,973,350,21,86,110,7230,905,6325,3214,45,526,634
4655000,2476000,13,596,30,566,161,11,38,60,3093,57,3036,1218,23,96,277
4655000,2477000,6,0,0,0,0,0,0,0,0,0,0,0,0,0,0
4655000,2478000,1,0,0,0,0,0,0,0,0,0,0,0,0,0,0
4655000,2486000,5,195,6,189,57,0,27,16,946,16,930,444,0,87,59
4655000,2488000,7,502,58,444,158,14,25,101,3422,148,3274,1431,63,64,303
4656000,2471000,36,16595,618,15977,3585,2730,1339,1192,65956,2467,63489,16797,11251,4910,4935
4656000,2473000,66,4071,489,3582,823,119,320,621,25787,2280,23507,6502,648,2117,3658
4656000,2474000,150,75390,12533,62857,10323,5155,6471,8865,253300,30747,222553,53900,13085,21628,34729
4656000,2475000,106,6654,307,6347,1949,177,437,547,40967,1166,39801,16326,582,2008,2854
4656000,2476000,52,4064,216,3848,900,92,469,326,21478,853,20625,6874,424,1729,1473
4656000,2477000,26,1422,31,1391,558,20,90,143,10484,66,10418,5069,70,400,822
4656000,2479000,7,429,3,426,154,3,28,26,2854,15,2839,1436,16,94,117
4656000,2480000,1,0,0,0,0,0,0,0,0,0,0,0,0,0,0
4656000,2488000,1,0,0,0,0,0,0,0,0,0,0,0,0,0,0
4656000,2494000,6,0,0,0,0,0,0,0,0,0,0,0,0,0,0
4656000,2495000,1,0,0,0,0,0,0,0,0,0,0,0,0,0,0
4657000,2475000,34,3591,183,3408,575,159,432,448,16772,564,16208,3711,574,1887,1708
4657000,2476000,137,28117,1099,27018,6261,1163,2273,4095,114262,3959,110303,30113,4047,7317,16951
4657000,2477000,12,1175,122,1053,187,55,116,222,4597,215,4382,1348,96,291,738
4657000,2478000,6,369,5,364,113,25,22,14,2707,18,2689,997,142,170,97
4657000,2479000,1,0,0,0,0,0,0,0,0,0,0,0,0,0,0
4657000,2482000,6,128,9,119,36,0,14,5,1064,43,1021,362,0,108,19
4657000,2487000,2,0,0,0,0,0,0,0,0,0,0,0,0,0,0
4657000,2493000,1,0,0,0,0,0,0,0,0,0,0,0,0,0,0
4658000,2401000,34,0,0,0,0,0,0,0,0,0,0,0,0,0,0
4658000,2456000,11,410,23,387,124,26,35,54,3367,181,3186,1185,247,285,355
4658000,2477000,26,0,0,0,0,0,0,0,0,0,0,0,0,0,0
4658000,2478000,73,97467,11855,85612,12194,6232,9385,15374,294550,27328,267222,53451,13892,23876,52200
4658000,2479000,84,5017,548,4469,726,182,504,467,23327,2442,20885,4724,486,1636,2028
4658000,2480000,29,1354,43,1311,583,13,42,181,10341,271,10070,5204,49,239,1113
4658000,2481000,5,224,6,218,55,9,33,23,1080,16,1064,425,19,106,113
4658000,2482000,17,961,66,895,310,34,169,71,5126,163,4963,2630,59,537,287
4658000,2484000,1,0,0,0,0,0,0,0,0,0,0,0,0,0,0
4658000,2485000,6,505,73,432,55,21,120,39,1532,151,1381,268,27,314,141
4658000,2486000,3,0,0,0,0,0,0,0,0,0,0,0,0,0,0
4658000,2487000,1,0,0,0,0,0,0,0,0,0,0,0,0,0,0
4658000,2488000,1,0,0,0,0,0,0,0,0,0,0,0,0,0,0
4659000,2454000,2,0,0,0,0,0,0,0,0,0,0,0,0,0,0
4659000,2478000,1,0,0,0,0,0,0,0,0,0,0,0,0,0,0
4659000,2479000,57,18233,728,17505,2232,374,1066,9979,81559,2667,78892,13210,1047,3741,44241
4659000,2480000,320,203539,37001,166538,15972,11637,18602,26931,572776,78880,493896,73200,24816,45078,90477
4659000,2481000,83,10146,1600,8546,1666,351,1300,1106,37339,4921,32418,9865,688,3156,3751
4659000,2482000,13,670,71,599,180,12,119,24,3724,135,3589,1737,46,456,101
4659000,2483000,5,0,0,0,0,0,0,0,0,0,0,0,0,0,0
4659000,2485000,2,0,0,0,0,0,0,0,0,0,0,0,0,0,0
4660000,2452000,1,0,0,0,0,0,0,0,0,0,0,0,0,0,0
4660000,2480000,1,0,0,0,0,0,0,0,0,0,0,0,0,0,0
4660000,2481000,10,723,219,504,51,27,116,34,2521,660,1861,322,76,331,118
4660000,2482000,62,4301,389,3912,613,64,1522,201,17278,1580,15698,4612,262,3564,892
4660000,2483000,15,731,33,698,238,10,79,15,5069,85,4984,2490,38,322,111
4660000,2494000,1,0,0,0,0,0,0,0,0,0,0,0,0,0,0
4661000,2456000,1,0,0,0,0,0,0,0,0,0,0,0,0,0,0
4661000,2480000,1,0,0,0,0,0,0,0,0,0,0,0,0,0,0
4661000,2481000,15,1889,641,1248,196,108,175,51,8565,2230,6335,1431,378,530,200
4661000,2482000,22,769,53,716,262,13,40,51,5093,180,4913,2213,50,193,303
4661000,2483000,26,3552,461,3091,444,61,880,188,11301,968,10333,2302,136,2129,423
4662000,2480000,22,1157,45,1112,332,15,173,85,6814,277,6537,2859,48,677,435
4662000,2481000,8,577,93,484,82,10,181,30,2284,237,2047,591,17,516,107
4662000,2482000,4,618,92,526,35,7,68,11,1419,188,1231,209,15,116,21
4662000,2483000,2,0,0,0,0,0,0,0,0,0,0,0,0,0,0
4662000,2485000,7,416,10,406,172,12,13,37,3163,19,3144,1735,16,108,247
4662000,2490000,1,0,0,0,0,0,0,0,0,0,0,0,0,0,0
4663000,2387000,27,925,162,763,80,165,77,281,6998,874,6124,810,1104,536,2548
4663000,2429000,4,0,0,0,0,0,0,0,0,0,0,0,0,0,0
4663000,2432000,1,0,0,0,0,0,0,0,0,0,0,0,0,0,0
4663000,2454000,2,0,0,0,0,0,0,0,0,0,0,0,0,0,0
4663000,2479000,1,0,0,0,0,0,0,0,0,0,0,0,0,0,0
4663000,2480000,16,793,35,758,145,9,77,50,3969,64,3905,1113,40,211,241
4663000,2481000,17,885,73,812,217,3,119,40,4076,268,3808,1587,7,279,155
4663000,2482000,3,0,0,0,0,0,0,0,0,0,0,0,0,0,0
4663000,2485000,1,0,0,0,0,0,0,0,0,0,0,0,0,0,0
4663000,2486000,2,0,0,0,0,0,0,0,0,0,0,0,0,0,0
4664000,2387000,9,496,63,433,47,55,37,212,4127,416,3711,394,424,331,1897
4664000,2431000,4,121,0,121,16,3,39,28,746,0,746,100,12,236,168
4664000,2454000,9,0,0,0,0,0,0,0,0,0,0,0,0,0,0
4664000,2479000,32,2897,304,2593,242,131,705,113,11002,923,10079,1252,378,2382,435
4664000,2480000,30,2008,321,1687,295,17,356,88,8898,1475,7423,1848,57,1050,299
4664000,2481000,12,381,20,361,59,6,56,7,2047,34,2013,439,12,274,45
4664000,2482000,5,729,50,679,180,20,80,16,3035,107,2928,1492,40,252,37
4664000,2483000,1,0,0,0,0,0,0,0,0,0,0,0,0,0,0
4664000,2484000,3,143,0,143,58,0,10,16,1446,0,1446,671,0,74,174
4664000,2485000,6,355,108,247,132,5,24,12,2017,228,1789,1469,5,72,77
4664000,2486000,3,469,237,232,58,14,100,7,2043,505,1538,301,52,988,37
4665000,2421000,19,949,41,908,115,84,460,118,7526,249,7277,1010,649,3586,902
4665000,2422000,48,0,0,0,0,0,0,0,0,0,0,0,0,0,0
4665000,2423000,10,0,0,0,0,0,0,0,0,0,0,0,0,0,0
4665000,2428000,1,0,0,0,0,0,0,0,0,0,0,0,0,0,0
4665000,2431000,47,5611,126,5485,1482,349,1119,1417,36488,519,35969,10994,2360,7491,9127
4665000,2479000,10,0,0,0,0,0,0,0,0,0,0,0,0,0,0
4665000,2480000,9,543,65,478,48,12,99,17,1658,125,1533,260,19,285,35
4665000,2481000,12,724,43,681,63,3,116,51,2390,120,2270,239,21,236,171
4665000,2482000,4,0,0,0,0,0,0,0,0,0,0,0,0,0,0
4665000,2484000,5,359,106,253,47,15,56,28,1302,278,1024,340,19,156,104
4665000,2485000,1,0,0,0,0,0,0,0,0,0,0,0,0,0,0
4665000,2486000,1,0,0,0,0,0,0,0,0,0,0,0,0,0,0
4666000,2420000,2,0,0,0,0,0,0,0,0,0,0,0,0,0,0
4666000,2421000,5,352,2,350,49,31,135,69,3016,23,2993,442,309,1109,676
4666000,2479000,11,697,149,548,58,7,124,28,1784,341,1443,333,7,221,81
4666000,2480000,8,282,39,243,54,14,43,13,1347,271,1076,449,23,150,43
4666000,2481000,2,0,0,0,0,0,0,0,0,0,0,0,0,0,0
4666000,2484000,1,0,0,0,0,0,0,0,0,0,0,0,0,0,0
4667000,2418000,5,183,6,177,28,10,58,9,1229,28,1201,302,52,421,47
4667000,2419000,2,0,0,0,0,0,0,0,0,0,0,0,0,0,0
4667000,2420000,73,3359,170,3189,332,1726,477,306,26513,1265,25248,3139,13701,3322,2511
4667000,2422000,1,0,0,0,0,0,0,0,0,0,0,0,0,0,0
4667000,2438000,2,0,0,0,0,0,0,0,0,0,0,0,0,0,0
4667000,2439000,8,102,1,101,15,43,7,8,1058,10,1048,161,495,34,50
4667000,2479000,9,1215,210,1005,97,23,177,48,3966,1307,2659,293,72,343,165
4667000,2480000,5,216,4,212,81,4,19,1,1330,8,1322,664,16,128,1
4667000,2481000,1,0,0,0,0,0,0,0,0,0,0,0,0,0,0
4667000,2483000,1,0,0,0,0,0,0,0,0,0,0,0,0,0,0
4667000,2486000,1,0,0,0,0,0,0,0,0,0,0,0,0,0,0
4668000,2418000,19,676,19,657,146,37,168,160,5330,114,5216,1322,261,1340,1346
4668000,2438000,1,0,0,0,0,0,0,0,0,0,0,0,0,0,0
4668000,2478000,3,82,5,77,7,0,10,2,297,16,281,18,0,62,8
4668000,2479000,43,2093,232,1861,207,34,357,60,6840,600,6240,1276,58,993,184
4668000,2480000,2,0,0,0,0,0,0,0,0,0,0,0,0,0,0
4668000,2481000,9,1261,176,1085,89,29,270,25,3027,379,2648,279,55,514,81
4668000,2482000,3,84,11,73,52,0,0,6,607,77,530,371,0,0,14
4669000,2396000,3,169,0,169,41,27,9,44,1582,0,1582,516,265,56,314
4669000,2402000,6,170,2,168,22,19,44,14,1295,4,1291,204,184,330,78
4669000,2403000,1,0,0,0,0,0,0,0,0,0,0,0,0,0,0
4669000,2404000,9,390,17,373,97,120,70,21,3219,90,3129,994,948,434,216
4669000,2405000,1,0,0,0,0,0,0,0,0,0,0,0,0,0,0
4669000,2406000,1,0,0,0,0,0,0,0,0,0,0,0,0,0,0
4669000,2408000,18,14474,373,14101,5351,2836,1397,1273,99881,2310,97571,39721,23293,9887,8781
4669000,2413000,1,0,0,0,0,0,0,0,0,0,0,0,0,0,0
4669000,2414000,1,0,0,0,0,0,0,0,0,0,0,0,0,0,0
4669000,2437000,322,82552,4181,78371,22031,17060,15962,7904,600463,23356,577107,208395,127970,96920,55746
4669000,2438000,6,256,19,237,24,5,117,23,1369,92,1277,156,15,659,94
4669000,2478000,222,96483,17612,78871,8644,1810,12963,3781,190640,30561,160079,18801,4625,23357,7141
4669000,2479000,57,3145,299,2846,332,21,572,112,10007,1061,8946,1137,63,1768,271
4669000,2480000,9,1033,231,802,97,10,290,38,3329,796,2533,508,20,782,138
4669000,2483000,1,0,0,0,0,0,0,0,0,0,0,0,0,0,0
4669000,2485000,1,0,0,0,0,0,0,0,0,0,0,0,0,0,0
4670000,2393000,2,0,0,0,0,0,0,0,0,0,0,0,0,0,0
4670000,2398000,1,0,0,0,0,0,0,0,0,0,0,0,0,0,0
4670000,2399000,1,0,0,0,0,0,0,0,0,0,0,0,0,0,0
4670000,2402000,15,609,76,533,111,37,82,82,4962,520,4442,1018,257,525,711
4670000,2403000,8,630,6,624,45,461,24,11,5399,36,5363,517,3961,214,77
4670000,2404000,96,40043,1231,38812,6617,22243,3445,1814,304107,6501,297606,56449,176438,24619,12362
4670000,2405000,4,165,3,162,37,34,17,40,1422,15,1407,370,288,121,311
4670000,2413000,1,0,0,0,0,0,0,0,0,0,0,0,0,0,0
4670000,2414000,8,408,4,404,36,21,173,65,2891,32,2859,236,257,1229,379
4670000,2424000,3,187,19,168,14,12,69,9,555,52,503,68,34,248,21
4670000,2429000,6,245,25,220,23,17,98,18,1282,125,1157,128,101,593,104
4670000,2433000,3,108,13,95,8,12,42,6,596,68,528,88,59,172,18
4670000,2451000,2,0,0,0,0,0,0,0,0,0,0,0,0,0,0
4670000,2452000,3,0,0,0,0,0,0,0,0,0,0,0,0,0,0
4670000,2478000,24,14440,3310,11130,690,240,1627,475,23470,5277,18193,1551,318,2473,833
4670000,2479000,11,575,59,516,46,12,66,10,1970,246,1724,212,23,166,15
4670000,2483000,1,0,0,0,0,0,0,0,0,0,0,0,0,0,0
4670000,2485000,4,0,0,0,0,0,0,0,0,0,0,0,0,0,0
4670000,2486000,2,0,0,0,0,0,0,0,0,0,0,0,0,0,0
4671000,2394000,7,289,17,272,62,37,74,31,2262,119,2143,548,360,429,221
4671000,2395000,86,4497,340,4157,710,992,1157,362,38846,2689,36157,7678,8078,9923,3129
4671000,2396000,23,848,54,794,114,109,326,61,5766,255,5511,864,910,2017,446
4671000,2417000,3,91,1,90,21,9,26,6,610,8,602,221,80,135,38
4671000,2418000,2,0,0,0,0,0,0,0,0,0,0,0,0,0,0
4671000,2429000,8,338,37,301,15,37,130,31,1810,185,1625,93,211,690,205
4671000,2433000,3,177,8,169,13,5,81,22,1090,32,1058,127,17,464,169
4671000,2439000,12,448,25,423,132,16,87,46,3118,147,2971,1193,116,475,355
4671000,2450000,3,347,12,335,127,20,79,21,2233,20,2213,1193,87,416,119
4671000,2451000,30,1538,30,1508,448,71,176,62,10577,166,10411,4474,569,1115,425
4671000,2477000,4,149,37,112,9,5,21,9,372,92,280,29,7,78,27
4671000,2478000,19,587,50,537,70,9,70,30,2571,291,2280,336,25,211,145
4671000,2479000,4,201,40,161,51,4,25,10,1128,139,989,400,14,147,26
4671000,2481000,1,0,0,0,0,0,0,0,0,0,0,0,0,0,0
4671000,2483000,2,0,0,0,0,0,0,0,0,0,0,0,0,0,0
4671000,2484000,2,0,0,0,0,0,0,0,0,0,0,0,0,0,0
4671000,2485000,5,282,42,240,49,2,68,19,1078,134,944,326,4,197,59
4671000,2486000,2,0,0,0,0,0,0,0,0,0,0,0,0,0,0
4672000,2450000,22,1604,38,1566,601,59,116,178,11024,255,10769,5644,259,696,1175
4672000,2451000,19,874,16,858,419,57,149,25,7051,95,6956,4221,310,948,169
4672000,2477000,5,279,32,247,47,2,48,12,1113,90,1023,273,4,158,39
4672000,2478000,11,630,104,526,40,7,108,25,2448,262,2186,161,12,333,78
4672000,2480000,1,0,0,0,0,0,0,0,0,0,0,0,0,0,0
4672000,2481000,7,353,73,280,73,3,43,34,1371,221,1150,329,147,132,95
4672000,2482000,7,1262,540,722,146,46,187,76,3399,1134,2265,855,93,357,219
4672000,2483000,2,0,0,0,0,0,0,0,0,0,0,0,0,0,0
4672000,2484000,7,267,20,247,86,1,48,16,1193,41,1152,528,2,145,49
4672000,2485000,2,0,0,0,0,0,0,0,0,0,0,0,0,0,0
4673000,2414000,1,0,0,0,0,0,0,0,0,0,0,0,0,0,0
4673000,2450000,12,682,11,671,372,16,48,121,5418,59,5359,3516,92,376,797
4673000,2476000,58,8768,4517,4251,892,163,717,461,33711,12648,21063,6996,391,2333,2262
4673000,2477000,11,673,69,604,122,10,39,33,5603,201,5402,1130,27,166,245
4673000,2480000,1,0,0,0,0,0,0,0,0,0,0,0,0,0,0
4673000,2481000,3,108,18,90,49,4,10,8,717,39,678,385,124,45,19
4673000,2482000,1,0,0,0,0,0,0,0,0,0,0,0,0,0,0
4673000,2483000,3,1561,1082,479,78,40,101,28,3466,2288,1178,381,64,155,62
4673000,2484000,3,549,167,382,66,4,208,39,1577,548,1029,235,5,480,93
4674000,2392000,2,0,0,0,0,0,0,0,0,0,0,0,0,0,0
4674000,2393000,2,0,0,0,0,0,0,0,0,0,0,0,0,0,0
4674000,2414000,7,211,7,204,35,3,53,18,1404,34,1370,290,15,374,121
4674000,2447000,98,7151,331,6820,1717,1414,929,399,50066,2038,48028,16662,7683,5805,2585
4674000,2448000,3,0,0,0,0,0,0,0,0,0,0,0,0,0,0
4674000,2449000,13,569,5,564,229,13,100,63,4389,21,4368,2165,86,489,646
4674000,2452000,6,0,0,0,0,0,0,0,0,0,0,0,0,0,0
4674000,2455000,4,260,9,251,23,111,45,4,1807,89,1718,177,814,289,4
4674000,2456000,76,9080,367,8713,2178,900,1206,2299,54351,1731,52620,17616,4712,6580,12465
4674000,2475000,5,0,0,0,0,0,0,0,0,0,0,0,0,0,0
4674000,2476000,13,670,73,597,195,7,56,39,4646,623,4023,1562,14,276,219
4674000,2478000,1,0,0,0,0,0,0,0,0,0,0,0,0,0,0
4674000,2481000,1,0,0,0,0,0,0,0,0,0,0,0,0,0,0
4675000,2390000,6,760,192,568,116,66,101,132,4572,1262,3310,883,493,465,599
4675000,2392000,8,915,84,831,113,410,145,45,7038,569,6469,1198,3281,1159,262
4675000,2447000,1,0,0,0,0,0,0,0,0,0,0,0,0,0,0
4675000,2448000,22,1705,63,1642,464,224,221,100,8248,248,8000,3387,770,1148,636
4675000,2451000,7,401,1,400,209,2,43,45,3272,8,3264,1911,14,350,362
4675000,2452000,1,0,0,0,0,0,0,0,0,0,0,0,0,0,0
4675000,2455000,171,9252,476,8776,2110,1628,1165,864,67383,2615,64768,19014,10468,8277,5751
4675000,2456000,4,197,3,194,71,19,27,17,2149,12,2137,871,133,413,239
4675000,2475000,11,350,20,330,70,3,30,20,3095,161,2934,627,17,320,92
4676000,2390000,142,77386,10918,66468,16798,17075,8068,9598,538337,49635,488702,141292,131138,48124,63706
4676000,2391000,79,4907,681,4226,689,441,1190,519,30306,3442,26864,5273,2716,7900,2806
4676000,2392000,19,1228,96,1132,291,155,227,137,8968,427,8541,2813,1033,1549,949
4676000,2449000,5,160,2,158,75,2,6,31,1302,14,1288,634,8,60,256
4676000,2450000,2,0,0,0,0,0,0,0,0,0,0,0,0,0,0
4676000,2451000,1,0,0,0,0,0,0,0,0,0,0,0,0,0,0
4676000,2453000,4,209,3,206,124,2,0,32,1966,21,1945,1169,14,0,270
4676000,2455000,57,0,0,0,0,0,0,0,0,0,0,0,0,0,0
4676000,2456000,2,0,0,0,0,0,0,0,0,0,0,0,0,0,0
4676000,2476000,8,135,33,102,34,7,14,9,698,82,616,277,25,90,35
4676000,2478000,5,200,46,154,11,8,29,5,627,153,474,112,23,67,23
4676000,2479000,1,0,0,0,0,0,0,0,0,0,0,0,0,0,0
4677000,2390000,369,77936,14280,63656,16210,8707,10261,12231,489383,55595,433788,138563,47824,66516,72366
4677000,2391000,31,2012,184,1828,304,430,380,166,15984,862,15122,3037,3542,3061,1263
4677000,2402000,14,0,0,0,0,0,0,0,0,0,0,0,0,0,0
4677000,2448000,13,713,45,668,187,25,146,59,4256,112,4144,1738,67,682,381
4677000,2453000,5,0,0,0,0,0,0,0,0,0,0,0,0,0,0
4677000,2454000,39,0,0,0,0,0,0,0,0,0,0,0,0,0,0
4677000,2455000,1,0,0,0,0,0,0,0,0,0,0,0,0,0,0
4677000,2456000,679,77862,9658,68204,18637,7308,7518,10554,435892,37399,398493,134174,33724,43421,52131
4677000,2457000,13,1231,442,789,32,334,40,27,7405,2288,5117,384,1677,374,206
4677000,2460000,15,0,0,0,0,0,0,0,0,0,0,0,0,0,0
4677000,2475000,1,0,0,0,0,0,0,0,0,0,0,0,0,0,0
4677000,2476000,13,509,36,473,89,2,57,15,2259,84,2175,535,4,272,73
4677000,2477000,3,0,0,0,0,0,0,0,0,0,0,0,0,0,0
4678000,2400000,5,221,12,209,26,87,37,14,1900,72,1828,228,739,268,163
4678000,2402000,4,0,0,0,0,0,0,0,0,0,0,0,0,0,0
4678000,2446000,1,0,0,0,0,0,0,0,0,0,0,0,0,0,0
4678000,2448000,43,3256,118,3138,719,140,739,367,17769,343,17426,5771,476,3913,1885
4678000,2449000,1,0,0,0,0,0,0,0,0,0,0,0,0,0,0
4678000,2454000,18,0,0,0,0,0,0,0,0,0,0,0,0,0,0
4678000,2455000,22,0,0,0,0,0,0,0,0,0,0,0,0,0,0
4678000,2456000,24,1214,88,1126,258,69,195,39,8639,464,8175,2314,435,1438,322
4678000,2457000,64,4116,381,3735,1116,262,620,311,27699,2117,25582,10633,1174,3540,1981
4678000,2459000,77,5631,553,5078,1037,845,586,352,34746,2918,31828,8950,4620,3335,1770
4678000,2460000,245,80637,4263,76374,26723,17971,4639,7737,454169,17195,436974,183046,88290,22479,40949
4678000,2461000,66,14767,955,13812,4164,2081,1029,2619,82420,4342,78078,29590,10512,4898,12465
4678000,2466000,9,17960,2448,15512,1499,961,434,243,76964,9036,67928,5848,4112,1047,895
4678000,2467000,6,334,30,304,63,71,28,17,2202,142,2060,565,482,136,96
4678000,2468000,76,7910,2213,5697,1039,1798,429,335,47923,12923,35000,8592,9240,2786,2025
4678000,2477000,9,336,6,330,146,5,24,33,2446,18,2428,1355,9,107,239
4678000,2488000,1,0,0,0,0,0,0,0,0,0,0,0,0,0,0
4678000,2490000,1,0,0,0,0,0,0,0,0,0,0,0,0,0,0
4678000,2513000,1,0,0,0,0,0,0,0,0,0,0,0,0,0,0
4679000,2388000,5,244,22,222,81,19,47,29,2140,203,1937,865,76,382,254
4679000,2389000,154,39807,11249,28558,5742,3598,5575,6625,231690,61861,169829,43590,18477,29456,36075
4679000,2400000,7,113,6,107,22,10,52,16,1308,34,1274,236,123,656,231
4679000,2447000,9,471,16,455,148,0,88,61,3446,92,3354,1362,0,452,384
4679000,2456000,10,0,0,0,0,0,0,0,0,0,0,0,0,0,0
4679000,2465000,1,0,0,0,0,0,0,0,0,0,0,0,0,0,0
4679000,2466000,38,1750,144,1606,477,122,244,91,10970,907,10063,4179,606,1229,405
4679000,2467000,10,419,26,393,88,65,46,32,3133,226,2907,827,469,402,210
4679000,2472000,54,32957,2670,30287,3026,11322,941,657,134532,13441,121091,12589,47640,2265,2762
4679000,2473000,8,258,13,245,77,14,26,7,1746,73,1673,640,82,152,35
4679000,2477000,2,0,0,0,0,0,0,0,0,0,0,0,0,0,0
4679000,2511000,2,0,0,0,0,0,0,0,0,0,0,0,0,0,0
4680000,2388000,1,0,0,0,0,0,0,0,0,0,0,0,0,0,0
4680000,2445000,7,276,12,264,116,3,42,40,1915,68,1847,976,12,292,194
4680000,2446000,5,0,0,0,0,0,0,0,0,0,0,0,0,0,0
4680000,2455000,20,688,45,643,270,7,116,27,5712,250,5462,2833,47,830,198
4680000,2456000,17,1385,72,1313,516,30,238,128,9303,279,9024,4817,131,943,876
4680000,2470000,1,0,0,0,0,0,0,0,0,0,0,0,0,0,0
4680000,2471000,3,119,1,118,75,0,2,10,1136,7,1129,708,0,14,126
4680000,2472000,13,368,33,335,57,39,34,16,2322,169,2153,648,190,247,82
4680000,2473000,8,2636,1055,1581,242,72,258,93,6735,2762,3973,1190,127,479,365
4680000,2474000,8,527,55,472,118,24,44,51,2256,146,2110,724,98,183,230
4680000,2475000,3,0,0,0,0,0,0,0,0,0,0,0,0,0,0
4680000,2476000,4,131,0,131,100,0,0,2,1338,0,1338,1043,0,0,8
4680000,2510000,2,0,0,0,0,0,0,0,0,0,0,0,0,0,0
4681000,2385000,1,0,0,0,0,0,0,0,0,0,0,0,0,0,0
4681000,2445000,208,49967,1639,48328,13828,10250,5882,4740,290729,8970,281759,97964,54646,29890,27124
4681000,2446000,113,7873,399,7474,1457,341,1688,677,42500,1753,40747,10455,1516,9118,3119
4681000,2455000,9,0,0,0,0,0,0,0,0,0,0,0,0,0,0
4681000,2456000,2,0,0,0,0,0,0,0,0,0,0,0,0,0,0
4681000,2458000,1,0,0,0,0,0,0,0,0,0,0,0,0,0,0
4681000,2459000,6,0,0,0,0,0,0,0,0,0,0,0,0,0,0
4681000,2460000,2,0,0,0,0,0,0,0,0,0,0,0,0,0,0
4681000,2471000,9,262,57,205,44,14,24,19,1923,298,1625,443,56,166,120
4681000,2472000,1,0,0,0,0,0,0,0,0,0,0,0,0,0,0
4681000,2473000,2,0,0,0,0,0,0,0,0,0,0,0,0,0,0
4681000,2474000,1,0,0,0,0,0,0,0,0,0,0,0,0,0,0
4681000,2507000,2,0,0,0,0,0,0,0,0,0,0,0,0,0,0
4681000,2511000,1,0,0,0,0,0,0,0,0,0,0,0,0,0,0
4682000,2385000,1,0,0,0,0,0,0,0,0,0,0,0,0,0,0
4682000,2386000,1,0,0,0,0,0,0,0,0,0,0,0,0,0,0
4682000,2445000,6,22011,803,21208,7628,1366,1464,4858,102500,2199,100301,43398,3846,4927,19310
4682000,2446000,441,59585,2964,56621,14920,2851,8705,8043,329306,11263,318043,105911,13314,44278,40938
4682000,2448000,6,217,17,200,120,13,15,22,1840,76,1764,1129,95,93,153
4682000,2449000,1,0,0,0,0,0,0,0,0,0,0,0,0,0,0
4682000,2454000,4,236,0,236,146,0,17,30,2002,0,2002,1548,0,67,171
4682000,2455000,4,0,0,0,0,0,0,0,0,0,0,0,0,0,0
4682000,2456000,6,169,3,166,111,0,0,17,1591,19,1572,1110,0,0,114
4682000,2457000,4,0,0,0,0,0,0,0,0,0,0,0,0,0,0
4682000,2458000,12,562,0,562,160,58,77,13,3701,0,3701,1597,345,387,57
4682000,2460000,65,4487,199,4288,1304,666,403,308,33833,1119,32714,12467,4335,2898,2139
4682000,2461000,16,0,0,0,0,0,0,0,0,0,0,0,0,0,0
4682000,2470000,5,332,10,322,87,27,37,18,1493,26,1467,743,43,111,96
4682000,2471000,28,0,0,0,0,0,0,0,0,0,0,0,0,0,0
4682000,2474000,12,450,18,432,162,3,34,34,3118,58,3060,1474,10,193,216
4682000,2506000,6,296,251,45,2,9,6,0,702,605,97,3,20,14,0
4682000,2507000,1,0,0,0,0,0,0,0,0,0,0,0,0,0,0
4683000,2383000,11,0,0,0,0,0,0,0,0,0,0,0,0,0,0
4683000,2445000,1,0,0,0,0,0,0,0,0,0,0,0,0,0,0
4683000,2448000,5,344,24,320,105,19,79,16,2214,108,2106,920,69,431,49
4683000,2449000,1,0,0,0,0,0,0,0,0,0,0,0,0,0,0
4683000,2454000,15,778,7,771,411,6,56,82,6347,41,6306,4007,12,308,603
4683000,2455000,7,431,9,422,260,0,1,106,4005,64,3941,2689,0,4,810
4683000,2457000,13,596,29,567,143,12,99,35,3367,75,3292,1315,28,502,153
4683000,2459000,37,4585,178,4407,936,542,272,558,26289,644,25645,7581,3194,1398,2836
4683000,2463000,4,129,0,129,48,7,27,17,974,0,974,481,49,167,94
4683000,2467000,11,480,50,430,127,36,11,32,4247,550,3697,1346,276,81,293
4683000,2468000,63,3315,286,3029,1154,169,161,390,24517,1759,22758,10368,840,1094,2651
4683000,2469000,13,632,181,451,116,34,56,83,3602,582,3020,1108,116,459,520
4683000,2470000,3,0,0,0,0,0,0,0,0,0,0,0,0,0,0
4683000,2472000,5,0,0,0,0,0,0,0,0,0,0,0,0,0,0
4683000,2500000,3,0,0,0,0,0,0,0,0,0,0,0,0,0,0
4683000,2506000,1,0,0,0,0,0,0,0,0,0,0,0,0,0,0
4684000,2447000,5,425,4,421,195,11,14,80,3542,4,3538,1915,77,99,647
4684000,2448000,129,7027,349,6678,2032,729,944,700,47666,1963,45703,18375,4428,5659,4135
4684000,2450000,1,0,0,0,0,0,0,0,0,0,0,0,0,0,0
4684000,2452000,12,597,10,587,337,4,19,93,4778,16,4762,3238,4,89,615
4684000,2453000,2,0,0,0,0,0,0,0,0,0,0,0,0,0,0
4684000,2456000,3,169,0,169,47,0,4,39,1289,0,1289,409,0,44,256
4684000,2457000,13,599,6,593,276,6,58,101,5274,25,5249,2933,54,387,781
4684000,2458000,10,410,3,407,245,19,14,41,3529,9,3520,2432,82,122,279
4684000,2459000,4,0,0,0,0,0,0,0,0,0,0,0,0,0,0
4684000,2460000,60,8323,165,8158,3140,1135,372,1163,48889,1076,47813,20770,6131,1974,7246
4684000,2467000,108,6467,761,5706,1931,276,285,501,45597,4291,41306,17872,1438,1697,2640
4684000,2468000,43,3003,465,2538,846,129,150,229,18943,2482,16461,7076,559,631,1398
4684000,2471000,3,185,25,160,116,0,2,0,1483,39,1444,1247,0,12,0
4685000,2444000,28,2584,120,2464,449,855,177,254,18277,803,17474,3461,5878,1220,1791
4685000,2448000,6,340,0,340,204,13,19,65,2986,0,2986,1932,100,121,511
4685000,2450000,1,0,0,0,0,0,0,0,0,0,0,0,0,0,0
4685000,2452000,1,0,0,0,0,0,0,0,0,0,0,0,0,0,0
4685000,2456000,3,73,0,73,57,0,4,10,699,0,699,561,0,28,96
4685000,2457000,6,270,3,267,128,2,8,56,2397,21,2376,1385,6,96,369
4685000,2459000,2,0,0,0,0,0,0,0,0,0,0,0,0,0,0
4685000,2460000,9,760,22,738,148,210,30,63,5941,181,5760,1532,1604,244,535
4685000,2467000,5,422,37,385,121,9,28,37,2840,163,2677,1033,40,168,312
4685000,2468000,12,512,42,470,120,56,26,20,3707,234,3473,1182,375,146,191
4685000,2470000,3,120,0,120,39,0,6,11,958,0,958,354,0,48,97
4685000,2471000,1,0,0,0,0,0,0,0,0,0,0,0,0,0,0
4686000,2444000,106,8304,552,7752,1627,1570,1196,797,55767,3406,52361,14250,9891,6894,4310
4686000,2445000,221,58899,2522,56377,12990,15739,6161,7722,345000,12319,332681,90588,93176,31613,45602
4686000,2446000,34,5611,495,5116,1613,350,552,1266,23639,1782,21857,7940,1133,2632,4623
4686000,2454000,8,312,4,308,147,18,38,19,2653,32,2621,1577,90,280,153
4686000,2455000,18,912,47,865,259,60,135,70,6159,272,5887,2253,349,839,297
4686000,2457000,4,197,0,197,79,14,20,20,1595,0,1595,737,110,88,141
4686000,2458000,48,2118,63,2055,702,207,293,194,14517,289,14228,6707,1136,1758,1188
4686000,2459000,2,0,0,0,0,0,0,0,0,0,0,0,0,0,0
4686000,2465000,12,697,48,649,163,24,36,45,5168,321,4847,1478,174,320,298
4686000,2466000,14,501,12,489,174,6,36,31,3484,54,3430,1510,18,232,157
4686000,2469000,6,190,3,187,107,0,9,28,1811,12,1799,1177,0,87,224
4686000,2470000,4,99,7,92,27,0,0,7,722,32,690,309,0,0,26
4686000,2476000,4,86,30,56,14,6,6,3,367,64,303,158,14,16,6
4686000,2484000,1,0,0,0,0,0,0,0,0,0,0,0,0,0,0
4686000,2504000,1,0,0,0,0,0,0,0,0,0,0,0,0,0,0
4687000,2369000,3,116,31,85,6,31,17,17,1073,242,831,31,401,160,171
4687000,2370000,2,0,0,0,0,0,0,0,0,0,0,0,0,0,0
4687000,2454000,2,0,0,0,0,0,0,0,0,0,0,0,0,0,0
4687000,2455000,23,1212,61,1151,388,81,157,99,8931,379,8552,3666,452,1198,912
4687000,2456000,1,0,0,0,0,0,0,0,0,0,0,0,0,0,0
4687000,2457000,1,0,0,0,0,0,0,0,0,0,0,0,0,0,0
4687000,2458000,6,154,0,154,45,5,27,15,1343,0,1343,443,25,229,146
4687000,2459000,111,7537,308,7229,1828,661,938,456,54046,1612,52434,17365,3624,6464,3066
4687000,2465000,196,24518,3186,21332,4872,3097,637,1198,150999,14588,136411,40647,16158,3274,7065
4687000,2466000,14,686,190,496,214,16,14,35,5206,1167,4039,2187,81,110,228
4687000,2469000,1,0,0,0,0,0,0,0,0,0,0,0,0,0,0
4687000,2484000,1,0,0,0,0,0,0,0,0,0,0,0,0,0,0
4687000,2500000,1,0,0,0,0,0,0,0,0,0,0,0,0,0,0
4687000,2504000,1,0,0,0,0,0,0,0,0,0,0,0,0,0,0
4688000,2369000,2,0,0,0,0,0,0,0,0,0,0,0,0,0,0
4688000,2370000,7,186,34,152,17,44,44,19,1242,211,1031,96,309,283,152
4688000,2451000,3,308,1,307,207,6,10,35,2594,1,2593,1953,24,47,220
4688000,2452000,1,0,0,0,0,0,0,0,0,0,0,0,0,0,0
4688000,2455000,1,0,0,0,0,0,0,0,0,0,0,0,0,0,0
4688000,2459000,135,15884,314,15570,4362,4146,1261,1164,107011,1741,105270,39257,22743,7056,7638
4688000,2460000,15,1853,39,1814,335,271,149,345,11950,206,11744,2658,1793,753,2118
4688000,2464000,134,30252,6505,23747,3485,1762,520,6354,171243,41600,129643,27476,7669,2027,27727
4688000,2465000,68,3930,472,3458,1265,168,120,122,27964,2371,25593,11984,865,703,761
4688000,2467000,9,0,0,0,0,0,0,0,0,0,0,0,0,0,0
4688000,2468000,14,958,88,870,291,101,41,142,5181,344,4837,2343,365,193,639
4688000,2476000,1,0,0,0,0,0,0,0,0,0,0,0,0,0,0
4688000,2477000,3,0,0,0,0,0,0,0,0,0,0,0,0,0,0
4688000,2490000,7,0,0,0,0,0,0,0,0,0,0,0,0,0,0
4688000,2502000,1,0,0,0,0,0,0,0,0,0,0,0,0,0,0
4689000,2451000,109,7354,257,7097,2693,238,642,905,47984,958,47026,22781,1205,3239,4782
4689000,2452000,47,5961,438,5523,1403,971,532,889,25980,1103,24877,9716,2252,2022,3748
4689000,2462000,23,6336,776,5560,1060,626,180,2017,27954,2962,24992,6268,2412,799,7738
4689000,2463000,507,67706,9313,58393,16378,5675,2760,9742,356856,36318,320538,118686,22172,9556,42808
4689000,2464000,109,22041,3168,18873,3074,970,409,1007,117459,11647,105812,25258,4170,1848,5034
4689000,2466000,2,0,0,0,0,0,0,0,0,0,0,0,0,0,0
4689000,2467000,7,643,125,518,215,19,31,83,3937,400,3537,1859,31,182,621
4689000,2468000,3,101,10,91,41,0,0,19,783,34,749,337,0,0,132
4689000,2477000,2,0,0,0,0,0,0,0,0,0,0,0,0,0,0
4689000,2478000,1,0,0,0,0,0,0,0,0,0,0,0,0,0,0
4689000,2479000,2,0,0,0,0,0,0,0,0,0,0,0,0,0,0
4689000,2489000,10,1418,756,662,117,13,85,10,3229,1698,1531,361,29,135,14
4689000,2490000,5,0,0,0,0,0,0,0,0,0,0,0,0,0,0
4689000,2491000,1,0,0,0,0,0,0,0,0,0,0,0,0,0,0
4690000,2439000,2,0,0,0,0,0,0,0,0,0,0,0,0,0,0
4690000,2462000,218,24340,3581,20759,6169,1409,879,1842,123346,15344,108002,40051,6131,3078,8409
4690000,2463000,218,14199,1405,12794,4021,535,450,1142,93638,6584,87054,34912,2561,2551,6674
4690000,2464000,5,473,4,469,235,2,7,164,3662,12,3650,1990,4,50,1157
4690000,2465000,4,125,59,66,40,4,0,7,1174,442,732,526,12,0,75
4690000,2466000,11,519,0,519,325,0,8,56,4547,0,4547,3121,0,56,375
4690000,2467000,22,1073,10,1063,687,1,39,95,8920,23,8897,6399,2,226,537
4690000,2468000,1,0,0,0,0,0,0,0,0,0,0,0,0,0,0
4690000,2477000,5,986,561,425,144,13,51,13,4094,1402,2692,1500,13,176,43
4690000,2484000,2,0,0,0,0,0,0,0,0,0,0,0,0,0,0
4691000,2438000,27,0,0,0,0,0,0,0,0,0,0,0,0,0,0
4691000,2439000,35,2492,27,2465,432,98,386,326,17082,168,16914,3330,754,2518,2079
4691000,2461000,32,14043,4629,9414,1020,977,556,1228,60540,17137,43403,5446,4426,1838,4249
4691000,2462000,192,19581,6111,13470,3578,848,402,796,116176,25734,90442,31888,4125,2465,4269
4691000,2463000,35,2762,151,2611,1113,62,123,216,17844,520,17324,9206,185,527,1228
4691000,2464000,1,0,0,0,0,0,0,0,0,0,0,0,0,0,0
4691000,2465000,10,380,0,380,263,0,1,15,3660,0,3660,2779,0,14,120
4691000,2466000,8,254,1,253,170,0,0,10,2334,1,2333,1666,0,0,104
4691000,2467000,5,183,0,183,135,0,0,23,1772,0,1772,1310,0,0,207
4691000,2474000,8,432,219,213,53,11,14,0,1521,491,1030,436,14,42,0
4691000,2475000,3,0,0,0,0,0,0,0,0,0,0,0,0,0,0
4691000,2477000,28,4101,2895,1206,116,78,121,56,13290,8308,4982,479,215,279,180
4691000,2478000,6,4336,1387,2949,92,28,130,57,6014,2404,3610,236,47,166,104
4691000,2479000,1,0,0,0,0,0,0,0,0,0,0,0,0,0,0
4691000,2483000,4,630,175,455,118,5,23,13,1685,527,1158,384,7,35,28
4691000,2484000,1,0,0,0,0,0,0,0,0,0,0,0,0,0,0
4692000,2443000,1,0,0,0,0,0,0,0,0,0,0,0,0,0,0
4692000,2460000,65,37318,3118,34200,7079,10139,1655,1466,171839,17264,154575,30374,46174,4747,5885
4692000,2461000,369,63181,10943,52238,10774,7681,2399,8192,318420,55977,262443,68571,35047,8778,31278
4692000,2463000,4,0,0,0,0,0,0,0,0,0,0,0,0,0,0
4692000,2464000,13,319,36,283,143,0,14,8,2720,230,2490,1575,0,68,34
4692000,2465000,2,0,0,0,0,0,0,0,0,0,0,0,0,0,0
4692000,2466000,2,0,0,0,0,0,0,0,0,0,0,0,0,0,0
4692000,2479000,5,0,0,0,0,0,0,0,0,0,0,0,0,0,0
4692000,2483000,1,0,0,0,0,0,0,0,0,0,0,0,0,0,0
4692000,2501000,1,0,0,0,0,0,0,0,0,0,0,0,0,0,0
4693000,2419000,3,306,2,304,70,54,9,69,2340,10,2330,658,443,80,469
4693000,2420000,69,12517,930,11587,2481,1660,832,1444,88856,5764,83092,22430,11527,5581,9588
4693000,2421000,52,3263,96,3167,1183,242,241,447,27702,650,27052,11800,1775,2179,3347
4693000,2422000,46,3372,93,3279,1073,351,157,654,28593,726,27867,11179,2485,1023,4601
4693000,2441000,1,0,0,0,0,0,0,0,0,0,0,0,0,0,0
4693000,2442000,22,1692,113,1579,231,64,359,101,9387,404,8983,1697,226,2072,683
4693000,2443000,14,549,18,531,84,32,130,44,3019,62,2957,693,129,665,228
4693000,2460000,3,83,5,78,31,7,4,4,750,30,720,276,161,16,52
4693000,2461000,1,0,0,0,0,0,0,0,0,0,0,0,0,0,0
4693000,2463000,9,535,57,478,343,0,10,53,4441,100,4341,3211,0,100,421
4693000,2464000,11,361,0,361,253,0,16,17,3434,0,3434,2587,0,148,102
4693000,2480000,2,0,0,0,0,0,0,0,0,0,0,0,0,0,0
4693000,2481000,1,0,0,0,0,0,0,0,0,0,0,0,0,0,0
4693000,2482000,1,0,0,0,0,0,0,0,0,0,0,0,0,0,0
4693000,2483000,6,346,251,95,2,5,15,5,733,496,237,4,7,15,5
4694000,2417000,5,598,8,590,123,54,126,97,4745,41,4704,1161,355,969,958
4694000,2418000,3,166,1,165,28,10,25,13,1229,2,1227,284,34,205,98
4694000,2419000,23,1383,23,1360,463,59,72,111,11665,134,11531,4819,534,708,803
4694000,2420000,59,4049,86,3963,1708,166,238,488,34067,731,33336,17977,1134,1633,3731
4694000,2421000,95,5346,138,5208,2773,226,431,828,48287,756,47531,29816,1757,3359,6163
4694000,2422000,39,2432,69,2363,1246,113,214,272,22097,418,21679,12918,886,2122,2079
4694000,2425000,28,2132,73,2059,961,125,128,145,17443,491,16952,8602,1013,1195,1000
4694000,2426000,3,235,16,219,72,13,14,18,2081,135,1946,686,143,76,178
4694000,2427000,1,0,0,0,0,0,0,0,0,0,0,0,0,0,0
4694000,2440000,22,2040,90,1950,373,109,382,94,10544,316,10228,2948,542,1714,426
4694000,2441000,45,3915,312,3603,330,250,668,205,19137,1083,18054,2278,853,3204,934
4694000,2461000,3,74,0,74,47,0,0,0,655,0,655,466,0,0,0
4694000,2462000,6,311,5,306,108,6,16,62,2543,41,2502,1046,26,106,471
4694000,2463000,5,176,5,171,143,0,6,7,1706,15,1691,1492,0,32,49
4695000,2373000,4,0,0,0,0,0,0,0,0,0,0,0,0,0,0
4695000,2374000,85,2562,820,1742,193,531,262,352,22503,6412,16091,1910,5316,2167,3834
4695000,2375000,1,0,0,0,0,0,0,0,0,0,0,0,0,0,0
4695000,2416000,2,0,0,0,0,0,0,0,0,0,0,0,0,0,0
4695000,2417000,24,3869,391,3478,652,445,467,491,29354,2528,26826,6154,3185,3525,3645
4695000,2418000,19,984,25,959,316,35,136,108,8086,184,7902,3313,276,1057,749
4695000,2419000,28,1353,93,1260,573,30,162,56,10876,532,10344,5293,159,1421,452
4695000,2420000,5,232,3,229,149,7,18,15,1939,15,1924,1365,68,113,101
4695000,2421000,57,3124,133,2991,1149,128,317,305,24757,747,24010,11149,826,2496,2186
4695000,2422000,27,2153,53,2100,674,78,230,248,14898,212,14686,6701,465,1333,1629
4695000,2424000,46,4768,189,4579,1877,176,202,438,35263,879,34384,17181,1081,1335,2863
4695000,2425000,191,15080,566,14514,5784,660,745,1244,116753,3717,113036,52184,4450,5637,7801
4695000,2426000,1,0,0,0,0,0,0,0,0,0,0,0,0,0,0
4695000,2439000,156,14462,415,14047,2610,835,1096,2669,91968,2099,89869,20668,4487,5634,15299
4695000,2440000,176,16740,576,16164,3530,963,1953,2094,109296,3145,106151,28790,5137,11858,12205
4695000,2441000,27,2065,115,1950,272,121,434,145,11329,406,10923,2073,490,2136,649
4695000,2460000,1,0,0,0,0,0,0,0,0,0,0,0,0,0,0
4695000,2461000,5,199,29,170,90,0,2,39,1697,45,1652,995,0,20,295
4695000,2462000,14,439,6,433,204,15,16,64,3667,12,3655,1945,70,154,399
4695000,2463000,2,0,0,0,0,0,0,0,0,0,0,0,0,0,0
4696000,2374000,16,449,183,266,24,120,29,35,3800,1411,2389,248,1154,208,340
4696000,2409000,74,11932,2294,9638,1340,1680,1321,1270,67082,7885,59197,10944,10249,8635,7072
4696000,2410000,1,0,0,0,0,0,0,0,0,0,0,0,0,0,0
4696000,2417000,2,0,0,0,0,0,0,0,0,0,0,0,0,0,0
4696000,2418000,51,3168,148,3020,928,124,516,274,24920,914,24006,9964,780,3711,1982
4696000,2420000,9,477,51,426,118,4,52,8,3837,327,3510,1252,16,427,77
4696000,2421000,3,299,7,292,97,7,35,33,2506,20,2486,997,49,209,259
4696000,2424000,152,66803,2467,64336,23369,4599,2918,10750,515032,14641,500391,217751,34847,20272,73625
4696000,2425000,36,2591,78,2513,1077,112,122,300,19712,381,19331,9655,786,976,1884
4696000,2440000,423,127785,6960,120825,26254,16781,12175,22959,722336,25390,696946,185655,78690,65634,118408
4696000,2458000,30,0,0,0,0,0,0,0,0,0,0,0,0,0,0
4696000,2460000,3,53,0,53,39,0,0,0,550,0,550,406,0,0,0
4696000,2461000,27,719,20,699,368,4,45,49,6230,158,6072,3383,4,360,305
4696000,2462000,1,0,0,0,0,0,0,0,0,0,0,0,0,0,0
4696000,2487000,11,6209,2516,3693,148,72,317,81,10433,5316,5117,225,103,464,119
4696000,2488000,4,103,72,31,5,2,11,0,204,128,76,8,2,19,0
4696000,2489000,3,0,0,0,0,0,0,0,0,0,0,0,0,0,0
4697000,2409000,5,141,25,116,16,0,14,14,1109,138,971,163,0,154,74
4697000,2417000,126,8365,746,7619,2588,390,1258,1368,63633,3119,60514,26153,2547,9346,9286
4697000,2418000,73,4133,358,3775,1115,154,851,301,30211,2308,27903,10261,1062,5852,1938
4697000,2419000,7,0,0,0,0,0,0,0,0,0,0,0,0,0,0
4697000,2420000,3,191,4,187,104,5,8,22,1620,23,1597,979,25,60,169
4697000,2424000,1,0,0,0,0,0,0,0,0,0,0,0,0,0,0
4697000,2440000,38,2354,57,2297,516,105,315,549,16229,319,15910,4299,666,2203,3640
4697000,2458000,151,8328,995,7333,1920,375,434,382,54511,5290,49221,16898,1806,2717,2052
4697000,2459000,6,253,26,227,70,23,17,6,1795,102,1693,529,163,90,25
4697000,2460000,1,0,0,0,0,0,0,0,0,0,0,0,0,0,0
4697000,2467000,1,0,0,0,0,0,0,0,0,0,0,0,0,0,0
4697000,2479000,2,0,0,0,0,0,0,0,0,0,0,0,0,0,0
4697000,2487000,1,0,0,0,0,0,0,0,0,0,0,0,0,0,0
4697000,2488000,7,1242,658,584,54,64,93,32,2455,1359,1096,72,169,102,119
4697000,2495000,1,0,0,0,0,0,0,0,0,0,0,0,0,0,0
4697000,2496000,4,0,0,0,0,0,0,0,0,0,0,0,0,0,0
4698000,2409000,2,0,0,0,0,0,0,0,0,0,0,0,0,0,0
4698000,2416000,28,2679,404,2275,620,100,353,403,14878,2305,12573,4268,515,1931,2024
4698000,2417000,234,33402,5112,28290,9337,2074,3734,4373,178444,19877,158567,64898,8776,21420,21006
4698000,2418000,41,1702,139,1563,485,55,378,144,12785,691,12094,4717,347,2818,1138
4698000,2457000,14,12794,3441,9353,375,999,142,972,68203,12738,55465,2301,3595,310,3801
4698000,2458000,384,27418,4211,23207,6162,1213,1405,2054,174082,20543,153539,54082,5228,7857,9535
4698000,2480000,1,0,0,0,0,0,0,0,0,0,0,0,0,0,0
4699000,2405000,5,0,0,0,0,0,0,0,0,0,0,0,0,0,0
4699000,2406000,5,312,18,294,24,51,64,28,2372,113,2259,217,376,464,248
4699000,2416000,154,39502,2051,37451,13362,4321,2832,6328,267053,8340,258713,107676,32014,17706,36571
4699000,2417000,72,4719,314,4405,1422,306,690,446,33174,1846,31328,12341,2036,4470,3019
4699000,2418000,5,322,2,320,124,0,59,15,2789,17,2772,1352,0,528,123
4699000,2457000,75,8739,3894,4845,1196,361,256,239,52463,17719,34744,10846,2156,1742,1404
4699000,2458000,19,765,42,723,230,32,29,57,5643,185,5458,2193,185,235,330
4699000,2480000,2,0,0,0,0,0,0,0,0,0,0,0,0,0,0
4699000,2486000,2,0,0,0,0,0,0,0,0,0,0,0,0,0,0
4699000,2495000,2,0,0,0,0,0,0,0,0,0,0,0,0,0,0
4700000,2415000,56,3770,218,3552,1404,321,326,481,30738,1336,29402,15158,2210,2254,3049
4700000,2416000,104,5647,314,5333,2117,496,468,704,46231,2074,44157,21763,3794,3696,4511
4700000,2417000,5,141,11,130,46,9,32,26,987,49,938,455,41,194,159
4700000,2457000,93,9606,533,9073,3122,631,822,607,54061,1945,52116,23000,2657,2976,3280
4700000,2459000,2,0,0,0,0,0,0,0,0,0,0,0,0,0,0
4700000,2464000,1,0,0,0,0,0,0,0,0,0,0,0,0,0,0
4700000,2485000,1,0,0,0,0,0,0,0,0,0,0,0,0,0,0
4700000,2493000,2,0,0,0,0,0,0,0,0,0,0,0,0,0,0
4700000,2494000,1,0,0,0,0,0,0,0,0,0,0,0,0,0,0
4700000,2495000,5,0,0,0,0,0,0,0,0,0,0,0,0,0,0
4701000,2363000,8,174,25,149,22,58,10,7,1494,253,1241,212,553,56,43
4701000,2403000,1,0,0,0,0,0,0,0,0,0,0,0,0,0,0
4701000,2414000,42,2273,46,2227,1106,179,161,316,19709,249,19460,11331,1244,1232,2344
4701000,2415000,159,7905,464,7441,2993,553,772,1019,67987,3182,64805,31393,4239,6647,8150
4701000,2416000,3,52,4,48,10,4,6,2,420,16,404,93,28,46,8
4701000,2457000,18,1547,115,1432,393,66,40,168,9878,423,9455,3422,389,173,912
4701000,2459000,1,0,0,0,0,0,0,0,0,0,0,0,0,0,0
4701000,2479000,2,0,0,0,0,0,0,0,0,0,0,0,0,0,0
4701000,2481000,2,0,0,0,0,0,0,0,0,0,0,0,0,0,0
4702000,2363000,14,305,39,266,24,110,50,20,2657,278,2379,251,1121,452,167
4702000,2374000,3,37,4,33,0,9,20,0,405,60,345,0,44,259,0
4702000,2375000,13,156,38,118,8,60,6,13,1653,414,1239,36,612,60,175
4702000,2401000,1,0,0,0,0,0,0,0,0,0,0,0,0,0,0
4702000,2402000,2,0,0,0,0,0,0,0,0,0,0,0,0,0,0
4702000,2413000,43,2116,96,2020,948,167,199,251,18254,716,17538,9662,1402,1517,1837
4702000,2414000,133,7521,252,7269,3266,588,685,1263,63980,1547,62433,34456,4408,5285,8809
4702000,2415000,6,151,42,109,49,7,7,10,1414,424,990,474,54,92,101
4702000,2455000,86,24616,644,23972,7252,1790,2282,1443,115718,2683,113035,36296,7988,9014,6776
4702000,2456000,39,2554,131,2423,555,193,175,148,17744,670,17074,5211,1032,1077,974
4702000,2459000,4,0,0,0,0,0,0,0,0,0,0,0,0,0,0
4702000,2461000,1,0,0,0,0,0,0,0,0,0,0,0,0,0,0
4702000,2478000,4,396,309,87,2,40,6,2,803,568,235,6,77,12,12
4702000,2479000,4,126,83,43,3,0,2,0,355,198,157,14,0,2,0
4702000,2480000,4,334,308,26,4,3,0,8,774,684,90,28,8,0,24
4702000,2483000,1,0,0,0,0,0,0,0,0,0,0,0,0,0,0
4702000,2495000,2,0,0,0,0,0,0,0,0,0,0,0,0,0,0
4702000,2496000,4,160,100,60,11,0,4,0,765,328,437,75,0,19,0
4703000,2401000,3,0,0,0,0,0,0,0,0,0,0,0,0,0,0
4703000,2402000,50,0,0,0,0,0,0,0,0,0,0,0,0,0,0
4703000,2413000,19,1016,94,922,347,76,86,50,9092,669,8423,3887,578,650,450
4703000,2414000,6,391,118,273,43,32,22,17,2373,741,1632,415,177,124,62
4703000,2453000,2,0,0,0,0,0,0,0,0,0,0,0,0,0,0
4703000,2454000,17,653,24,629,165,32,33,48,4757,146,4611,1509,183,233,273
4703000,2455000,2,0,0,0,0,0,0,0,0,0,0,0,0,0,0
4703000,2456000,6,0,0,0,0,0,0,0,0,0,0,0,0,0,0
4703000,2477000,1,0,0,0,0,0,0,0,0,0,0,0,0,0,0
4703000,2488000,1,0,0,0,0,0,0,0,0,0,0,0,0,0,0
4703000,2497000,1,0,0,0,0,0,0,0,0,0,0,0,0,0,0
4704000,2464000,1,0,0,0,0,0,0,0,0,0,0,0,0,0,0
4704000,2465000,4,0,0,0,0,0,0,0,0,0,0,0,0,0,0
4704000,2477000,2,0,0,0,0,0,0,0,0,0,0,0,0,0,0
4704000,2485000,1,0,0,0,0,0,0,0,0,0,0,0,0,0,0
4704000,2493000,2,0,0,0,0,0,0,0,0,0,0,0,0,0,0
4704000,2497000,3,0,0,0,0,0,0,0,0,0,0,0,0,0,0
4705000,2361000,1,0,0,0,0,0,0,0,0,0,0,0,0,0,0
4705000,2448000,1,0,0,0,0,0,0,0,0,0,0,0,0,0,0
4705000,2449000,13,1815,35,1780,448,94,267,85,9998,210,9788,2890,480,1284,523
4705000,2478000,5,65,54,11,3,0,2,0,313,244,69,21,0,12,0
4705000,2492000,4,0,0,0,0,0,0,0,0,0,0,0,0,0,0
4705000,2498000,1,0,0,0,0,0,0,0,0,0,0,0,0,0,0
4705000,2499000,1,0,0,0,0,0,0,0,0,0,0,0,0,0,0
4706000,2445000,3,0,0,0,0,0,0,0,0,0,0,0,0,0,0
4706000,2446000,5,454,5,449,89,11,19,21,2522,5,2517,636,58,98,116
4706000,2447000,14,1479,8,1471,524,48,138,94,7498,33,7465,3227,176,607,496
4706000,2448000,1,0,0,0,0,0,0,0,0,0,0,0,0,0,0
4706000,2478000,4,451,356,95,14,6,14,7,1266,850,416,147,9,21,8
4706000,2497000,1,0,0,0,0,0,0,0,0,0,0,0,0,0,0
4707000,2350000,1,0,0,0,0,0,0,0,0,0,0,0,0,0,0
4707000,2358000,13,348,44,304,29,131,25,37,3211,348,2863,260,1378,348,358
4707000,2422000,19,775,16,759,210,45,51,111,5881,70,5811,1898,340,361,722
4707000,2424000,24,0,0,0,0,0,0,0,0,0,0,0,0,0,0
4707000,2443000,501,44988,1124,43864,10394,918,4487,2589,192643,3506,189137,62224,3580,15114,8765
4707000,2444000,4,106,0,106,65,11,2,6,870,0,870,650,53,6,28
4707000,2445000,14,602,3,599,238,11,42,65,4907,5,4902,2461,69,236,414
4707000,2446000,4,0,0,0,0,0,0,0,0,0,0,0,0,0,0
4707000,2456000,3,73,0,73,44,0,0,8,706,0,706,500,0,0,53
4707000,2485000,1,0,0,0,0,0,0,0,0,0,0,0,0,0,0
4707000,2489000,2,0,0,0,0,0,0,0,0,0,0,0,0,0,0
4707000,2501000,2,0,0,0,0,0,0,0,0,0,0,0,0,0,0
4708000,2358000,1,0,0,0,0,0,0,0,0,0,0,0,0,0,0
4708000,2395000,9,650,31,619,109,45,229,34,3647,144,3503,603,295,1356,178
4708000,2396000,987,86790,2801,83989,20742,2833,20406,7177,480897,11799,469098,119389,16219,127239,32837
4708000,2399000,41,2283,85,2198,253,226,265,90,15922,697,15225,2570,1889,1943,775
4708000,2400000,9,701,21,680,30,82,13,20,5558,227,5331,327,768,112,146
4708000,2428000,36,1713,63,1650,220,65,168,308,11098,260,10838,1529,354,1204,2101
4708000,2442000,1,0,0,0,0,0,0,0,0,0,0,0,0,0,0
4708000,2443000,15,1644,37,1607,273,36,170,88,5876,146,5730,1336,140,540,239
4708000,2485000,15,4779,1666,3113,219,41,576,77,7551,3777,3774,320,92,694,116
4708000,2486000,1,0,0,0,0,0,0,0,0,0,0,0,0,0,0
4708000,2487000,1,0,0,0,0,0,0,0,0,0,0,0,0,0,0
4708000,2491000,2,0,0,0,0,0,0,0,0,0,0,0,0,0,0
4709000,2349000,27,4844,548,4296,1461,677,583,426,30953,3416,27537,9128,5833,3770,2338
4709000,2358000,1,0,0,0,0,0,0,0,0,0,0,0,0,0,0
4709000,2394000,27,9108,457,8651,1474,499,1339,1253,39996,1295,38701,7643,1792,7011,4474
4709000,2395000,123,0,0,0,0,0,0,0,0,0,0,0,0,0,0
4709000,2396000,44,4224,118,4106,840,125,1066,472,22949,410,22539,5026,530,6569,2080
4709000,2397000,42,3139,185,2954,350,552,465,150,23650,1484,22166,3242,4358,3083,1001
4709000,2398000,112,6210,356,5854,715,1382,861,239,46882,3044,43838,6632,10597,5856,1613
4709000,2399000,4,161,5,156,0,62,10,0,1258,40,1218,0,565,95,0
4709000,2412000,21,0,0,0,0,0,0,0,0,0,0,0,0,0,0
4709000,2413000,1,0,0,0,0,0,0,0,0,0,0,0,0,0,0
4709000,2414000,44,1049,52,997,180,370,61,80,7708,234,7474,1650,2680,304,496
4709000,2421000,1,0,0,0,0,0,0,0,0,0,0,0,0,0,0
4709000,2422000,1,0,0,0,0,0,0,0,0,0,0,0,0,0,0
4709000,2436000,8,327,3,324,64,12,34,20,1983,4,1979,549,91,216,131
4709000,2437000,133,17748,651,17097,5085,635,1110,953,77258,1553,75705,27280,2915,4174,3963
4709000,2441000,2,0,0,0,0,0,0,0,0,0,0,0,0,0,0
4709000,2446000,1,0,0,0,0,0,0,0,0,0,0,0,0,0,0
4709000,2452000,1,0,0,0,0,0,0,0,0,0,0,0,0,0,0
4710000,2348000,2,0,0,0,0,0,0,0,0,0,0,0,0,0,0
4710000,2349000,18,2653,297,2356,669,220,347,272,20210,2083,18127,6088,1960,2445,2196
4710000,2357000,2,0,0,0,0,0,0,0,0,0,0,0,0,0,0
4710000,2392000,1,0,0,0,0,0,0,0,0,0,0,0,0,0,0
4710000,2393000,218,8976,809,8167,687,2430,1599,587,55469,5646,49823,4019,18939,9237,2576
4710000,2394000,3,0,0,0,0,0,0,0,0,0,0,0,0,0,0
4710000,2395000,21,4758,134,4624,615,97,613,402,21338,377,20961,3297,470,3406,1597
4710000,2397000,16,419,59,360,54,42,76,17,3385,538,2847,514,345,588,95
4710000,2411000,1,0,0,0,0,0,0,0,0,0,0,0,0,0,0
4710000,2437000,4,298,0,298,131,5,20,12,2487,0,2487,1474,30,124,104
4710000,2439000,4,710,10,700,155,18,45,18,3844,18,3826,1220,73,275,72
4710000,2440000,1,0,0,0,0,0,0,0,0,0,0,0,0,0,0
4710000,2447000,5,133,4,129,83,6,7,3,1019,8,1011,697,36,32,21
4710000,2450000,1,0,0,0,0,0,0,0,0,0,0,0,0,0,0
4710000,2496000,1,0,0,0,0,0,0,0,0,0,0,0,0,0,0
4711000,2349000,2,0,0,0,0,0,0,0,0,0,0,0,0,0,0
4711000,2357000,15,279,34,245,22,99,13,36,2654,314,2340,255,1015,117,433
4711000,2392000,43,0,0,0,0,0,0,0,0,0,0,0,0,0,0
4711000,2411000,1,0,0,0,0,0,0,0,0,0,0,0,0,0,0
4711000,2444000,2,0,0,0,0,0,0,0,0,0,0,0,0,0,0
4712000,2349000,7,0,0,0,0,0,0,0,0,0,0,0,0,0,0
4712000,2386000,3,0,0,0,0,0,0,0,0,0,0,0,0,0,0
4712000,2387000,22,1723,56,1667,83,263,75,31,13919,415,13504,871,2206,543,262
4712000,2394000,3,0,0,0,0,0,0,0,0,0,0,0,0,0,0
4712000,2395000,21,0,0,0,0,0,0,0,0,0,0,0,0,0,0
4712000,2434000,2,0,0,0,0,0,0,0,0,0,0,0,0,0,0
4712000,2491000,1,0,0,0,0,0,0,0,0,0,0,0,0,0,0
4712000,2494000,1,0,0,0,0,0,0,0,0,0,0,0,0,0,0
4712000,2495000,1,0,0,0,0,0,0,0,0,0,0,0,0,0,0
4713000,2349000,11,485,110,375,52,51,88,42,3050,501,2549,396,353,652,288
4713000,2386000,253,16919,1148,15771,1554,3245,1550,529,138490,8557,129933,15604,27509,12309,3978
4713000,2387000,2,0,0,0,0,0,0,0,0,0,0,0,0,0,0
4713000,2441000,1,0,0,0,0,0,0,0,0,0,0,0,0,0,0
4713000,2486000,4,0,0,0,0,0,0,0,0,0,0,0,0,0,0
4714000,2349000,24,6497,2102,4395,700,1545,300,839,41887,13779,28108,4977,9955,1822,5319
4714000,2351000,6,192,31,161,11,73,10,11,1651,250,1401,139,727,32,96
4714000,2352000,3,59,4,55,9,17,9,3,915,42,873,261,160,93,51
4714000,2393000,10,1661,83,1578,124,182,195,185,8193,502,7691,550,1283,876,827
4714000,2394000,32,2620,165,2455,308,745,321,122,17313,1030,16283,2766,5683,1858,661
4714000,2438000,2,0,0,0,0,0,0,0,0,0,0,0,0,0,0
4714000,2440000,1,0,0,0,0,0,0,0,0,0,0,0,0,0,0
4714000,2448000,1,0,0,0,0,0,0,0,0,0,0,0,0,0,0
4714000,2473000,1,0,0,0,0,0,0,0,0,0,0,0,0,0,0
4714000,2491000,1,0,0,0,0,0,0,0,0,0,0,0,0,0,0
4715000,2385000,27,0,0,0,0,0,0,0,0,0,0,0,0,0,0
4715000,2386000,13,919,43,876,113,211,242,91,6980,251,6729,995,1693,1957,578
4715000,2389000,5,172,7,165,26,2,49,5,1211,29,1182,208,8,350,54
4715000,2390000,12,2191,106,2085,378,669,302,155,11917,616,11301,1873,4281,1332,1026
4715000,2392000,48,3503,84,3419,358,1663,357,98,27200,620,26580,3928,13048,2495,580
4715000,2393000,15,986,16,970,60,547,42,23,8006,83,7923,584,4463,323,86
4715000,2401000,14,926,10,916,273,35,52,76,7461,61,7400,2908,420,383,472
4715000,2431000,2,0,0,0,0,0,0,0,0,0,0,0,0,0,0
4715000,2442000,1,0,0,0,0,0,0,0,0,0,0,0,0,0,0
4715000,2472000,7,177,113,64,25,4,28,3,826,445,381,284,21,55,8
4715000,2491000,1,0,0,0,0,0,0,0,0,0,0,0,0,0,0
4716000,2346000,1,0,0,0,0,0,0,0,0,0,0,0,0,0,0
4716000,2347000,8,0,0,0,0,0,0,0,0,0,0,0,0,0,0
4716000,2385000,11,0,0,0,0,0,0,0,0,0,0,0,0,0,0
4716000,2386000,14,1122,26,1096,156,157,256,167,8832,128,8704,1438,1160,2278,1121
4716000,2388000,1,0,0,0,0,0,0,0,0,0,0,0,0,0,0
4716000,2392000,3,0,0,0,0,0,0,0,0,0,0,0,0,0,0
4716000,2393000,1,0,0,0,0,0,0,0,0,0,0,0,0,0,0
4716000,2436000,1,0,0,0,0,0,0,0,0,0,0,0,0,0,0
4716000,2470000,1,0,0,0,0,0,0,0,0,0,0,0,0,0,0
4716000,2488000,1,0,0,0,0,0,0,0,0,0,0,0,0,0,0
4717000,2392000,49,3399,198,3201,266,1017,433,102,22349,1126,21223,2159,7104,2821,575
4717000,2465000,1,0,0,0,0,0,0,0,0,0,0,0,0,0,0
4717000,2471000,3,53,32,21,4,0,6,0,177,86,91,20,0,12,0
4717000,2486000,1,0,0,0,0,0,0,0,0,0,0,0,0,0,0
4717000,2499000,3,0,0,0,0,0,0,0,0,0,0,0,0,0,0
4718000,2497000,1,0,0,0,0,0,0,0,0,0,0,0,0,0,0
4718000,2498000,1,0,0,0,0,0,0,0,0,0,0,0,0,0,0
4719000,2390000,3,0,0,0,0,0,0,0,0,0,0,0,0,0,0
4719000,2391000,1,0,0,0,0,0,0,0,0,0,0,0,0,0,0
4719000,2487000,4,0,0,0,0,0,0,0,0,0,0,0,0,0,0
4719000,2489000,1,0,0,0,0,0,0,0,0,0,0,0,0,0,0
4720000,2385000,1,0,0,0,0,0,0,0,0,0,0,0,0,0,0
4720000,2386000,32,1361,66,1295,137,18,40,47,11430,492,10938,1443,224,311,358
4720000,2390000,71,4870,160,4710,533,1848,572,210,37395,1038,36357,4397,14401,3992,1435
4720000,2425000,11,3545,1589,1956,211,133,194,46,5991,2924,3067,396,213,272,87
4721000,2342000,2,0,0,0,0,0,0,0,0,0,0,0,0,0,0
4721000,2343000,1,0,0,0,0,0,0,0,0,0,0,0,0,0,0
4721000,2384000,21,909,86,823,133,59,159,37,6898,607,6291,1281,347,1028,278
4721000,2385000,5,0,0,0,0,0,0,0,0,0,0,0,0,0,0
4721000,2396000,159,9513,210,9303,3678,255,235,1067,77937,1373,76564,36516,1481,1406,8276
4721000,2425000,1,0,0,0,0,0,0,0,0,0,0,0,0,0,0
4721000,2493000,1,0,0,0,0,0,0,0,0,0,0,0,0,0,0
4722000,2342000,11,0,0,0,0,0,0,0,0,0,0,0,0,0,0
4722000,2343000,1,0,0,0,0,0,0,0,0,0,0,0,0,0,0
4722000,2349000,1,0,0,0,0,0,0,0,0,0,0,0,0,0,0
4722000,2379000,5,0,0,0,0,0,0,0,0,0,0,0,0,0,0
4722000,2380000,1,0,0,0,0,0,0,0,0,0,0,0,0,0,0
4722000,2383000,56,3697,366,3331,300,192,322,121,26898,2192,24706,2652,1309,2359,815
4722000,2384000,430,41565,3755,37810,3601,4284,6406,3290,265306,20478,244828,28326,25468,39926,18388
4722000,2425000,1,0,0,0,0,0,0,0,0,0,0,0,0,0,0
4722000,2437000,2,0,0,0,0,0,0,0,0,0,0,0,0,0,0
4722000,2483000,2,0,0,0,0,0,0,0,0,0,0,0,0,0,0
4722000,2493000,1,0,0,0,0,0,0,0,0,0,0,0,0,0,0
4723000,2341000,16,707,91,616,64,115,102,49,5599,539,5060,597,1078,677,424
4723000,2379000,5,124,30,94,14,20,13,0,1158,195,963,152,182,110,0
4723000,2383000,40,3225,327,2898,266,210,385,154,19879,2131,17748,2205,1418,2376,930
4723000,2384000,37,3280,180,3100,275,206,528,212,21195,874,20321,1851,1017,3345,1485
4723000,2385000,8,496,20,476,38,20,110,13,3142,90,3052,288,79,705,61
4723000,2426000,1,0,0,0,0,0,0,0,0,0,0,0,0,0,0
4724000,2341000,2,0,0,0,0,0,0,0,0,0,0,0,0,0,0
4724000,2351000,7,0,0,0,0,0,0,0,0,0,0,0,0,0,0
4724000,2366000,5,202,19,183,17,34,0,8,1295,87,1208,123,262,0,41
4724000,2368000,1,0,0,0,0,0,0,0,0,0,0,0,0,0,0
4724000,2369000,10,488,67,421,87,21,4,18,3676,344,3332,906,119,40,115
4724000,2370000,4,321,39,282,104,45,2,10,2866,350,2516,1219,372,4,78
4724000,2383000,10,381,58,323,43,13,81,15,2498,299,2199,431,53,541,201
4724000,2384000,22,1339,130,1209,93,78,311,29,9721,819,8902,738,590,2112,218
4724000,2393000,115,0,0,0,0,0,0,0,0,0,0,0,0,0,0
4724000,2395000,1,0,0,0,0,0,0,0,0,0,0,0,0,0,0
4724000,2445000,3,0,0,0,0,0,0,0,0,0,0,0,0,0,0
4725000,2366000,10,392,29,363,107,34,6,24,3557,213,3344,1196,222,94,231
4725000,2367000,3,115,8,107,15,10,2,3,957,56,901,193,80,26,18
4725000,2369000,8,327,52,275,49,4,10,45,2818,338,2480,556,32,70,411
4725000,2379000,21,1082,66,1016,157,156,76,99,9005,432,8573,1528,1272,498,752
4725000,2393000,1,0,0,0,0,0,0,0,0,0,0,0,0,0,0
4725000,2394000,1,0,0,0,0,0,0,0,0,0,0,0,0,0,0
4725000,2439000,1,0,0,0,0,0,0,0,0,0,0,0,0,0,0
4725000,2472000,4,0,0,0,0,0,0,0,0,0,0,0,0,0,0
4725000,2478000,1,0,0,0,0,0,0,0,0,0,0,0,0,0,0
4725000,2492000,2,0,0,0,0,0,0,0,0,0,0,0,0,0,0
4726000,2339000,8,120,13,107,9,45,16,4,1246,130,1116,109,506,206,36
4726000,2366000,8,305,18,287,74,34,1,25,2704,148,2556,733,249,30,210
4726000,2367000,18,1347,108,1239,172,291,14,55,10512,856,9656,1377,2059,93,434
4726000,2368000,21,880,78,802,230,83,15,31,7360,504,6856,2435,649,113,212
4726000,2369000,15,918,138,780,114,71,12,24,7144,976,6168,1252,556,95,168
4726000,2379000,13,0,0,0,0,0,0,0,0,0,0,0,0,0,0
4726000,2393000,2,0,0,0,0,0,0,0,0,0,0,0,0,0,0
4726000,2427000,1,0,0,0,0,0,0,0,0,0,0,0,0,0,0
4726000,2428000,1,0,0,0,0,0,0,0,0,0,0,0,0,0,0
4726000,2476000,1,0,0,0,0,0,0,0,0,0,0,0,0,0,0
4727000,2349000,2,0,0,0,0,0,0,0,0,0,0,0,0,0,0
4727000,2350000,157,9965,1540,8425,731,3727,422,377,86753,12693,74060,6773,34719,4480,3037
4727000,2367000,11,1448,221,1227,102,370,15,92,8586,811,7775,859,2324,33,459
4727000,2368000,1346,64664,8666,55998,9754,8504,685,2453,503312,59316,443996,99626,66315,5400,19084
4727000,2369000,5,420,38,382,26,62,8,8,2821,226,2595,211,574,53,120
4727000,2426000,1,0,0,0,0,0,0,0,0,0,0,0,0,0,0
4727000,2444000,1,0,0,0,0,0,0,0,0,0,0,0,0,0,0
4727000,2480000,2,0,0,0,0,0,0,0,0,0,0,0,0,0,0
4727000,2493000,2,0,0,0,0,0,0,0,0,0,0,0,0,0,0
4728000,2348000,1,0,0,0,0,0,0,0,0,0,0,0,0,0,0
4728000,2349000,3,81,9,72,6,41,0,0,577,48,529,70,309,0,0
4728000,2350000,5,355,4,351,43,170,60,30,2775,32,2743,333,1233,661,163
4728000,2367000,7,480,7,473,29,42,0,3,3574,95,3479,255,304,0,12
4728000,2368000,32,2100,316,1784,257,211,46,50,15169,1557,13612,2555,1788,427,343
4728000,2369000,2,0,0,0,0,0,0,0,0,0,0,0,0,0,0
4728000,2373000,205,18628,1854,16774,1616,3525,874,834,138230,13394,124836,14090,27689,5089,6055
4728000,2374000,5,0,0,0,0,0,0,0,0,0,0,0,0,0,0
4728000,2397000,1,0,0,0,0,0,0,0,0,0,0,0,0,0,0
4728000,2426000,1,0,0,0,0,0,0,0,0,0,0,0,0,0,0
4729000,2333000,1,0,0,0,0,0,0,0,0,0,0,0,0,0,0
4729000,2348000,1,0,0,0,0,0,0,0,0,0,0,0,0,0,0
4729000,2349000,3,74,19,55,4,19,0,1,603,174,429,50,142,0,1
4729000,2350000,5,131,38,93,19,36,3,5,1181,383,798,210,257,18,35
4729000,2363000,6,363,33,330,34,24,0,25,2888,271,2617,379,193,0,149
4729000,2364000,4,304,27,277,55,39,0,0,2717,174,2543,597,343,0,0
4729000,2367000,19,1254,168,1086,196,65,7,94,8857,957,7900,1993,504,39,502
4729000,2368000,9,408,19,389,113,8,7,20,3209,134,3075,1027,55,110,166
4729000,2373000,35,1858,216,1642,231,238,125,81,13692,1444,12248,2277,1694,761,672
4729000,2379000,1,0,0,0,0,0,0,0,0,0,0,0,0,0,0
4729000,2475000,2,0,0,0,0,0,0,0,0,0,0,0,0,0,0
4730000,2332000,14,2550,270,2280,140,1010,162,93,19817,1267,18550,1104,7013,906,488
4730000,2333000,1,0,0,0,0,0,0,0,0,0,0,0,0,0,0
4730000,2340000,13,368,55,313,71,129,17,30,3204,389,2815,754,1124,257,193
4730000,2341000,1,0,0,0,0,0,0,0,0,0,0,0,0,0,0
4730000,2348000,1,0,0,0,0,0,0,0,0,0,0,0,0,0,0
4730000,2349000,5,118,26,92,8,44,0,3,943,128,815,68,423,0,42
4730000,2362000,5,286,18,268,28,23,0,8,2701,144,2557,330,230,0,62
4730000,2363000,24,1204,144,1060,272,122,22,50,10426,1184,9242,2928,982,132,344
4730000,2364000,22,1056,39,1017,220,61,31,31,8866,342,8524,2204,437,284,212
4730000,2365000,3,224,8,216,40,35,7,18,1723,56,1667,411,266,25,111
4730000,2367000,20,1187,103,1084,150,106,1,154,8851,746,8105,1687,818,17,952
4730000,2407000,1,0,0,0,0,0,0,0,0,0,0,0,0,0,0
4730000,2430000,1,0,0,0,0,0,0,0,0,0,0,0,0,0,0
4730000,2474000,2,0,0,0,0,0,0,0,0,0,0,0,0,0,0
4730000,2475000,1,0,0,0,0,0,0,0,0,0,0,0,0,0,0
4730000,2495000,1,0,0,0,0,0,0,0,0,0,0,0,0,0,0
4731000,2331000,8,204,29,175,12,62,24,9,1711,217,1494,95,629,188,104
4731000,2340000,7,71,13,58,2,11,0,10,704,125,579,56,155,0,84
4731000,2341000,1,0,0,0,0,0,0,0,0,0,0,0,0,0,0
4731000,2348000,2,0,0,0,0,0,0,0,0,0,0,0,0,0,0
4731000,2349000,1,0,0,0,0,0,0,0,0,0,0,0,0,0,0
4731000,2361000,3,159,0,159,39,4,0,35,991,0,991,264,8,0,245
4731000,2362000,27,1751,76,1675,758,123,17,122,18301,508,17793,9645,927,123,1472
4731000,2363000,21,1167,147,1020,268,120,9,41,9483,942,8541,2808,1077,74,326
4731000,2364000,6,326,35,291,96,4,0,30,2826,205,2621,901,12,0,208
4731000,2365000,15,1019,71,948,236,102,25,73,8438,519,7919,2453,835,125,549
4731000,2407000,1,0,0,0,0,0,0,0,0,0,0,0,0,0,0
4731000,2468000,1,0,0,0,0,0,0,0,0,0,0,0,0,0,0
4731000,2469000,2,0,0,0,0,0,0,0,0,0,0,0,0,0,0
4731000,2470000,4,714,121,593,77,1,66,18,1341,190,1151,147,1,71,100
4731000,2471000,1,0,0,0,0,0,0,0,0,0,0,0,0,0,0
4731000,2472000,5,0,0,0,0,0,0,0,0,0,0,0,0,0,0
4731000,2475000,1,0,0,0,0,0,0,0,0,0,0,0,0,0,0
4731000,2476000,7,7044,1477,5567,282,32,443,142,8585,2329,6256,393,37,632,195
4731000,2496000,1,0,0,0,0,0,0,0,0,0,0,0,0,0,0
4732000,2331000,22,985,101,884,118,273,86,139,7811,570,7241,1044,2707,607,1169
4732000,2332000,2,0,0,0,0,0,0,0,0,0,0,0,0,0,0
4732000,2338000,43,1833,175,1658,401,603,78,186,16527,1391,15136,4106,5807,641,1526
4732000,2361000,303,24629,3322,21307,6287,2466,392,1224,196253,25698,170555,62921,18464,2457,9643
4732000,2362000,16,512,166,346,107,48,2,42,3993,1153,2840,1000,391,14,510
4732000,2364000,2,0,0,0,0,0,0,0,0,0,0,0,0,0,0
4732000,2432000,2,0,0,0,0,0,0,0,0,0,0,0,0,0,0
4732000,2471000,1,0,0,0,0,0,0,0,0,0,0,0,0,0,0
4732000,2472000,1,0,0,0,0,0,0,0,0,0,0,0,0,0,0
4732000,2474000,1,0,0,0,0,0,0,0,0,0,0,0,0,0,0
4732000,2475000,1,0,0,0,0,0,0,0,0,0,0,0,0,0,0
4732000,2496000,1,0,0,0,0,0,0,0,0,0,0,0,0,0,0
4732000,2497000,1,0,0,0,0,0,0,0,0,0,0,0,0,0,0
4733000,2325000,1,0,0,0,0,0,0,0,0,0,0,0,0,0,0
4733000,2330000,3,0,0,0,0,0,0,0,0,0,0,0,0,0,0
4733000,2331000,2,0,0,0,0,0,0,0,0,0,0,0,0,0,0
4733000,2346000,3,127,12,115,24,20,6,19,1082,32,1050,157,229,48,120
4733000,2356000,4,0,0,0,0,0,0,0,0,0,0,0,0,0,0
4733000,2361000,9,725,51,674,129,48,10,55,6383,350,6033,1452,341,83,554
4733000,2362000,2,0,0,0,0,0,0,0,0,0,0,0,0,0,0
4733000,2363000,37,1697,269,1428,403,80,18,66,13127,1861,11266,3909,621,127,516
4733000,2364000,13,867,137,730,111,79,11,40,5982,915,5067,1240,575,65,266
4733000,2393000,3,1598,942,656,154,36,50,22,3170,1773,1397,299,72,90,40
4733000,2431000,2,0,0,0,0,0,0,0,0,0,0,0,0,0,0
4733000,2471000,5,0,0,0,0,0,0,0,0,0,0,0,0,0,0
4733000,2473000,2,0,0,0,0,0,0,0,0,0,0,0,0,0,0
4733000,2495000,1,0,0,0,0,0,0,0,0,0,0,0,0,0,0
4733000,2498000,1,0,0,0,0,0,0,0,0,0,0,0,0,0,0
4734000,2329000,22,894,119,775,119,150,98,23,7084,755,6329,1283,1341,818,227
4734000,2330000,1,0,0,0,0,0,0,0,0,0,0,0,0,0,0
4734000,2346000,26,1237,135,1102,113,694,49,36,11845,994,10851,1242,7220,337,327
4734000,2347000,1,0,0,0,0,0,0,0,0,0,0,0,0,0,0
4734000,2355000,223,102415,11594,90821,17658,5569,3065,17436,475077,38729,436348,116145,27219,15375,93743
4734000,2356000,6,547,18,529,28,0,4,0,3716,118,3598,296,0,30,0
4734000,2359000,5,295,24,271,68,21,0,7,2147,145,2002,714,209,0,37
4734000,2360000,159,66007,4964,61043,17818,2929,1961,5784,519900,25610,494290,173458,20514,14197,42827
4734000,2362000,256,64972,5275,59697,17466,2332,1828,5829,524119,28797,495322,174443,14453,13665,43640
4734000,2363000,5,0,0,0,0,0,0,0,0,0,0,0,0,0,0
4734000,2375000,6,307,22,285,48,130,6,11,2359,141,2218,514,913,46,65
4734000,2383000,1,0,0,0,0,0,0,0,0,0,0,0,0,0,0
4734000,2384000,2,0,0,0,0,0,0,0,0,0,0,0,0,0,0
4734000,2430000,3,420,39,381,51,5,20,11,717,66,651,114,5,30,19
4734000,2431000,3,153,33,120,13,0,30,3,273,52,221,28,0,60,18
4734000,2432000,3,279,42,237,7,7,39,8,616,90,526,25,12,93,12
4734000,2434000,1,0,0,0,0,0,0,0,0,0,0,0,0,0,0
4734000,2463000,1,0,0,0,0,0,0,0,0,0,0,0,0,0,0
4734000,2482000,1,0,0,0,0,0,0,0,0,0,0,0,0,0,0
4734000,2526000,1,0,0,0,0,0,0,0,0,0,0,0,0,0,0
4735000,2328000,13,498,40,458,71,63,116,49,3903,250,3653,598,471,956,516
4735000,2345000,3,0,0,0,0,0,0,0,0,0,0,0,0,0,0
4735000,2346000,29,655,118,537,138,98,20,59,5991,1040,4951,1522,798,171,551
4735000,2354000,91,7602,1171,6431,1144,358,183,437,47218,4723,42495,9731,2400,843,3411
4735000,2356000,1,0,0,0,0,0,0,0,0,0,0,0,0,0,0
4735000,2359000,3,202,15,187,86,2,0,11,1313,62,1251,649,10,0,116
4735000,2361000,10,762,53,709,324,25,14,54,6030,325,5705,3127,152,106,404
4735000,2362000,23,1707,111,1596,430,38,54,113,13348,673,12675,4306,206,547,634
4735000,2370000,5,105,15,90,0,55,9,0,877,101,776,0,418,93,0
4735000,2371000,3,67,0,67,0,46,9,4,553,0,553,0,320,110,56
4735000,2372000,1,0,0,0,0,0,0,0,0,0,0,0,0,0,0
4735000,2375000,12,1211,304,907,164,82,62,54,9217,2648,6569,1237,523,322,450
4735000,2383000,22,1068,29,1039,360,40,51,105,7879,172,7707,3383,282,292,743
4735000,2431000,5,110,25,85,19,1,16,2,168,31,137,34,1,33,2
4735000,2432000,5,18399,712,17687,638,58,517,138,19358,924,18434,785,69,588,141
4735000,2471000,1,0,0,0,0,0,0,0,0,0,0,0,0,0,0
4736000,2327000,2,0,0,0,0,0,0,0,0,0,0,0,0,0,0
4736000,2328000,108,4796,916,3880,636,529,789,295,31710,5388,26322,5748,3991,5195,2354
4736000,2344000,73,4181,586,3595,691,754,159,368,33139,4284,28855,6456,5923,1157,3105
4736000,2345000,56,2066,432,1634,273,524,36,140,19053,3843,15210,3163,5030,311,1210
4736000,2353000,29,1676,31,1645,378,69,18,229,13859,150,13709,4225,478,82,1614
4736000,2354000,24,1282,89,1193,203,76,45,43,9308,587,8721,1969,573,289,321
4736000,2362000,25,2066,215,1851,480,192,42,156,15293,1427,13866,4098,1290,211,1082
4736000,2371000,3,368,8,360,54,61,3,9,2804,54,2750,621,462,9,50
4736000,2382000,2,0,0,0,0,0,0,0,0,0,0,0,0,0,0
4736000,2383000,2,0,0,0,0,0,0,0,0,0,0,0,0,0,0
4736000,2429000,3,0,0,0,0,0,0,0,0,0,0,0,0,0,0
4736000,2431000,7,674,61,613,50,23,82,15,1008,95,913,83,27,132,18
4736000,2432000,5,16651,492,16159,221,55,506,107,17699,678,17021,347,55,761,151
4736000,2433000,1,0,0,0,0,0,0,0,0,0,0,0,0,0,0
4736000,2447000,1,0,0,0,0,0,0,0,0,0,0,0,0,0,0
4736000,2467000,5,0,0,0,0,0,0,0,0,0,0,0,0,0,0
4736000,2468000,3,0,0,0,0,0,0,0,0,0,0,0,0,0,0
4736000,2494000,1,0,0,0,0,0,0,0,0,0,0,0,0,0,0
4736000,2497000,2,0,0,0,0,0,0,0,0,0,0,0,0,0,0
4736000,2514000,1,0,0,0,0,0,0,0,0,0,0,0,0,0,0
4737000,2326000,1,0,0,0,0,0,0,0,0,0,0,0,0,0,0
4737000,2343000,6,200,19,181,36,43,6,7,1568,121,1447,371,351,33,75
4737000,2344000,23,716,109,607,135,108,36,81,6290,825,5465,1460,941,309,591
4737000,2352000,43,3235,407,2828,477,167,127,186,16640,2063,14577,3731,842,486,891
4737000,2353000,3,0,0,0,0,0,0,0,0,0,0,0,0,0,0
4737000,2354000,1,0,0,0,0,0,0,0,0,0,0,0,0,0,0
4737000,2362000,35,1583,163,1420,197,124,12,119,11957,1216,10741,1664,1055,15,935
4737000,2363000,210,10839,2139,8700,2022,1199,106,469,87661,15098,72563,21715,10320,802,3221
4737000,2364000,41,2312,320,1992,375,228,35,142,18067,2356,15711,3944,1708,196,1085
4737000,2365000,8,527,26,501,103,60,13,63,4373,188,4185,1028,556,100,422
4737000,2371000,28,4169,213,3956,223,552,132,139,28558,1152,27406,2414,4611,1025,1016
4737000,2381000,7,319,5,314,96,53,8,33,2219,30,2189,785,350,74,240
4737000,2382000,1,0,0,0,0,0,0,0,0,0,0,0,0,0,0
4737000,2400000,3,0,0,0,0,0,0,0,0,0,0,0,0,0,0
4737000,2430000,4,265,22,243,22,5,41,6,489,34,455,52,5,86,6
4737000,2478000,2,0,0,0,0,0,0,0,0,0,0,0,0,0,0
4738000,2339000,1,0,0,0,0,0,0,0,0,0,0,0,0,0,0
4738000,2341000,2,0,0,0,0,0,0,0,0,0,0,0,0,0,0
4738000,2342000,53,2341,249,2092,399,436,112,93,19285,2080,17205,3755,3895,777,748
4738000,2343000,9,529,29,500,106,53,22,30,3806,296,3510,808,388,166,179
4738000,2344000,9,329,37,292,76,60,5,31,2789,269,2520,747,559,82,378
4738000,2349000,3,483,20,463,76,10,16,9,1832,58,1774,374,24,73,33
4738000,2350000,15,4409,695,3714,496,160,240,268,10653,1546,9107,1778,390,487,645
4738000,2351000,94,8539,806,7733,1435,410,384,390,40371,3083,37288,8880,2049,1445,1985
4738000,2352000,17,975,92,883,141,71,60,32,6511,574,5937,1405,565,330,230
4738000,2359000,1,0,0,0,0,0,0,0,0,0,0,0,0,0,0
4738000,2360000,9,268,33,235,42,4,16,10,1920,191,1729,328,36,128,65
4738000,2363000,8,163,112,51,14,4,0,3,1314,890,424,108,28,0,21
4738000,2364000,24,1451,250,1201,369,77,38,55,10266,1597,8669,3391,477,228,408
4738000,2365000,2,0,0,0,0,0,0,0,0,0,0,0,0,0,0
4738000,2370000,5,355,13,342,76,119,6,42,3225,65,3160,922,1054,42,364
4738000,2371000,1,0,0,0,0,0,0,0,0,0,0,0,0,0,0
4738000,2372000,16,0,0,0,0,0,0,0,0,0,0,0,0,0,0
4738000,2373000,2,0,0,0,0,0,0,0,0,0,0,0,0,0,0
4738000,2380000,2,0,0,0,0,0,0,0,0,0,0,0,0,0,0
4738000,2381000,2,0,0,0,0,0,0,0,0,0,0,0,0,0,0
4738000,2399000,1,0,0,0,0,0,0,0,0,0,0,0,0,0,0
4738000,2418000,1,0,0,0,0,0,0,0,0,0,0,0,0,0,0
4738000,2479000,1,0,0,0,0,0,0,0,0,0,0,0,0,0,0
4739000,2327000,1,0,0,0,0,0,0,0,0,0,0,0,0,0,0
4739000,2328000,2,0,0,0,0,0,0,0,0,0,0,0,0,0,0
4739000,2340000,10,429,53,376,54,212,14,2,3984,483,3501,641,1896,94,6
4739000,2341000,5,0,0,0,0,0,0,0,0,0,0,0,0,0,0
4739000,2342000,12,327,21,306,52,133,12,11,2989,191,2798,485,1353,91,112
4739000,2348000,2038,356474,47046,309428,31186,10900,18930,16504,1031222,119098,912124,150436,48108,51942,74264
4739000,2349000,29,2946,173,2773,369,52,180,136,12137,532,11605,1969,233,634,549
4739000,2350000,34,1473,113,1360,186,36,78,45,8237,462,7775,1519,295,363,211
4739000,2351000,2,0,0,0,0,0,0,0,0,0,0,0,0,0,0
4739000,2364000,9,392,56,336,30,18,24,39,2570,439,2131,322,99,110,264
4739000,2365000,9,289,136,153,30,27,9,16,2074,899,1175,326,228,46,141
4739000,2427000,1,0,0,0,0,0,0,0,0,0,0,0,0,0,0
4739000,2428000,1,0,0,0,0,0,0,0,0,0,0,0,0,0,0
4739000,2472000,1,0,0,0,0,0,0,0,0,0,0,0,0,0,0
4739000,2508000,1,0,0,0,0,0,0,0,0,0,0,0,0,0,0
4739000,2518000,1,0,0,0,0,0,0,0,0,0,0,0,0,0,0
4740000,2347000,13,1586,82,1504,175,9,59,40,4048,222,3826,563,29,135,129
4740000,2348000,81,4693,349,4344,335,54,246,117,13937,1161,12776,1260,215,744,423
4740000,2349000,36,2435,94,2341,286,14,162,93,8261,350,7911,1556,42,617,464
4740000,2350000,28,2216,153,2063,192,40,160,32,6268,421,5847,742,117,453,132
4740000,2351000,6,179,5,174,16,0,9,6,802,8,794,96,0,21,30
4740000,2352000,4,210,6,204,23,2,53,0,1061,16,1045,222,6,212,0
4740000,2377000,1,0,0,0,0,0,0,0,0,0,0,0,0,0,0
4740000,2391000,1,0,0,0,0,0,0,0,0,0,0,0,0,0,0
4740000,2427000,1,0,0,0,0,0,0,0,0,0,0,0,0,0,0
4740000,2428000,2,0,0,0,0,0,0,0,0,0,0,0,0,0,0
4740000,2488000,1,0,0,0,0,0,0,0,0,0,0,0,0,0,0
4740000,2516000,1,0,0,0,0,0,0,0,0,0,0,0,0,0,0
4740000,2518000,1,0,0,0,0,0,0,0,0,0,0,0,0,0,0
4740000,2530000,1,0,0,0,0,0,0,0,0,0,0,0,0,0,0
4741000,2339000,85,7432,1098,6334,728,3045,268,492,62075,8805,53270,7902,24132,2477,4370
4741000,2346000,8,447,31,416,53,28,34,10,2559,203,2356,308,176,131,56
4741000,2347000,28,1413,215,1198,139,30,103,13,6147,653,5494,709,73,475,65
4741000,2348000,60,3451,193,3258,328,47,278,73,13253,720,12533,1932,135,1059,281
4741000,2349000,20,1556,93,1463,191,17,112,24,6778,427,6351,1297,56,471,148
4741000,2350000,28,2842,184,2658,373,29,230,93,9432,489,8943,1807,141,629,278
4741000,2351000,13,730,50,680,198,8,41,19,4700,280,4420,1642,8,142,197
4741000,2357000,1,0,0,0,0,0,0,0,0,0,0,0,0,0,0
4741000,2376000,1,0,0,0,0,0,0,0,0,0,0,0,0,0,0
4741000,2377000,26,1163,36,1127,331,51,70,46,8279,311,7968,3044,360,380,223
4741000,2391000,1,0,0,0,0,0,0,0,0,0,0,0,0,0,0
4741000,2393000,2,0,0,0,0,0,0,0,0,0,0,0,0,0,0
4741000,2406000,1,0,0,0,0,0,0,0,0,0,0,0,0,0,0
4741000,2426000,4,148,10,138,25,0,51,0,397,17,380,82,0,116,0
4741000,2472000,1,0,0,0,0,0,0,0,0,0,0,0,0,0,0
4741000,2473000,1,0,0,0,0,0,0,0,0,0,0,0,0,0,0
4741000,2487000,1,0,0,0,0,0,0,0,0,0,0,0,0,0,0
4741000,2502000,1,0,0,0,0,0,0,0,0,0,0,0,0,0,0
4741000,2509000,2,0,0,0,0,0,0,0,0,0,0,0,0,0,0
4742000,2337000,1,0,0,0,0,0,0,0,0,0,0,0,0,0,0
4742000,2347000,4,725,35,690,57,8,46,11,1468,40,1428,190,8,54,11
4742000,2348000,6,274,4,270,45,3,24,4,1386,11,1375,328,12,147,20
4742000,2349000,16,900,84,816,71,31,51,23,2888,231,2657,267,82,208,109
4742000,2361000,4,0,0,0,0,0,0,0,0,0,0,0,0,0,0
4742000,2370000,9,465,26,439,158,56,33,20,3841,102,3739,1616,417,277,124
4742000,2391000,2,0,0,0,0,0,0,0,0,0,0,0,0,0,0
4742000,2397000,1,0,0,0,0,0,0,0,0,0,0,0,0,0,0
4742000,2425000,8,1748,129,1619,309,12,196,123,4351,264,4087,662,48,563,683
4742000,2427000,1,0,0,0,0,0,0,0,0,0,0,0,0,0,0
4742000,2485000,2,0,0,0,0,0,0,0,0,0,0,0,0,0,0
4742000,2500000,1,0,0,0,0,0,0,0,0,0,0,0,0,0,0
4743000,2337000,2,0,0,0,0,0,0,0,0,0,0,0,0,0,0
4743000,2347000,7,629,164,465,74,9,68,15,1889,492,1397,454,15,131,24
4743000,2355000,1,0,0,0,0,0,0,0,0,0,0,0,0,0,0
4743000,2360000,11,463,32,431,94,18,30,17,3087,129,2958,893,108,118,174
4743000,2361000,2,0,0,0,0,0,0,0,0,0,0,0,0,0,0
4743000,2365000,1,0,0,0,0,0,0,0,0,0,0,0,0,0,0
4743000,2369000,9,474,16,458,194,70,9,2,4008,49,3959,2075,731,15,2
4743000,2376000,3,130,0,130,23,14,9,15,586,0,586,118,66,30,50
4743000,2390000,1,0,0,0,0,0,0,0,0,0,0,0,0,0,0
4743000,2396000,1,0,0,0,0,0,0,0,0,0,0,0,0,0,0
4743000,2398000,1,0,0,0,0,0,0,0,0,0,0,0,0,0,0
4743000,2408000,1,0,0,0,0,0,0,0,0,0,0,0,0,0,0
4743000,2431000,3,0,0,0,0,0,0,0,0,0,0,0,0,0,0
4743000,2485000,1,0,0,0,0,0,0,0,0,0,0,0,0,0,0
4743000,2496000,2,0,0,0,0,0,0,0,0,0,0,0,0,0,0
4744000,2318000,37,884,83,801,104,291,167,57,8240,930,7310,834,3165,1408,517
4744000,2337000,1,0,0,0,0,0,0,0,0,0,0,0,0,0,0
4744000,2342000,8,391,42,349,86,36,18,10,3560,273,3287,780,359,115,132
4744000,2343000,335,20001,1767,18234,2715,2349,433,769,139417,11568,127849,24884,17359,2478,4995
4744000,2344000,60,3036,279,2757,364,417,52,54,22886,1797,21089,3565,3361,336,408
4744000,2345000,15,609,108,501,95,135,1,25,4708,659,4049,1036,1176,6,187
4744000,2347000,2,0,0,0,0,0,0,0,0,0,0,0,0,0,0
4744000,2349000,1,0,0,0,0,0,0,0,0,0,0,0,0,0,0
4744000,2358000,3,0,0,0,0,0,0,0,0,0,0,0,0,0,0
4744000,2359000,1,0,0,0,0,0,0,0,0,0,0,0,0,0,0
4744000,2360000,1,0,0,0,0,0,0,0,0,0,0,0,0,0,0
4744000,2363000,1,0,0,0,0,0,0,0,0,0,0,0,0,0,0
4744000,2364000,62,2833,245,2588,1023,474,32,166,25207,1737,23470,10802,3993,290,1438
4744000,2365000,16,376,38,338,96,75,10,49,3416,393,3023,910,735,112,405
4744000,2368000,82,7272,650,6622,2256,1107,109,827,54128,4290,49838,19295,8119,582,5696
4744000,2369000,1,0,0,0,0,0,0,0,0,0,0,0,0,0,0
4744000,2375000,3,131,0,131,16,7,9,3,942,0,942,145,70,97,15
4744000,2394000,2,0,0,0,0,0,0,0,0,0,0,0,0,0,0
4744000,2417000,2,0,0,0,0,0,0,0,0,0,0,0,0,0,0
4744000,2425000,1,0,0,0,0,0,0,0,0,0,0,0,0,0,0
4744000,2453000,1,0,0,0,0,0,0,0,0,0,0,0,0,0,0
4744000,2457000,1,0,0,0,0,0,0,0,0,0,0,0,0,0,0
4744000,2458000,1,0,0,0,0,0,0,0,0,0,0,0,0,0,0
4745000,2334000,1,0,0,0,0,0,0,0,0,0,0,0,0,0,0
4745000,2336000,1,0,0,0,0,0,0,0,0,0,0,0,0,0,0
4745000,2337000,125,4374,667,3707,574,1538,68,144,38104,5257,32847,6200,13219,519,1382
4745000,2342000,72,5690,341,5349,870,551,103,273,43397,2108,41289,7907,4177,573,2129
4745000,2343000,32,1628,146,1482,150,260,64,25,11893,903,10990,1684,1827,373,187
4745000,2344000,9,661,82,579,110,9,12,28,4298,466,3832,1076,62,50,112
4745000,2347000,1,0,0,0,0,0,0,0,0,0,0,0,0,0,0
4745000,2348000,2,0,0,0,0,0,0,0,0,0,0,0,0,0,0
4745000,2350000,1,0,0,0,0,0,0,0,0,0,0,0,0,0,0
4745000,2354000,6,156,8,148,18,0,13,8,1260,88,1172,215,0,115,118
4745000,2363000,1,0,0,0,0,0,0,0,0,0,0,0,0,0,0
4745000,2364000,2,0,0,0,0,0,0,0,0,0,0,0,0,0,0
4745000,2368000,5,0,0,0,0,0,0,0,0,0,0,0,0,0,0
4745000,2375000,4,147,7,140,45,0,3,0,729,21,708,194,0,6,0
4745000,2400000,2,0,0,0,0,0,0,0,0,0,0,0,0,0,0
4745000,2405000,1,0,0,0,0,0,0,0,0,0,0,0,0,0,0
4745000,2426000,3,205,21,184,25,0,8,3,481,35,446,67,0,14,3
4745000,2458000,1,0,0,0,0,0,0,0,0,0,0,0,0,0,0
4745000,2488000,2,0,0,0,0,0,0,0,0,0,0,0,0,0,0
4745000,2489000,1,0,0,0,0,0,0,0,0,0,0,0,0,0,0
4746000,2335000,2,0,0,0,0,0,0,0,0,0,0,0,0,0,0
4746000,2336000,27,833,114,719,111,266,12,39,7808,961,6847,1380,2626,145,339
4746000,2340000,14,1941,165,1776,282,287,82,301,10933,1352,9581,1577,2188,340,1452
4746000,2341000,38,3384,440,2944,332,1047,23,301,27910,4202,23708,3492,8695,152,2475
4746000,2342000,28,1481,177,1304,334,57,53,73,10736,1168,9568,3309,420,460,510
4746000,2353000,1,0,0,0,0,0,0,0,0,0,0,0,0,0,0
4746000,2354000,1,0,0,0,0,0,0,0,0,0,0,0,0,0,0
4746000,2357000,2,0,0,0,0,0,0,0,0,0,0,0,0,0,0
4746000,2362000,1,0,0,0,0,0,0,0,0,0,0,0,0,0,0
4746000,2363000,5,92,18,74,28,3,3,4,729,124,605,294,30,14,16
4746000,2374000,6,388,8,380,62,35,26,51,2889,40,2849,532,213,215,363
4746000,2423000,1,0,0,0,0,0,0,0,0,0,0,0,0,0,0
4746000,2476000,1,0,0,0,0,0,0,0,0,0,0,0,0,0,0
4746000,2489000,3,0,0,0,0,0,0,0,0,0,0,0,0,0,0
4746000,2490000,2,0,0,0,0,0,0,0,0,0,0,0,0,0,0
4746000,2499000,1,0,0,0,0,0,0,0,0,0,0,0,0,0,0
4746000,2506000,1,0,0,0,0,0,0,0,0,0,0,0,0,0,0
4746000,2526000,2,0,0,0,0,0,0,0,0,0,0,0,0,0,0
4746000,2531000,1,0,0,0,0,0,0,0,0,0,0,0,0,0,0
4747000,2335000,3,0,0,0,0,0,0,0,0,0,0,0,0,0,0
4747000,2340000,78,4348,735,3613,645,799,53,159,35030,5098,29932,6664,6237,479,1619
4747000,2341000,181,10566,1597,8969,1921,1171,209,795,76977,10711,66266,18455,8749,1529,4508
4747000,2342000,23,4431,1656,2775,581,207,215,424,14514,3506,11008,3639,799,528,1207
4747000,2352000,10,314,30,284,128,0,16,20,2393,143,2250,1217,0,72,162
4747000,2354000,1,0,0,0,0,0,0,0,0,0,0,0,0,0,0
4747000,2357000,1,0,0,0,0,0,0,0,0,0,0,0,0,0,0
4747000,2367000,10,560,193,367,31,92,15,17,4098,1220,2878,328,674,170,109
4747000,2373000,4,466,10,456,96,36,17,18,2114,28,2086,557,192,41,72
4747000,2404000,2,0,0,0,0,0,0,0,0,0,0,0,0,0,0
4747000,2455000,1,0,0,0,0,0,0,0,0,0,0,0,0,0,0
4747000,2492000,3,0,0,0,0,0,0,0,0,0,0,0,0,0,0
4747000,2500000,1,0,0,0,0,0,0,0,0,0,0,0,0,0,0
4747000,2517000,1,0,0,0,0,0,0,0,0,0,0,0,0,0,0
4747000,2519000,2,0,0,0,0,0,0,0,0,0,0,0,0,0,0
4748000,2315000,1,0,0,0,0,0,0,0,0,0,0,0,0,0,0
4748000,2335000,44,2118,50,2068,245,1043,41,147,19269,361,18908,2493,9535,416,1469
4748000,2340000,52,3018,431,2587,381,540,74,129,24847,3026,21821,3906,4775,463,1056
4748000,2341000,8,292,37,255,72,16,23,6,2166,220,1946,870,81,165,36
4748000,2342000,1,0,0,0,0,0,0,0,0,0,0,0,0,0,0
4748000,2351000,1,0,0,0,0,0,0,0,0,0,0,0,0,0,0
4748000,2366000,2,0,0,0,0,0,0,0,0,0,0,0,0,0,0
4748000,2367000,132,5477,493,4984,1217,677,261,182,45655,3593,42062,12768,5338,2185,1419
4748000,2396000,14,4761,1658,3103,225,125,1493,43,8977,4282,4695,338,433,1758,104
4748000,2408000,6,1162,425,737,92,24,147,39,2795,1171,1624,139,31,331,57
4748000,2456000,6,281,25,256,50,0,36,3,897,65,832,296,0,67,11
4748000,2492000,1,0,0,0,0,0,0,0,0,0,0,0,0,0,0
4748000,2496000,1,0,0,0,0,0,0,0,0,0,0,0,0,0,0
4748000,2515000,1,0,0,0,0,0,0,0,0,0,0,0,0,0,0
4748000,2519000,1,0,0,0,0,0,0,0,0,0,0,0,0,0,0
4749000,2330000,1,0,0,0,0,0,0,0,0,0,0,0,0,0,0
4749000,2334000,5,0,0,0,0,0,0,0,0,0,0,0,0,0,0
4749000,2340000,14,1109,82,1027,267,133,30,91,7774,565,7209,2395,1060,166,443
4749000,2350000,1,0,0,0,0,0,0,0,0,0,0,0,0,0,0
4749000,2358000,3,0,0,0,0,0,0,0,0,0,0,0,0,0,0
4749000,2373000,37,8900,377,8523,2031,2534,421,358,54952,2759,52193,10488,20834,1673,2102
4749000,2431000,3,397,2,395,28,3,44,2,652,2,650,44,30,59,4
4749000,2480000,1,0,0,0,0,0,0,0,0,0,0,0,0,0,0
4749000,2492000,1,0,0,0,0,0,0,0,0,0,0,0,0,0,0
4749000,2493000,6,0,0,0,0,0,0,0,0,0,0,0,0,0,0
4749000,2494000,1,0,0,0,0,0,0,0,0,0,0,0,0,0,0
4749000,2498000,2,0,0,0,0,0,0,0,0,0,0,0,0,0,0
4749000,2510000,2,0,0,0,0,0,0,0,0,0,0,0,0,0,0
4749000,2514000,1,0,0,0,0,0,0,0,0,0,0,0,0,0,0
4749000,2516000,1,0,0,0,0,0,0,0,0,0,0,0,0,0,0
4750000,2333000,29,1110,78,1032,59,780,5,12,10314,605,9709,708,7367,47,91
4750000,2334000,6,350,46,304,59,175,4,13,2947,318,2629,640,1441,42,111
4750000,2341000,4,178,2,176,83,3,0,17,1424,24,1400,758,42,0,101
4750000,2342000,10,487,22,465,191,8,2,64,4027,164,3863,1835,56,14,450
4750000,2349000,7,0,0,0,0,0,0,0,0,0,0,0,0,0,0
4750000,2355000,1,0,0,0,0,0,0,0,0,0,0,0,0,0,0
4750000,2359000,1,0,0,0,0,0,0,0,0,0,0,0,0,0,0
4750000,2362000,1,0,0,0,0,0,0,0,0,0,0,0,0,0,0
4750000,2403000,2,0,0,0,0,0,0,0,0,0,0,0,0,0,0
4750000,2447000,1,0,0,0,0,0,0,0,0,0,0,0,0,0,0
4750000,2470000,1,0,0,0,0,0,0,0,0,0,0,0,0,0,0
4750000,2494000,7,0,0,0,0,0,0,0,0,0,0,0,0,0,0
4750000,2498000,4,0,0,0,0,0,0,0,0,0,0,0,0,0,0
4751000,2329000,3,54,0,54,2,9,10,15,542,0,542,14,81,119,182
4751000,2332000,19,728,107,621,81,185,25,47,6379,857,5522,940,1765,256,320
4751000,2333000,3,0,0,0,0,0,0,0,0,0,0,0,0,0,0
4751000,2341000,14,597,30,567,263,16,25,36,5275,150,5125,2802,106,178,241
4751000,2342000,1,0,0,0,0,0,0,0,0,0,0,0,0,0,0
4751000,2355000,3,0,0,0,0,0,0,0,0,0,0,0,0,0,0
4751000,2359000,4,0,0,0,0,0,0,0,0,0,0,0,0,0,0
4751000,2364000,4,0,0,0,0,0,0,0,0,0,0,0,0,0,0
4751000,2372000,1,0,0,0,0,0,0,0,0,0,0,0,0,0,0
4751000,2430000,2,0,0,0,0,0,0,0,0,0,0,0,0,0,0
4751000,2495000,1,0,0,0,0,0,0,0,0,0,0,0,0,0,0
4751000,2517000,1,0,0,0,0,0,0,0,0,0,0,0,0,0,0
4752000,2331000,2,0,0,0,0,0,0,0,0,0,0,0,0,0,0
4752000,2332000,2,0,0,0,0,0,0,0,0,0,0,0,0,0,0
4752000,2333000,2,0,0,0,0,0,0,0,0,0,0,0,0,0,0
4752000,2336000,9,528,9,519,83,251,0,35,5364,57,5307,1061,2708,0,334
4752000,2337000,130,7122,813,6309,679,1620,145,251,56740,5186,51554,6900,14230,820,2032
4752000,2340000,3,0,0,0,0,0,0,0,0,0,0,0,0,0,0
4752000,2372000,2,0,0,0,0,0,0,0,0,0,0,0,0,0,0
4752000,2430000,1,0,0,0,0,0,0,0,0,0,0,0,0,0,0
4752000,2446000,2,0,0,0,0,0,0,0,0,0,0,0,0,0,0
4752000,2506000,1,0,0,0,0,0,0,0,0,0,0,0,0,0,0
4752000,2510000,1,0,0,0,0,0,0,0,0,0,0,0,0,0,0
4752000,2511000,1,0,0,0,0,0,0,0,0,0,0,0,0,0,0
4753000,2309000,1,0,0,0,0,0,0,0,0,0,0,0,0,0,0
4753000,2329000,1,0,0,0,0,0,0,0,0,0,0,0,0,0,0
4753000,2330000,2,0,0,0,0,0,0,0,0,0,0,0,0,0,0
4753000,2331000,63,3078,483,2595,223,1598,99,212,29985,5836,24149,2261,14790,957,1743
4753000,2332000,3,112,14,98,2,66,9,4,991,142,849,34,543,116,16
4753000,2335000,6,258,26,232,11,4,5,17,1834,122,1712,113,28,27,114
4753000,2336000,8,384,18,366,100,24,17,52,3187,129,3058,1007,137,78,532
4753000,2338000,2,0,0,0,0,0,0,0,0,0,0,0,0,0,0
4753000,2339000,4,242,20,222,92,6,12,16,1695,51,1644,729,38,88,148
4753000,2344000,12,551,11,540,162,4,21,55,3829,77,3752,1572,16,145,310
4753000,2357000,3,0,0,0,0,0,0,0,0,0,0,0,0,0,0
4753000,2371000,1,0,0,0,0,0,0,0,0,0,0,0,0,0,0
4753000,2372000,2,0,0,0,0,0,0,0,0,0,0,0,0,0,0
4753000,2446000,4,727,20,707,42,3,54,3,1335,34,1301,88,5,80,7
4753000,2509000,2,0,0,0,0,0,0,0,0,0,0,0,0,0,0
4754000,2328000,3,75,13,62,0,11,0,0,962,157,805,0,146,0,0
4754000,2329000,71,3916,466,3450,249,2053,165,164,34057,3748,30309,2733,18099,1087,1373
4754000,2330000,1,0,0,0,0,0,0,0,0,0,0,0,0,0,0
4754000,2331000,10,426,52,374,46,174,14,43,3618,367,3251,336,1539,56,302
4754000,2333000,3,159,104,55,5,21,0,0,1328,813,515,51,216,0,0
4754000,2334000,4,0,0,0,0,0,0,0,0,0,0,0,0,0,0
4754000,2339000,3,0,0,0,0,0,0,0,0,0,0,0,0,0,0
4754000,2352000,8,559,15,544,166,1,22,61,4118,43,4075,1645,1,96,426
4754000,2357000,1,0,0,0,0,0,0,0,0,0,0,0,0,0,0
4754000,2362000,13,520,25,495,161,6,26,22,3207,63,3144,1573,52,108,83
4754000,2370000,8,2565,111,2454,811,170,66,142,11880,491,11389,3972,1016,173,688
4754000,2430000,2,0,0,0,0,0,0,0,0,0,0,0,0,0,0
4754000,2432000,1,0,0,0,0,0,0,0,0,0,0,0,0,0,0
4754000,2445000,7,1313,53,1260,129,16,149,12,2273,128,2145,255,16,264,20
4754000,2494000,1,0,0,0,0,0,0,0,0,0,0,0,0,0,0
4754000,2501000,2,0,0,0,0,0,0,0,0,0,0,0,0,0,0
4754000,2502000,3,963,178,785,127,19,31,77,1332,299,1033,149,25,34,90
4754000,2504000,1,0,0,0,0,0,0,0,0,0,0,0,0,0,0
4754000,2535000,1,0,0,0,0,0,0,0,0,0,0,0,0,0,0
4754000,2541000,1,0,0,0,0,0,0,0,0,0,0,0,0,0,0
4754000,2576000,1,0,0,0,0,0,0,0,0,0,0,0,0,0,0
4755000,2328000,6,149,13,136,31,63,2,0,1315,88,1227,386,523,8,0
4755000,2329000,16,913,45,868,46,677,16,25,8411,323,8088,576,6284,148,255
4755000,2333000,148,7661,835,6826,641,2221,115,471,63581,6887,56694,7253,18758,1502,4052
4755000,2341000,3,0,0,0,0,0,0,0,0,0,0,0,0,0,0
4755000,2369000,290,51442,3360,48082,10133,3951,1410,3271,284521,13771,270750,57273,19549,5388,15927
4755000,2371000,1,0,0,0,0,0,0,0,0,0,0,0,0,0,0
4755000,2430000,2,0,0,0,0,0,0,0,0,0,0,0,0,0,0
4755000,2444000,2,0,0,0,0,0,0,0,0,0,0,0,0,0,0
4755000,2490000,1,0,0,0,0,0,0,0,0,0,0,0,0,0,0
4755000,2497000,1,0,0,0,0,0,0,0,0,0,0,0,0,0,0
4755000,2500000,5,937,181,756,77,13,29,26,1418,339,1079,147,16,36,37
4755000,2501000,22,11188,1761,9427,1002,169,296,365,16014,3573,12441,1535,315,428,440
4755000,2502000,3,0,0,0,0,0,0,0,0,0,0,0,0,0,0
4755000,2573000,1,0,0,0,0,0,0,0,0,0,0,0,0,0,0
4755000,2574000,1,0,0,0,0,0,0,0,0,0,0,0,0,0,0
4756000,2327000,1,0,0,0,0,0,0,0,0,0,0,0,0,0,0
4756000,2328000,109,4023,590,3433,509,1108,87,367,34380,4088,30292,5122,10293,699,3108
4756000,2332000,37,7386,855,6531,271,962,44,110,57500,5748,51752,2785,8027,541,899
4756000,2333000,18,713,108,605,187,110,20,72,7587,747,6840,2891,892,275,966
4756000,2337000,2,0,0,0,0,0,0,0,0,0,0,0,0,0,0
4756000,2345000,2,0,0,0,0,0,0,0,0,0,0,0,0,0,0
4756000,2358000,1,0,0,0,0,0,0,0,0,0,0,0,0,0,0
4756000,2359000,1,0,0,0,0,0,0,0,0,0,0,0,0,0,0
4756000,2368000,2,0,0,0,0,0,0,0,0,0,0,0,0,0,0
4756000,2369000,6,167,31,136,18,0,0,18,1217,189,1028,197,0,0,167
4756000,2430000,1,0,0,0,0,0,0,0,0,0,0,0,0,0,0
4756000,2476000,2,0,0,0,0,0,0,0,0,0,0,0,0,0,0
4756000,2499000,2,0,0,0,0,0,0,0,0,0,0,0,0,0,0
4756000,2502000,1,0,0,0,0,0,0,0,0,0,0,0,0,0,0
4756000,2508000,1,0,0,0,0,0,0,0,0,0,0,0,0,0,0
4756000,2509000,3,0,0,0,0,0,0,0,0,0,0,0,0,0,0
4757000,2327000,24,1131,161,970,74,451,5,56,9679,1221,8458,872,3960,26,588
4757000,2328000,2,0,0,0,0,0,0,0,0,0,0,0,0,0,0
4757000,2331000,1,0,0,0,0,0,0,0,0,0,0,0,0,0,0
4757000,2332000,184,32689,9153,23536,2254,6932,171,627,226813,56878,169935,21247,51012,822,4592
4757000,2333000,13,388,113,275,56,34,1,12,2899,683,2216,534,258,7,73
4757000,2337000,1,0,0,0,0,0,0,0,0,0,0,0,0,0,0
4757000,2340000,2,0,0,0,0,0,0,0,0,0,0,0,0,0,0
4757000,2360000,1,0,0,0,0,0,0,0,0,0,0,0,0,0,0
4757000,2365000,37,2482,156,2326,418,159,97,108,14824,720,14104,3109,978,538,595
4757000,2368000,29,2493,142,2351,436,227,55,258,16861,852,16009,4215,1496,254,1681
4757000,2463000,1,0,0,0,0,0,0,0,0,0,0,0,0,0,0
4757000,2494000,1,0,0,0,0,0,0,0,0,0,0,0,0,0,0
4757000,2497000,2,0,0,0,0,0,0,0,0,0,0,0,0,0,0
4757000,2498000,1,0,0,0,0,0,0,0,0,0,0,0,0,0,0
4757000,2530000,1,0,0,0,0,0,0,0,0,0,0,0,0,0,0
4758000,2323000,1,0,0,0,0,0,0,0,0,0,0,0,0,0,0
4758000,2326000,2,0,0,0,0,0,0,0,0,0,0,0,0,0,0
4758000,2329000,45,42765,6168,36597,4136,2922,1873,3609,147429,19703,127726,17431,17006,4685,13957
4758000,2330000,166,9599,2056,7543,781,1220,184,540,63924,13874,50050,6754,8208,1263,3151
4758000,2331000,48,3795,445,3350,442,397,22,163,28257,2847,25410,4545,2787,200,1164
4758000,2332000,1,0,0,0,0,0,0,0,0,0,0,0,0,0,0
4758000,2336000,1,0,0,0,0,0,0,0,0,0,0,0,0,0,0
4758000,2339000,1,0,0,0,0,0,0,0,0,0,0,0,0,0,0
4758000,2346000,1,0,0,0,0,0,0,0,0,0,0,0,0,0,0
4758000,2358000,3,68,0,68,32,4,5,0,663,0,663,401,20,55,0
4758000,2359000,2,0,0,0,0,0,0,0,0,0,0,0,0,0,0
4758000,2360000,92,9149,1028,8121,2366,679,278,358,44995,5822,39173,17237,4733,911,1880
4758000,2361000,4,155,17,138,71,9,0,15,1170,72,1098,674,78,0,100
4758000,2364000,2,0,0,0,0,0,0,0,0,0,0,0,0,0,0
4758000,2365000,6,0,0,0,0,0,0,0,0,0,0,0,0,0,0
4758000,2367000,37,6870,218,6652,2367,448,305,457,35610,1245,34365,12861,2278,984,2336
4758000,2368000,72,5325,454,4871,913,267,94,424,35603,2468,33135,8125,1703,450,2983
4758000,2430000,1,0,0,0,0,0,0,0,0,0,0,0,0,0,0
4758000,2464000,1,0,0,0,0,0,0,0,0,0,0,0,0,0,0
4758000,2465000,1,0,0,0,0,0,0,0,0,0,0,0,0,0,0
4758000,2469000,1,0,0,0,0,0,0,0,0,0,0,0,0,0,0
4758000,2474000,1,0,0,0,0,0,0,0,0,0,0,0,0,0,0
4759000,2328000,26,1834,216,1618,204,302,17,44,14512,1657,12855,2094,2455,192,419
4759000,2329000,64,10273,2762,7511,763,1974,287,449,59102,13521,45581,5426,12089,1464,2169
4759000,2330000,351,85821,14758,71063,7977,16163,1661,3466,547686,72506,475180,63359,117623,9835,21565
4759000,2331000,35,2018,364,1654,236,160,23,79,15180,2202,12978,2243,1024,92,549
4759000,2357000,1,0,0,0,0,0,0,0,0,0,0,0,0,0,0
4759000,2358000,1,0,0,0,0,0,0,0,0,0,0,0,0,0,0
4759000,2360000,3,162,5,157,67,18,2,3,1186,31,1155,567,119,2,13
4759000,2367000,19,785,92,693,164,71,9,37,5877,616,5261,1543,398,42,263
4759000,2368000,2,0,0,0,0,0,0,0,0,0,0,0,0,0,0
4759000,2460000,2,0,0,0,0,0,0,0,0,0,0,0,0,0,0
4759000,2462000,8,2107,132,1975,91,5,85,32,3380,217,3163,149,5,270,50
4759000,2464000,1,0,0,0,0,0,0,0,0,0,0,0,0,0,0
4759000,2491000,1,0,0,0,0,0,0,0,0,0,0,0,0,0,0
4759000,2496000,1,0,0,0,0,0,0,0,0,0,0,0,0,0,0
4759000,2524000,1,0,0,0,0,0,0,0,0,0,0,0,0,0,0
4759000,2529000,1,0,0,0,0,0,0,0,0,0,0,0,0,0,0
4759000,2536000,1,0,0,0,0,0,0,0,0,0,0,0,0,0,0
4760000,2328000,13,710,170,540,61,72,12,20,5629,1442,4187,559,512,77,148
4760000,2329000,11,567,179,388,37,70,1,20,3193,1021,2172,328,428,2,82
4760000,2330000,7,324,143,181,20,19,3,4,2225,998,1227,218,130,17,16
4760000,2331000,1,0,0,0,0,0,0,0,0,0,0,0,0,0,0
4760000,2340000,1,0,0,0,0,0,0,0,0,0,0,0,0,0,0
4760000,2345000,1,0,0,0,0,0,0,0,0,0,0,0,0,0,0
4760000,2348000,1,0,0,0,0,0,0,0,0,0,0,0,0,0,0
4760000,2357000,1,0,0,0,0,0,0,0,0,0,0,0,0,0,0
4760000,2360000,6,368,27,341,74,167,4,11,3074,187,2887,780,1324,34,56
4760000,2367000,1,0,0,0,0,0,0,0,0,0,0,0,0,0,0
4760000,2368000,2,0,0,0,0,0,0,0,0,0,0,0,0,0,0
4760000,2375000,1,0,0,0,0,0,0,0,0,0,0,0,0,0,0
4760000,2439000,1,0,0,0,0,0,0,0,0,0,0,0,0,0,0
4760000,2460000,6,0,0,0,0,0,0,0,0,0,0,0,0,0,0
4760000,2461000,64,17108,1409,15699,664,96,786,273,24799,2134,22665,1174,128,1218,471
4760000,2462000,7,0,0,0,0,0,0,0,0,0,0,0,0,0,0
4760000,2463000,2,0,0,0,0,0,0,0,0,0,0,0,0,0,0
4760000,2491000,1,0,0,0,0,0,0,0,0,0,0,0,0,0,0
4760000,2495000,2,0,0,0,0,0,0,0,0,0,0,0,0,0,0
4760000,2521000,2,0,0,0,0,0,0,0,0,0,0,0,0,0,0
4760000,2535000,2,0,0,0,0,0,0,0,0,0,0,0,0,0,0
4760000,2568000,1,0,0,0,0,0,0,0,0,0,0,0,0,0,0
4760000,2584000,1,0,0,0,0,0,0,0,0,0,0,0,0,0,0
4761000,2328000,1,0,0,0,0,0,0,0,0,0,0,0,0,0,0
4761000,2330000,3,140,18,122,41,2,8,0,1256,137,1119,474,14,92,0
4761000,2336000,3,199,0,199,72,0,0,6,2023,0,2023,791,0,0,84
4761000,2341000,1,0,0,0,0,0,0,0,0,0,0,0,0,0,0
4761000,2344000,2,0,0,0,0,0,0,0,0,0,0,0,0,0,0
4761000,2345000,1,0,0,0,0,0,0,0,0,0,0,0,0,0,0
4761000,2360000,1,0,0,0,0,0,0,0,0,0,0,0,0,0,0
4761000,2361000,5,223,8,215,89,6,0,38,1805,28,1777,766,38,0,254
4761000,2363000,2,0,0,0,0,0,0,0,0,0,0,0,0,0,0
4761000,2367000,3,97,0,97,47,12,0,7,954,0,954,579,94,0,69
4761000,2458000,1,0,0,0,0,0,0,0,0,0,0,0,0,0,0
4761000,2462000,2,0,0,0,0,0,0,0,0,0,0,0,0,0,0
4761000,2463000,1,0,0,0,0,0,0,0,0,0,0,0,0,0,0
4761000,2464000,1,0,0,0,0,0,0,0,0,0,0,0,0,0,0
4761000,2492000,3,343,95,248,8,0,41,0,466,171,295,8,0,52,0
4761000,2493000,1,0,0,0,0,0,0,0,0,0,0,0,0,0,0
4761000,2521000,1,0,0,0,0,0,0,0,0,0,0,0,0,0,0
4761000,2526000,1,0,0,0,0,0,0,0,0,0,0,0,0,0,0
4761000,2528000,1,0,0,0,0,0,0,0,0,0,0,0,0,0,0
4761000,2578000,1,0,0,0,0,0,0,0,0,0,0,0,0,0,0
4761000,2580000,1,0,0,0,0,0,0,0,0,0,0,0,0,0,0
4762000,2327000,5,0,0,0,0,0,0,0,0,0,0,0,0,0,0
4762000,2335000,1,0,0,0,0,0,0,0,0,0,0,0,0,0,0
4762000,2336000,14,617,155,462,145,17,11,49,5224,1110,4114,1618,202,79,288
4762000,2338000,1,0,0,0,0,0,0,0,0,0,0,0,0,0,0
4762000,2340000,1,0,0,0,0,0,0,0,0,0,0,0,0,0,0
4762000,2341000,1,0,0,0,0,0,0,0,0,0,0,0,0,0,0
4762000,2351000,5,0,0,0,0,0,0,0,0,0,0,0,0,0,0
4762000,2361000,1,0,0,0,0,0,0,0,0,0,0,0,0,0,0
4762000,2440000,4,1290,26,1264,129,5,119,34,2061,35,2026,292,7,197,71
4762000,2455000,1,0,0,0,0,0,0,0,0,0,0,0,0,0,0
4762000,2539000,1,0,0,0,0,0,0,0,0,0,0,0,0,0,0
4762000,2548000,1,0,0,0,0,0,0,0,0,0,0,0,0,0,0
4763000,2321000,4,127,24,103,12,29,10,11,943,142,801,135,195,54,35
4763000,2327000,337,56646,5753,50893,9779,13102,2122,3733,431651,42616,389035,85603,97494,15605,28080
4763000,2328000,4,0,0,0,0,0,0,0,0,0,0,0,0,0,0
4763000,2335000,1,0,0,0,0,0,0,0,0,0,0,0,0,0,0
4763000,2337000,1,0,0,0,0,0,0,0,0,0,0,0,0,0,0
4763000,2338000,3,50,23,27,1,0,0,0,241,163,78,2,0,0,0
4763000,2355000,1,0,0,0,0,0,0,0,0,0,0,0,0,0,0
4763000,2431000,2,0,0,0,0,0,0,0,0,0,0,0,0,0,0
4763000,2437000,21,9906,400,9506,531,52,351,228,15523,627,14896,1075,86,627,405
4763000,2439000,15,3936,35,3901,377,23,370,84,6228,52,6176,754,26,544,137
4763000,2440000,8,1937,16,1921,197,7,272,27,3514,25,3489,375,11,545,43
4763000,2448000,4,663,65,598,63,0,56,29,1381,111,1270,205,0,93,73
4763000,2455000,1,0,0,0,0,0,0,0,0,0,0,0,0,0,0
4763000,2460000,1,0,0,0,0,0,0,0,0,0,0,0,0,0,0
4763000,2538000,1,0,0,0,0,0,0,0,0,0,0,0,0,0,0
4763000,2540000,1,0,0,0,0,0,0,0,0,0,0,0,0,0,0
4763000,2566000,1,0,0,0,0,0,0,0,0,0,0,0,0,0,0
4763000,2570000,1,0,0,0,0,0,0,0,0,0,0,0,0,0,0
4763000,2571000,1,0,0,0,0,0,0,0,0,0,0,0,0,0,0
4764000,2327000,58,3282,361,2921,328,353,11,85,25307,2566,22741,3019,2419,117,598
4764000,2350000,1,0,0,0,0,0,0,0,0,0,0,0,0,0,0
4764000,2357000,2,0,0,0,0,0,0,0,0,0,0,0,0,0,0
4764000,2358000,50,5493,484,5009,1498,452,154,347,27450,2119,25331,9836,2003,505,1603
4764000,2385000,1,0,0,0,0,0,0,0,0,0,0,0,0,0,0
4764000,2437000,7,0,0,0,0,0,0,0,0,0,0,0,0,0,0
4764000,2438000,16,9062,115,8947,682,23,466,252,13201,165,13036,1265,28,707,423
4764000,2439000,7,3358,23,3335,286,26,267,74,4927,39,4888,534,34,391,130
4764000,2440000,10,1942,23,1919,202,4,140,29,4028,47,3981,493,4,253,51
4764000,2442000,1,0,0,0,0,0,0,0,0,0,0,0,0,0,0
4764000,2443000,2,0,0,0,0,0,0,0,0,0,0,0,0,0,0
4764000,2455000,1,0,0,0,0,0,0,0,0,0,0,0,0,0,0
4764000,2459000,1,0,0,0,0,0,0,0,0,0,0,0,0,0,0
4764000,2462000,1,0,0,0,0,0,0,0,0,0,0,0,0,0,0
4764000,2527000,1,0,0,0,0,0,0,0,0,0,0,0,0,0,0
4764000,2533000,1,0,0,0,0,0,0,0,0,0,0,0,0,0,0
4764000,2537000,1,0,0,0,0,0,0,0,0,0,0,0,0,0,0
4764000,2538000,1,0,0,0,0,0,0,0,0,0,0,0,0,0,0
4764000,2539000,1,0,0,0,0,0,0,0,0,0,0,0,0,0,0
4764000,2547000,1,0,0,0,0,0,0,0,0,0,0,0,0,0,0
4765000,2333000,5,490,101,389,122,21,60,33,2345,227,2118,1142,68,222,147
4765000,2354000,1,0,0,0,0,0,0,0,0,0,0,0,0,0,0
4765000,2357000,5,149,10,139,45,4,0,5,919,49,870,332,28,0,20
4765000,2358000,4,195,9,186,32,37,13,23,1198,57,1141,245,294,61,140
4765000,2361000,155,7705,539,7166,2612,498,106,376,62783,3429,59354,27613,3636,650,2834
4765000,2367000,73,0,0,0,0,0,0,0,0,0,0,0,0,0,0
4765000,2382000,1,0,0,0,0,0,0,0,0,0,0,0,0,0,0
4765000,2434000,2,0,0,0,0,0,0,0,0,0,0,0,0,0,0
4765000,2439000,4,1630,18,1612,149,10,148,31,2607,22,2585,269,13,220,65
4765000,2440000,1,0,0,0,0,0,0,0,0,0,0,0,0,0,0
4765000,2441000,8,0,0,0,0,0,0,0,0,0,0,0,0,0,0
4765000,2442000,25,16024,658,15366,900,59,937,368,24419,1175,23244,1837,65,1562,646
4765000,2443000,10,3162,40,3122,249,34,464,70,4887,65,4822,484,45,742,125
4765000,2447000,3,0,0,0,0,0,0,0,0,0,0,0,0,0,0
4765000,2451000,1,0,0,0,0,0,0,0,0,0,0,0,0,0,0
4765000,2452000,2,0,0,0,0,0,0,0,0,0,0,0,0,0,0
4765000,2460000,1,0,0,0,0,0,0,0,0,0,0,0,0,0,0
4765000,2531000,1,0,0,0,0,0,0,0,0,0,0,0,0,0,0
4765000,2532000,1,0,0,0,0,0,0,0,0,0,0,0,0,0,0
4765000,2534000,2,0,0,0,0,0,0,0,0,0,0,0,0,0,0
4765000,2537000,13,0,0,0,0,0,0,0,0,0,0,0,0,0,0
4765000,2538000,1,0,0,0,0,0,0,0,0,0,0,0,0,0,0
4765000,2547000,1,0,0,0,0,0,0,0,0,0,0,0,0,0,0
4765000,2563000,1,0,0,0,0,0,0,0,0,0,0,0,0,0,0
4765000,2565000,3,0,0,0,0,0,0,0,0,0,0,0,0,0,0
4765000,2567000,1,0,0,0,0,0,0,0,0,0,0,0,0,0,0
4765000,2568000,1,0,0,0,0,0,0,0,0,0,0,0,0,0,0
4766000,2324000,13,1245,103,1142,125,166,17,48,10643,791,9852,1444,1354,185,411
4766000,2325000,169,14334,1144,13190,3439,1314,426,1579,110862,8339,102523,30732,9935,2863,12471
4766000,2347000,1,0,0,0,0,0,0,0,0,0,0,0,0,0,0
4766000,2356000,1,0,0,0,0,0,0,0,0,0,0,0,0,0,0
4766000,2392000,1,0,0,0,0,0,0,0,0,0,0,0,0,0,0
4766000,2434000,73,136728,5280,131448,7460,972,7064,3795,175400,7660,167740,12722,1091,10003,6088
4766000,2441000,6,1022,27,995,87,14,58,32,1893,44,1849,196,22,135,72
4766000,2442000,8,1957,38,1919,151,13,146,58,3668,57,3611,326,13,302,109
4766000,2443000,18,0,0,0,0,0,0,0,0,0,0,0,0,0,0
4766000,2444000,7,0,0,0,0,0,0,0,0,0,0,0,0,0,0
4766000,2445000,39,48188,1343,46845,9534,271,3872,1876,82656,1724,80932,18409,421,6763,3262
4766000,2446000,3,1577,52,1525,92,4,203,21,2459,101,2358,190,4,331,27
4766000,2447000,6,2199,52,2147,244,21,237,39,3702,88,3614,492,29,411,54
4766000,2448000,17,4673,146,4527,446,15,358,136,8118,295,7823,965,18,656,272
4766000,2449000,4,896,29,867,92,0,77,21,1546,62,1484,170,0,154,43
4766000,2450000,12,7534,312,7222,556,46,631,175,11472,589,10883,1020,71,982,265
4766000,2451000,4,1284,38,1246,151,12,135,34,2407,55,2352,346,20,275,82
4766000,2452000,1,0,0,0,0,0,0,0,0,0,0,0,0,0,0
4766000,2453000,1,0,0,0,0,0,0,0,0,0,0,0,0,0,0
4766000,2535000,2,0,0,0,0,0,0,0,0,0,0,0,0,0,0
4766000,2567000,1,0,0,0,0,0,0,0,0,0,0,0,0,0,0
4767000,2324000,22,1034,216,818,118,97,0,52,8136,1525,6611,1126,802,0,364
4767000,2339000,1,0,0,0,0,0,0,0,0,0,0,0,0,0,0
4767000,2352000,1,0,0,0,0,0,0,0,0,0,0,0,0,0,0
4767000,2356000,1,0,0,0,0,0,0,0,0,0,0,0,0,0,0
4767000,2411000,1,0,0,0,0,0,0,0,0,0,0,0,0,0,0
4767000,2433000,26,8145,88,8057,896,36,862,346,13033,130,12903,1589,46,1428,643
4767000,2442000,12,2050,13,2037,194,21,255,45,3703,23,3680,497,31,418,95
4767000,2443000,8,998,37,961,99,0,115,16,1903,197,1706,199,0,177,33
4767000,2444000,11,5725,109,5616,745,30,482,316,8842,157,8685,1238,43,825,570
4767000,2445000,15,5854,74,5780,575,23,655,186,10384,107,10277,1124,38,1181,336
4767000,2447000,1,0,0,0,0,0,0,0,0,0,0,0,0,0,0
4767000,2448000,3,772,84,688,59,6,37,12,1490,172,1318,162,7,56,31
4767000,2449000,1,0,0,0,0,0,0,0,0,0,0,0,0,0,0
4767000,2485000,2,0,0,0,0,0,0,0,0,0,0,0,0,0,0
4767000,2534000,1,0,0,0,0,0,0,0,0,0,0,0,0,0,0
4767000,2539000,1,0,0,0,0,0,0,0,0,0,0,0,0,0,0
4767000,2566000,1,0,0,0,0,0,0,0,0,0,0,0,0,0,0
4767000,2568000,3,0,0,0,0,0,0,0,0,0,0,0,0,0,0
4767000,2576000,1,0,0,0,0,0,0,0,0,0,0,0,0,0,0
4768000,2351000,3,78,2,76,6,0,6,0,379,10,369,66,0,24,0
4768000,2352000,2,0,0,0,0,0,0,0,0,0,0,0,0,0,0
4768000,2353000,3,91,0,91,47,13,0,9,830,0,830,535,81,0,62
4768000,2354000,6,163,2,161,85,1,0,6,1484,8,1476,926,11,0,38
4768000,2355000,4,85,19,66,20,12,0,0,550,127,423,102,84,0,0
4768000,2402000,1,0,0,0,0,0,0,0,0,0,0,0,0,0,0
4768000,2431000,3,0,0,0,0,0,0,0,0,0,0,0,0,0,0
4768000,2432000,6,2656,51,2605,257,18,272,53,3911,56,3855,413,21,420,92
4768000,2433000,6,2481,67,2414,251,41,264,70,3917,98,3819,466,57,406,143
4768000,2442000,2,0,0,0,0,0,0,0,0,0,0,0,0,0,0
4768000,2443000,7,0,0,0,0,0,0,0,0,0,0,0,0,0,0
4768000,2444000,8,2076,85,1991,144,32,179,48,3557,138,3419,378,65,318,60
4768000,2526000,1,0,0,0,0,0,0,0,0,0,0,0,0,0,0
4768000,2567000,12,0,0,0,0,0,0,0,0,0,0,0,0,0,0
4769000,2352000,1,0,0,0,0,0,0,0,0,0,0,0,0,0,0
4769000,2354000,48,1627,267,1360,547,130,17,98,13985,2062,11923,5672,1090,123,719
4769000,2357000,1,0,0,0,0,0,0,0,0,0,0,0,0,0,0
4769000,2358000,1,0,0,0,0,0,0,0,0,0,0,0,0,0,0
4769000,2428000,1,0,0,0,0,0,0,0,0,0,0,0,0,0,0
4769000,2429000,3,0,0,0,0,0,0,0,0,0,0,0,0,0,0
4769000,2430000,4,1400,17,1383,193,3,153,68,2332,20,2312,390,3,279,132
4769000,2440000,2,0,0,0,0,0,0,0,0,0,0,0,0,0,0
4769000,2441000,1,0,0,0,0,0,0,0,0,0,0,0,0,0,0
4769000,2443000,7,1793,16,1777,148,1,174,46,2726,24,2702,241,1,287,72
4769000,2450000,1,0,0,0,0,0,0,0,0,0,0,0,0,0,0
4769000,2459000,1,0,0,0,0,0,0,0,0,0,0,0,0,0,0
4769000,2523000,1,0,0,0,0,0,0,0,0,0,0,0,0,0,0
4769000,2537000,1,0,0,0,0,0,0,0,0,0,0,0,0,0,0
4769000,2545000,2,0,0,0,0,0,0,0,0,0,0,0,0,0,0
4769000,2568000,1,0,0,0,0,0,0,0,0,0,0,0,0,0,0
4770000,2317000,15,1070,177,893,134,173,62,96,7853,1162,6691,1257,1401,526,732
4770000,2318000,3,0,0,0,0,0,0,0,0,0,0,0,0,0,0
4770000,2331000,1,0,0,0,0,0,0,0,0,0,0,0,0,0,0
4770000,2339000,1,0,0,0,0,0,0,0,0,0,0,0,0,0,0
4770000,2340000,1,0,0,0,0,0,0,0,0,0,0,0,0,0,0
4770000,2351000,1,0,0,0,0,0,0,0,0,0,0,0,0,0,0
4770000,2352000,44,1670,435,1235,371,211,15,86,11961,2770,9191,3136,1618,156,566
4770000,2355000,2,0,0,0,0,0,0,0,0,0,0,0,0,0,0
4770000,2423000,15,8576,217,8359,675,35,1036,138,12942,350,12592,1213,39,1668,240
4770000,2428000,3,0,0,0,0,0,0,0,0,0,0,0,0,0,0
4770000,2443000,2,0,0,0,0,0,0,0,0,0,0,0,0,0,0
4770000,2445000,2,0,0,0,0,0,0,0,0,0,0,0,0,0,0
4770000,2446000,2,0,0,0,0,0,0,0,0,0,0,0,0,0,0
4770000,2451000,2,0,0,0,0,0,0,0,0,0,0,0,0,0,0
4770000,2535000,1,0,0,0,0,0,0,0,0,0,0,0,0,0,0
4770000,2537000,1,0,0,0,0,0,0,0,0,0,0,0,0,0,0
4771000,2316000,5,300,22,278,30,28,22,23,2713,230,2483,314,216,301,174
4771000,2317000,497,35814,7413,28401,4494,6445,1939,2591,270596,47583,223013,42529,52978,13589,19697
4771000,2318000,39,2761,321,2440,323,761,222,312,18211,2015,16196,2899,5782,1677,1754
4771000,2341000,2,0,0,0,0,0,0,0,0,0,0,0,0,0,0
4771000,2352000,4,0,0,0,0,0,0,0,0,0,0,0,0,0,0
4771000,2354000,1,0,0,0,0,0,0,0,0,0,0,0,0,0,0
4771000,2355000,148,6303,673,5630,1524,1287,62,305,48554,4129,44425,15054,10144,380,2081
4771000,2358000,1,0,0,0,0,0,0,0,0,0,0,0,0,0,0
4771000,2411000,1,0,0,0,0,0,0,0,0,0,0,0,0,0,0
4771000,2422000,4,0,0,0,0,0,0,0,0,0,0,0,0,0,0
4771000,2423000,6,0,0,0,0,0,0,0,0,0,0,0,0,0,0
4771000,2424000,29,7031,104,6927,547,35,904,185,12673,203,12470,1124,50,1559,327
4771000,2437000,1,0,0,0,0,0,0,0,0,0,0,0,0,0,0
4771000,2532000,1,0,0,0,0,0,0,0,0,0,0,0,0,0,0
4771000,2537000,1,0,0,0,0,0,0,0,0,0,0,0,0,0,0
4771000,2538000,3,0,0,0,0,0,0,0,0,0,0,0,0,0,0
4771000,2545000,4,0,0,0,0,0,0,0,0,0,0,0,0,0,0
4771000,2569000,1,0,0,0,0,0,0,0,0,0,0,0,0,0,0
4771000,2570000,1,0,0,0,0,0,0,0,0,0,0,0,0,0,0
4771000,2582000,1,0,0,0,0,0,0,0,0,0,0,0,0,0,0
4772000,2317000,22,774,104,670,137,171,75,67,7520,858,6662,1597,1480,793,677
4772000,2318000,170,16178,1071,15107,4839,2303,1438,1651,142024,8564,133460,52534,18262,9852,15412
4772000,2335000,1,0,0,0,0,0,0,0,0,0,0,0,0,0,0
4772000,2338000,1,0,0,0,0,0,0,0,0,0,0,0,0,0,0
4772000,2352000,23,1076,83,993,93,128,11,40,8416,620,7796,859,1039,83,257
4772000,2353000,62,2091,416,1675,324,224,34,81,15366,2775,12591,3194,1587,205,606
4772000,2358000,1,0,0,0,0,0,0,0,0,0,0,0,0,0,0
4772000,2378000,2,0,0,0,0,0,0,0,0,0,0,0,0,0,0
4772000,2421000,5,0,0,0,0,0,0,0,0,0,0,0,0,0,0
4772000,2422000,11,5406,241,5165,310,124,359,142,7392,349,7043,496,142,573,246
4772000,2435000,5,0,0,0,0,0,0,0,0,0,0,0,0,0,0
4772000,2436000,2,0,0,0,0,0,0,0,0,0,0,0,0,0,0
4772000,2439000,2,0,0,0,0,0,0,0,0,0,0,0,0,0,0
4772000,2556000,1,0,0,0,0,0,0,0,0,0,0,0,0,0,0
4772000,2570000,28,0,0,0,0,0,0,0,0,0,0,0,0,0,0
4773000,2314000,1,0,0,0,0,0,0,0,0,0,0,0,0,0,0
4773000,2317000,1,0,0,0,0,0,0,0,0,0,0,0,0,0,0
4773000,2320000,5,782,20,762,248,45,44,42,4893,148,4745,1888,190,218,260
4773000,2358000,2,0,0,0,0,0,0,0,0,0,0,0,0,0,0
4773000,2381000,1,0,0,0,0,0,0,0,0,0,0,0,0,0,0
4773000,2420000,66,0,0,0,0,0,0,0,0,0,0,0,0,0,0
4773000,2421000,3,0,0,0,0,0,0,0,0,0,0,0,0,0,0
4773000,2423000,1,0,0,0,0,0,0,0,0,0,0,0,0,0,0
4773000,2436000,2,0,0,0,0,0,0,0,0,0,0,0,0,0,0
4773000,2438000,1,0,0,0,0,0,0,0,0,0,0,0,0,0,0
4773000,2439000,1,0,0,0,0,0,0,0,0,0,0,0,0,0,0
4773000,2535000,1,0,0,0,0,0,0,0,0,0,0,0,0,0,0
4773000,2537000,1,0,0,0,0,0,0,0,0,0,0,0,0,0,0
4773000,2561000,2,0,0,0,0,0,0,0,0,0,0,0,0,0,0
4773000,2565000,1,0,0,0,0,0,0,0,0,0,0,0,0,0,0
4773000,2573000,1,0,0,0,0,0,0,0,0,0,0,0,0,0,0
4773000,2580000,2,0,0,0,0,0,0,0,0,0,0,0,0,0,0
4774000,2313000,1,0,0,0,0,0,0,0,0,0,0,0,0,0,0
4774000,2314000,3,101,48,53,11,7,8,4,965,395,570,152,77,96,60
4774000,2315000,4,17493,1598,15895,4167,3818,930,1447,143018,9511,133507,44312,29411,6730,12407
4774000,2316000,26,1481,158,1323,304,67,56,188,11267,1309,9958,3569,520,267,1731
4774000,2328000,1,0,0,0,0,0,0,0,0,0,0,0,0,0,0
4774000,2381000,5,0,0,0,0,0,0,0,0,0,0,0,0,0,0
4774000,2419000,2,0,0,0,0,0,0,0,0,0,0,0,0,0,0
4774000,2516000,15,0,0,0,0,0,0,0,0,0,0,0,0,0,0
4774000,2544000,2,0,0,0,0,0,0,0,0,0,0,0,0,0,0
4774000,2566000,1,0,0,0,0,0,0,0,0,0,0,0,0,0,0
4774000,2578000,5,1062,254,808,77,20,11,18,1770,790,980,86,24,15,22
4774000,2579000,1,0,0,0,0,0,0,0,0,0,0,0,0,0,0
4775000,2313000,12,530,63,467,113,71,24,30,4411,467,3944,1134,609,173,251
4775000,2314000,153,6752,865,5887,993,801,442,507,55582,6592,48990,10462,5886,3993,4549
4775000,2315000,62,2132,274,1858,137,86,112,57,13803,1838,11965,1452,584,772,327
4775000,2316000,202,19671,2053,17618,3157,1474,812,1355,126457,12713,113744,29267,10769,4919,10367
4775000,2319000,2,0,0,0,0,0,0,0,0,0,0,0,0,0,0
4775000,2360000,1,0,0,0,0,0,0,0,0,0,0,0,0,0,0
4775000,2362000,2,0,0,0,0,0,0,0,0,0,0,0,0,0,0
4775000,2541000,1,0,0,0,0,0,0,0,0,0,0,0,0,0,0
4775000,2563000,1,0,0,0,0,0,0,0,0,0,0,0,0,0,0
4775000,2573000,1,0,0,0,0,0,0,0,0,0,0,0,0,0,0
4775000,2576000,2,0,0,0,0,0,0,0,0,0,0,0,0,0,0
4776000,2314000,36,2227,226,2001,533,351,173,270,21601,1985,19616,6542,2923,2067,2648
4776000,2315000,21,1296,80,1216,212,126,70,140,9618,481,9137,2493,941,631,1054
4776000,2316000,55,2201,241,1960,141,62,78,102,14897,1738,13159,1363,450,562,876
4776000,2318000,30,9255,1242,8013,654,3258,176,477,52720,8344,44376,4568,21492,734,2726
4776000,2319000,14,1127,74,1053,197,114,12,158,9239,410,8829,2362,1490,19,1036
4776000,2326000,2,0,0,0,0,0,0,0,0,0,0,0,0,0,0
4776000,2330000,1,0,0,0,0,0,0,0,0,0,0,0,0,0,0
4776000,2342000,1,0,0,0,0,0,0,0,0,0,0,0,0,0,0
4776000,2345000,1,0,0,0,0,0,0,0,0,0,0,0,0,0,0
4776000,2377000,2,0,0,0,0,0,0,0,0,0,0,0,0,0,0
4776000,2416000,1,0,0,0,0,0,0,0,0,0,0,0,0,0,0
4776000,2446000,1,0,0,0,0,0,0,0,0,0,0,0,0,0,0
4776000,2526000,1,0,0,0,0,0,0,0,0,0,0,0,0,0,0
4776000,2556000,1,0,0,0,0,0,0,0,0,0,0,0,0,0,0
4776000,2579000,3,0,0,0,0,0,0,0,0,0,0,0,0,0,0
4776000,2584000,2,0,0,0,0,0,0,0,0,0,0,0,0,0,0
4776000,2591000,1,0,0,0,0,0,0,0,0,0,0,0,0,0,0
4777000,2300000,25,754,191,563,63,273,32,53,6625,1474,5151,799,2578,191,477
4777000,2317000,4,117,2,115,24,8,0,18,1027,6,1021,309,97,0,124
4777000,2318000,266,14309,4096,10213,1625,2606,154,725,113005,30873,82132,16680,20828,1179,5654
4777000,2324000,2,0,0,0,0,0,0,0,0,0,0,0,0,0,0
4777000,2330000,1,0,0,0,0,0,0,0,0,0,0,0,0,0,0
4777000,2341000,2,0,0,0,0,0,0,0,0,0,0,0,0,0,0
4777000,2539000,1,0,0,0,0,0,0,0,0,0,0,0,0,0,0
4777000,2540000,3,278,88,190,18,4,6,10,511,159,352,35,6,10,12
4777000,2541000,1,0,0,0,0,0,0,0,0,0,0,0,0,0,0
4777000,2568000,1,0,0,0,0,0,0,0,0,0,0,0,0,0,0
4777000,2569000,1,0,0,0,0,0,0,0,0,0,0,0,0,0,0
4777000,2571000,1,0,0,0,0,0,0,0,0,0,0,0,0,0,0
4777000,2583000,1,0,0,0,0,0,0,0,0,0,0,0,0,0,0
4778000,2300000,1,0,0,0,0,0,0,0,0,0,0,0,0,0,0
4778000,2315000,5,101,7,94,56,0,0,12,798,44,754,477,0,0,90
4778000,2317000,9,552,62,490,89,92,1,39,5046,501,4545,1066,745,10,427
4778000,2318000,61,2711,714,1997,417,369,40,57,20528,5139,15389,4389,2956,170,368
4778000,2323000,1,0,0,0,0,0,0,0,0,0,0,0,0,0,0
4778000,2324000,1,0,0,0,0,0,0,0,0,0,0,0,0,0,0
4778000,2328000,2,0,0,0,0,0,0,0,0,0,0,0,0,0,0
4778000,2336000,1,0,0,0,0,0,0,0,0,0,0,0,0,0,0
4778000,2515000,3,0,0,0,0,0,0,0,0,0,0,0,0,0,0
4778000,2534000,4,0,0,0,0,0,0,0,0,0,0,0,0,0,0
4778000,2538000,1,0,0,0,0,0,0,0,0,0,0,0,0,0,0
4778000,2540000,2,0,0,0,0,0,0,0,0,0,0,0,0,0,0
4778000,2543000,1,0,0,0,0,0,0,0,0,0,0,0,0,0,0
4778000,2564000,1,0,0,0,0,0,0,0,0,0,0,0,0,0,0
4778000,2570000,3,0,0,0,0,0,0,0,0,0,0,0,0,0,0
4779000,2300000,1,0,0,0,0,0,0,0,0,0,0,0,0,0,0
4779000,2315000,1,0,0,0,0,0,0,0,0,0,0,0,0,0,0
4779000,2327000,1,0,0,0,0,0,0,0,0,0,0,0,0,0,0
4779000,2328000,1,0,0,0,0,0,0,0,0,0,0,0,0,0,0
4779000,2337000,3,0,0,0,0,0,0,0,0,0,0,0,0,0,0
4779000,2359000,1,0,0,0,0,0,0,0,0,0,0,0,0,0,0
4779000,2397000,2,0,0,0,0,0,0,0,0,0,0,0,0,0,0
4779000,2524000,2,0,0,0,0,0,0,0,0,0,0,0,0,0,0
4779000,2536000,2,0,0,0,0,0,0,0,0,0,0,0,0,0,0
4779000,2538000,11,0,0,0,0,0,0,0,0,0,0,0,0,0,0
4779000,2539000,1,0,0,0,0,0,0,0,0,0,0,0,0,0,0
4779000,2540000,4,2374,544,1830,94,57,550,80,3314,739,2575,198,70,641,183
4779000,2541000,1,0,0,0,0,0,0,0,0,0,0,0,0,0,0
4779000,2557000,1,0,0,0,0,0,0,0,0,0,0,0,0,0,0
4779000,2560000,2,0,0,0,0,0,0,0,0,0,0,0,0,0,0
4779000,2568000,2,0,0,0,0,0,0,0,0,0,0,0,0,0,0
4779000,2571000,1,0,0,0,0,0,0,0,0,0,0,0,0,0,0
4779000,2589000,2,0,0,0,0,0,0,0,0,0,0,0,0,0,0
4780000,2329000,1,0,0,0,0,0,0,0,0,0,0,0,0,0,0
4780000,2538000,6,448,208,240,14,28,5,6,1272,418,854,30,44,13,26
4780000,2539000,3,0,0,0,0,0,0,0,0,0,0,0,0,0,0
4780000,2558000,5,0,0,0,0,0,0,0,0,0,0,0,0,0,0
4781000,2326000,1,0,0,0,0,0,0,0,0,0,0,0,0,0,0
4781000,2374000,2,0,0,0,0,0,0,0,0,0,0,0,0,0,0
4781000,2531000,1,0,0,0,0,0,0,0,0,0,0,0,0,0,0
4781000,2537000,5,315,101,214,16,18,5,22,1678,867,811,56,36,18,51
4781000,2538000,1,0,0,0,0,0,0,0,0,0,0,0,0,0,0
4781000,2540000,1,0,0,0,0,0,0,0,0,0,0,0,0,0,0
4781000,2541000,2,0,0,0,0,0,0,0,0,0,0,0,0,0,0
4781000,2542000,1,0,0,0,0,0,0,0,0,0,0,0,0,0,0
4781000,2543000,2,0,0,0,0,0,0,0,0,0,0,0,0,0,0
4781000,2544000,1,0,0,0,0,0,0,0,0,0,0,0,0,0,0
4781000,2558000,1,0,0,0,0,0,0,0,0,0,0,0,0,0,0
4781000,2581000,1,0,0,0,0,0,0,0,0,0,0,0,0,0,0
4782000,2304000,38,1150,195,955,114,233,106,126,8994,1410,7584,1048,1804,841,1000
4782000,2313000,1,0,0,0,0,0,0,0,0,0,0,0,0,0,0
4782000,2317000,1,0,0,0,0,0,0,0,0,0,0,0,0,0,0
4782000,2320000,2,0,0,0,0,0,0,0,0,0,0,0,0,0,0
4782000,2360000,3,0,0,0,0,0,0,0,0,0,0,0,0,0,0
4782000,2415000,1,0,0,0,0,0,0,0,0,0,0,0,0,0,0
4782000,2481000,1,0,0,0,0,0,0,0,0,0,0,0,0,0,0
4782000,2532000,1,0,0,0,0,0,0,0,0,0,0,0,0,0,0
4782000,2535000,1,0,0,0,0,0,0,0,0,0,0,0,0,0,0
4782000,2537000,6,779,192,587,78,37,14,25,1866,391,1475,211,70,49,43
4782000,2538000,4,0,0,0,0,0,0,0,0,0,0,0,0,0,0
4782000,2539000,1,0,0,0,0,0,0,0,0,0,0,0,0,0,0
4782000,2540000,6,97,40,57,0,4,2,0,1140,463,677,2,8,9,4
4782000,2541000,4,1366,582,784,62,22,47,22,3327,1670,1657,138,39,101,41
4782000,2542000,5,55,0,55,0,0,0,1,283,0,283,0,0,0,3
4782000,2543000,1,0,0,0,0,0,0,0,0,0,0,0,0,0,0
4782000,2544000,1,0,0,0,0,0,0,0,0,0,0,0,0,0,0
4782000,2550000,1,0,0,0,0,0,0,0,0,0,0,0,0,0,0
4782000,2565000,1,0,0,0,0,0,0,0,0,0,0,0,0,0,0
4783000,2312000,23,952,89,863,133,47,15,23,7716,731,6985,1362,351,100,165
4783000,2313000,1,0,0,0,0,0,0,0,0,0,0,0,0,0,0
4783000,2335000,1,0,0,0,0,0,0,0,0,0,0,0,0,0,0
4783000,2535000,3,289,132,157,2,26,5,12,491,202,289,2,33,26,28
4783000,2536000,3,0,0,0,0,0,0,0,0,0,0,0,0,0,0
4783000,2537000,2,0,0,0,0,0,0,0,0,0,0,0,0,0,0
4783000,2538000,6,1299,206,1093,66,41,55,20,2824,466,2358,159,61,110,43
4783000,2539000,6,0,0,0,0,0,0,0,0,0,0,0,0,0,0
4783000,2540000,26,2295,752,1543,85,60,122,50,6379,2074,4305,297,115,359,134
4783000,2541000,4,180,64,116,6,2,9,2,307,128,179,9,2,13,4
4783000,2550000,1,0,0,0,0,0,0,0,0,0,0,0,0,0,0
4783000,2558000,4,0,0,0,0,0,0,0,0,0,0,0,0,0,0
4783000,2561000,2,0,0,0,0,0,0,0,0,0,0,0,0,0,0
4783000,2573000,1,0,0,0,0,0,0,0,0,0,0,0,0,0,0
4784000,2311000,366,21191,2908,18283,2467,1448,437,1606,162113,18958,143155,23729,11066,3189,10548
4784000,2312000,17,798,167,631,93,33,20,26,5584,1024,4560,704,238,150,147
4784000,2322000,1,0,0,0,0,0,0,0,0,0,0,0,0,0,0
4784000,2394000,1,0,0,0,0,0,0,0,0,0,0,0,0,0,0
4784000,2536000,5,1431,692,739,54,106,19,19,2716,1215,1501,130,226,34,55
4784000,2537000,1,0,0,0,0,0,0,0,0,0,0,0,0,0,0
4784000,2538000,6,4144,1594,2550,159,212,135,70,7355,2590,4765,261,382,276,120
4784000,2539000,4,282,57,225,16,3,19,5,574,97,477,52,12,59,12
4784000,2540000,45,9304,871,8433,542,186,336,167,21818,1784,20034,1389,355,1027,396
4784000,2541000,4,1645,172,1473,124,35,86,68,3067,337,2730,224,44,108,105
4784000,2542000,2,0,0,0,0,0,0,0,0,0,0,0,0,0,0
4784000,2543000,2,0,0,0,0,0,0,0,0,0,0,0,0,0,0
4784000,2544000,1,0,0,0,0,0,0,0,0,0,0,0,0,0,0
4784000,2560000,1,0,0,0,0,0,0,0,0,0,0,0,0,0,0
4784000,2566000,1,0,0,0,0,0,0,0,0,0,0,0,0,0,0
4785000,2311000,59,3337,227,3110,539,326,33,183,25911,1299,24612,5395,2312,187,1237
4785000,2312000,59,3617,303,3314,544,269,43,242,27799,1729,26070,5496,1902,370,1640
4785000,2315000,1,0,0,0,0,0,0,0,0,0,0,0,0,0,0
4785000,2316000,1,0,0,0,0,0,0,0,0,0,0,0,0,0,0
4785000,2325000,1,0,0,0,0,0,0,0,0,0,0,0,0,0,0
4785000,2327000,3,0,0,0,0,0,0,0,0,0,0,0,0,0,0
4785000,2536000,9,1010,385,625,29,80,29,22,1560,594,966,38,117,32,26
4785000,2537000,1,0,0,0,0,0,0,0,0,0,0,0,0,0,0
4785000,2538000,1,0,0,0,0,0,0,0,0,0,0,0,0,0,0
4785000,2539000,5,250,58,192,11,10,9,4,883,136,747,25,10,47,10
4785000,2540000,43,10385,879,9506,582,170,396,312,22350,1872,20478,1199,284,783,543
4785000,2541000,1503,953374,138450,814924,47718,19592,47320,25855,1698520,244319,1454201,90521,31481,92143,42471
4785000,2542000,14,749,199,550,34,42,64,12,2963,546,2417,102,96,168,26
4785000,2543000,2,0,0,0,0,0,0,0,0,0,0,0,0,0,0
4785000,2545000,2,0,0,0,0,0,0,0,0,0,0,0,0,0,0
4786000,2311000,54,4650,426,4224,554,492,81,217,31632,2889,28743,4304,3137,513,1519
4786000,2312000,176,9125,1813,7312,1023,833,213,548,59488,10118,49370,8931,4524,1300,3315
4786000,2313000,44,1767,421,1346,218,112,28,64,13044,3188,9856,1945,766,218,414
4786000,2320000,1,0,0,0,0,0,0,0,0,0,0,0,0,0,0
4786000,2361000,1,0,0,0,0,0,0,0,0,0,0,0,0,0,0
4786000,2382000,1,0,0,0,0,0,0,0,0,0,0,0,0,0,0
4786000,2497000,1,0,0,0,0,0,0,0,0,0,0,0,0,0,0
4786000,2538000,2,0,0,0,0,0,0,0,0,0,0,0,0,0,0
4786000,2539000,21,2481,668,1813,124,52,72,55,7259,1618,5641,342,115,169,217
4786000,2540000,25,1932,444,1488,85,43,144,40,4767,938,3829,213,60,361,75
4786000,2541000,7,1009,95,914,112,31,79,64,2023,316,1707,191,57,160,95
4786000,2542000,9,887,283,604,65,21,31,10,2558,673,1885,171,34,72,32
4786000,2543000,3,143,64,79,5,4,11,3,1157,230,927,85,12,19,9
4786000,2544000,1,0,0,0,0,0,0,0,0,0,0,0,0,0,0
4786000,2545000,2,0,0,0,0,0,0,0,0,0,0,0,0,0,0
4786000,2546000,1,0,0,0,0,0,0,0,0,0,0,0,0,0,0
4786000,2558000,1,0,0,0,0,0,0,0,0,0,0,0,0,0,0
4786000,2560000,1,0,0,0,0,0,0,0,0,0,0,0,0,0,0
4786000,2587000,1,0,0,0,0,0,0,0,0,0,0,0,0,0,0
4787000,2309000,35,830,169,661,58,127,52,93,7316,1542,5774,540,957,610,820
4787000,2311000,3,375,19,356,24,44,4,24,2149,93,2056,159,308,14,124
4787000,2312000,1027,163710,32463,131247,15117,11574,3286,9838,817436,118187,699249,105728,63047,13888,50005
4787000,2313000,8,210,7,203,69,6,3,13,1673,53,1620,604,48,18,77
4787000,2328000,1,0,0,0,0,0,0,0,0,0,0,0,0,0,0
4787000,2523000,1,0,0,0,0,0,0,0,0,0,0,0,0,0,0
4787000,2531000,2,0,0,0,0,0,0,0,0,0,0,0,0,0,0
4787000,2533000,1,0,0,0,0,0,0,0,0,0,0,0,0,0,0
4787000,2536000,2,0,0,0,0,0,0,0,0,0,0,0,0,0,0
4787000,2537000,3,62,37,25,0,3,6,1,272,113,159,0,6,20,3
4787000,2538000,1,0,0,0,0,0,0,0,0,0,0,0,0,0,0
4787000,2539000,13,13273,3417,9856,659,456,411,593,22335,5465,16870,1090,679,675,872
4787000,2540000,4,325,49,276,18,3,9,6,665,133,532,39,3,17,13
4787000,2541000,10,269,130,139,19,6,13,3,1860,664,1196,74,12,43,14
4787000,2542000,8,403,186,217,12,9,41,8,2018,1028,990,65,21,269,14
4787000,2543000,3,319,133,186,9,5,25,18,710,369,341,10,12,57,28
4787000,2544000,3,400,95,305,24,4,17,9,762,150,612,65,4,27,20
4787000,2559000,1,0,0,0,0,0,0,0,0,0,0,0,0,0,0
4787000,2561000,2,0,0,0,0,0,0,0,0,0,0,0,0,0,0
4787000,2585000,1,0,0,0,0,0,0,0,0,0,0,0,0,0,0
4787000,2590000,1,0,0,0,0,0,0,0,0,0,0,0,0,0,0
4788000,2308000,30,1171,588,583,159,44,31,47,10009,5155,4854,1398,411,304,337
4788000,2309000,6,0,0,0,0,0,0,0,0,0,0,0,0,0,0
4788000,2310000,2,0,0,0,0,0,0,0,0,0,0,0,0,0,0
4788000,2311000,346,28116,2440,25676,2424,3158,217,1161,203941,16090,187851,22947,22948,1621,8267
4788000,2312000,22,1644,315,1329,89,196,23,38,10291,1671,8620,813,1182,145,192
4788000,2315000,1,0,0,0,0,0,0,0,0,0,0,0,0,0,0
4788000,2328000,1,0,0,0,0,0,0,0,0,0,0,0,0,0,0
4788000,2482000,1,0,0,0,0,0,0,0,0,0,0,0,0,0,0
4788000,2537000,1,0,0,0,0,0,0,0,0,0,0,0,0,0,0
4788000,2539000,2,0,0,0,0,0,0,0,0,0,0,0,0,0,0
4788000,2540000,3,91,46,45,2,7,0,0,402,139,263,3,10,0,0
4788000,2542000,1,0,0,0,0,0,0,0,0,0,0,0,0,0,0
4788000,2543000,2,0,0,0,0,0,0,0,0,0,0,0,0,0,0
4788000,2558000,1,0,0,0,0,0,0,0,0,0,0,0,0,0,0
4789000,2308000,4,58,1,57,0,6,0,3,559,3,556,0,16,0,13
4789000,2310000,26,1157,95,1062,109,175,19,43,9698,713,8985,1180,1544,238,354
4789000,2311000,16,642,69,573,124,61,21,13,5367,507,4860,1357,504,206,91
4789000,2316000,1,0,0,0,0,0,0,0,0,0,0,0,0,0,0
4789000,2327000,1,0,0,0,0,0,0,0,0,0,0,0,0,0,0
4789000,2374000,11,492,119,373,41,16,76,7,1232,484,748,80,20,266,13
4789000,2377000,1,0,0,0,0,0,0,0,0,0,0,0,0,0,0
4789000,2482000,6,0,0,0,0,0,0,0,0,0,0,0,0,0,0
4789000,2483000,16,17356,9627,7729,115,928,141,98,49698,36577,13121,448,2473,399,249
4789000,2504000,1,0,0,0,0,0,0,0,0,0,0,0,0,0,0
4789000,2506000,1,0,0,0,0,0,0,0,0,0,0,0,0,0,0
4789000,2532000,2,0,0,0,0,0,0,0,0,0,0,0,0,0,0
4789000,2533000,4,0,0,0,0,0,0,0,0,0,0,0,0,0,0
4789000,2541000,3,232,88,144,12,4,8,6,904,289,615,27,15,38,29
4789000,2544000,1,0,0,0,0,0,0,0,0,0,0,0,0,0,0
4789000,2545000,2,0,0,0,0,0,0,0,0,0,0,0,0,0,0
4789000,2546000,1,0,0,0,0,0,0,0,0,0,0,0,0,0,0
4789000,2563000,1,0,0,0,0,0,0,0,0,0,0,0,0,0,0
4789000,2593000,1,0,0,0,0,0,0,0,0,0,0,0,0,0,0
4789000,2597000,1,0,0,0,0,0,0,0,0,0,0,0,0,0,0
4790000,2315000,33,1990,213,1777,368,69,85,116,10761,993,9768,3229,419,350,687
4790000,2316000,1,0,0,0,0,0,0,0,0,0,0,0,0,0,0
4790000,2484000,1,0,0,0,0,0,0,0,0,0,0,0,0,0,0
4790000,2540000,1,0,0,0,0,0,0,0,0,0,0,0,0,0,0
4790000,2543000,2,0,0,0,0,0,0,0,0,0,0,0,0,0,0
4790000,2544000,1,0,0,0,0,0,0,0,0,0,0,0,0,0,0
4790000,2572000,1,0,0,0,0,0,0,0,0,0,0,0,0,0,0
4790000,2598000,1,0,0,0,0,0,0,0,0,0,0,0,0,0,0
4791000,2305000,3,44,16,28,6,7,5,0,376,125,251,69,49,67,0
4791000,2306000,4,53,20,33,0,4,0,0,416,159,257,0,48,0,0
4791000,2309000,2,0,0,0,0,0,0,0,0,0,0,0,0,0,0
4791000,2312000,2,0,0,0,0,0,0,0,0,0,0,0,0,0,0
4791000,2504000,1,0,0,0,0,0,0,0,0,0,0,0,0,0,0
4791000,2541000,2,0,0,0,0,0,0,0,0,0,0,0,0,0,0
4791000,2544000,1,0,0,0,0,0,0,0,0,0,0,0,0,0,0
4791000,2545000,1,0,0,0,0,0,0,0,0,0,0,0,0,0,0
4792000,2305000,35,8741,817,7924,778,130,254,136,36290,4917,31373,3581,739,1239,901
4792000,2306000,6,57,29,28,0,6,7,4,632,282,350,0,44,86,26
4792000,2309000,22,724,35,689,246,80,6,54,7491,357,7134,3142,671,35,512
4792000,2312000,1,0,0,0,0,0,0,0,0,0,0,0,0,0,0
4792000,2317000,34,1043,93,950,483,57,25,42,9210,664,8546,5451,526,123,388
4792000,2318000,6,188,17,171,67,11,3,25,1832,111,1721,674,72,12,529
4792000,2529000,1,0,0,0,0,0,0,0,0,0,0,0,0,0,0
4792000,2530000,2,0,0,0,0,0,0,0,0,0,0,0,0,0,0
4792000,2532000,1,0,0,0,0,0,0,0,0,0,0,0,0,0,0
4792000,2534000,1,0,0,0,0,0,0,0,0,0,0,0,0,0,0
4792000,2536000,1,0,0,0,0,0,0,0,0,0,0,0,0,0,0
4792000,2540000,1,0,0,0,0,0,0,0,0,0,0,0,0,0,0
4792000,2542000,1,0,0,0,0,0,0,0,0,0,0,0,0,0,0
4792000,2545000,2,0,0,0,0,0,0,0,0,0,0,0,0,0,0
4792000,2590000,1,0,0,0,0,0,0,0,0,0,0,0,0,0,0
4792000,2602000,1,0,0,0,0,0,0,0,0,0,0,0,0,0,0
4793000,2313000,1,0,0,0,0,0,0,0,0,0,0,0,0,0,0
4793000,2323000,2,0,0,0,0,0,0,0,0,0,0,0,0,0,0
4793000,2383000,1,0,0,0,0,0,0,0,0,0,0,0,0,0,0
4793000,2518000,2,0,0,0,0,0,0,0,0,0,0,0,0,0,0
4793000,2530000,3,23,3,20,2,0,0,4,34,3,31,2,0,0,4
4793000,2531000,2,0,0,0,0,0,0,0,0,0,0,0,0,0,0
4793000,2532000,23,11836,2146,9690,419,287,230,118,16090,2842,13248,574,486,299,139
4793000,2567000,2,0,0,0,0,0,0,0,0,0,0,0,0,0,0
4794000,2307000,8,425,40,385,35,39,9,0,2928,263,2665,193,350,32,0
4794000,2312000,3,91,7,84,13,4,10,0,353,36,317,33,4,15,0
4794000,2315000,4,132,19,113,21,23,0,3,798,136,662,133,185,0,9
4794000,2316000,22,942,129,813,249,45,20,61,6743,848,5895,2460,293,116,393
4794000,2401000,1,0,0,0,0,0,0,0,0,0,0,0,0,0,0
4794000,2513000,1,0,0,0,0,0,0,0,0,0,0,0,0,0,0
4794000,2530000,2,0,0,0,0,0,0,0,0,0,0,0,0,0,0
4794000,2531000,3,0,0,0,0,0,0,0,0,0,0,0,0,0,0
4794000,2532000,2,0,0,0,0,0,0,0,0,0,0,0,0,0,0
4794000,2540000,1,0,0,0,0,0,0,0,0,0,0,0,0,0,0
4794000,2563000,7,0,0,0,0,0,0,0,0,0,0,0,0,0,0
4795000,2306000,1,0,0,0,0,0,0,0,0,0,0,0,0,0,0
4795000,2310000,17,860,80,780,66,7,69,23,2432,316,2116,186,12,158,78
4795000,2311000,47,3314,286,3028,297,105,258,75,10625,983,9642,1148,403,840,279
4795000,2312000,23,1500,107,1393,157,41,75,65,5795,257,5538,835,152,284,296
4795000,2314000,1,0,0,0,0,0,0,0,0,0,0,0,0,0,0
4795000,2315000,3,73,8,65,14,10,0,0,430,44,386,70,54,0,0
4795000,2316000,10,252,11,241,82,52,13,9,2149,58,2091,965,470,53,85
4795000,2323000,4,0,0,0,0,0,0,0,0,0,0,0,0,0,0
4795000,2332000,1,0,0,0,0,0,0,0,0,0,0,0,0,0,0
4795000,2402000,4,0,0,0,0,0,0,0,0,0,0,0,0,0,0
4795000,2540000,1,0,0,0,0,0,0,0,0,0,0,0,0,0,0
4795000,2543000,11,12060,4857,7203,674,228,680,947,19564,7807,11757,1423,342,1298,1717
4795000,2546000,3,0,0,0,0,0,0,0,0,0,0,0,0,0,0
4795000,2562000,2,0,0,0,0,0,0,0,0,0,0,0,0,0,0
4796000,2306000,13,959,98,861,142,102,27,33,5655,466,5189,1196,422,96,226
4796000,2307000,2,0,0,0,0,0,0,0,0,0,0,0,0,0,0
4796000,2308000,3,105,9,96,9,0,7,4,525,163,362,19,0,27,18
4796000,2310000,516,207928,33569,174359,27863,6383,6922,12972,956897,96905,859992,182005,31163,26699,69342
4796000,2311000,50,3728,391,3337,353,64,188,68,13216,2228,10988,1951,220,441,251
4796000,2312000,10,472,32,440,44,21,33,8,2009,170,1839,273,61,52,64
4796000,2313000,5,312,18,294,57,5,17,26,1680,71,1609,427,13,23,155
4796000,2314000,3,342,5,337,49,3,6,0,2299,21,2278,329,27,42,0
4796000,2315000,5,180,13,167,27,6,2,2,754,37,717,229,28,4,7
4796000,2316000,36,2555,189,2366,474,99,120,123,11371,928,10443,3312,526,482,662
4796000,2321000,4,460,8,452,39,8,35,9,888,26,862,86,9,68,13
4796000,2501000,1,0,0,0,0,0,0,0,0,0,0,0,0,0,0
4797000,2306000,10,880,140,740,127,24,39,45,4928,515,4413,943,106,224,212
4797000,2308000,6,286,41,245,15,1,33,8,882,158,724,70,1,86,21
4797000,2309000,21,850,78,772,85,3,77,22,3533,513,3020,458,14,312,75
4797000,2310000,20,709,71,638,51,18,75,18,2152,435,1717,153,71,209,67
4797000,2312000,1,0,0,0,0,0,0,0,0,0,0,0,0,0,0
4797000,2313000,6,628,67,561,101,2,27,11,2361,541,1820,688,6,56,12
4797000,2314000,2,0,0,0,0,0,0,0,0,0,0,0,0,0,0
4797000,2315000,2,0,0,0,0,0,0,0,0,0,0,0,0,0,0
4797000,2320000,6,1534,49,1485,395,36,178,72,2243,79,2164,546,53,235,116
4797000,2321000,5,1107,50,1057,74,26,85,16,1778,80,1698,150,52,158,24
4797000,2528000,1,0,0,0,0,0,0,0,0,0,0,0,0,0,0
4797000,2529000,1,0,0,0,0,0,0,0,0,0,0,0,0,0,0
4797000,2543000,1,0,0,0,0,0,0,0,0,0,0,0,0,0,0
4797000,2546000,1,0,0,0,0,0,0,0,0,0,0,0,0,0,0
4798000,2303000,402,22394,2626,19768,2757,1440,594,890,160877,13400,147477,26071,10155,4056,6368
4798000,2306000,2,0,0,0,0,0,0,0,0,0,0,0,0,0,0
4798000,2307000,4,231,25,206,22,0,26,7,873,58,815,173,0,68,33
4798000,2309000,3,131,8,123,13,7,15,2,482,34,448,27,49,116,2
4798000,2312000,2,0,0,0,0,0,0,0,0,0,0,0,0,0,0
4798000,2314000,2,0,0,0,0,0,0,0,0,0,0,0,0,0,0
4798000,2319000,51,14615,1885,12730,1684,308,711,819,30694,5547,25147,3580,679,1401,1516
4798000,2320000,5,1128,35,1093,150,18,80,52,2074,50,2024,382,30,113,88
4798000,2323000,2,0,0,0,0,0,0,0,0,0,0,0,0,0,0
4798000,2489000,1,0,0,0,0,0,0,0,0,0,0,0,0,0,0
4798000,2543000,1,0,0,0,0,0,0,0,0,0,0,0,0,0,0
4798000,2547000,3,0,0,0,0,0,0,0,0,0,0,0,0,0,0
4798000,2593000,2,0,0,0,0,0,0,0,0,0,0,0,0,0,0
4798000,2600000,1,0,0,0,0,0,0,0,0,0,0,0,0,0,0
4799000,2293000,19,821,52,769,107,9,29,30,6029,380,5649,922,63,204,197
4799000,2294000,30,0,0,0,0,0,0,0,0,0,0,0,0,0,0
4799000,2295000,6,523,3,520,90,23,5,10,3956,20,3936,816,159,59,100
4799000,2296000,9,1428,102,1326,85,118,18,54,9897,440,9457,686,778,82,420
4799000,2298000,165,10750,394,10356,1407,334,347,599,83346,2378,80968,13179,2390,2679,4391
4799000,2306000,1,0,0,0,0,0,0,0,0,0,0,0,0,0,0
4799000,2307000,1,0,0,0,0,0,0,0,0,0,0,0,0,0,0
4799000,2310000,1,0,0,0,0,0,0,0,0,0,0,0,0,0,0
4799000,2311000,1,0,0,0,0,0,0,0,0,0,0,0,0,0,0
4799000,2317000,2,0,0,0,0,0,0,0,0,0,0,0,0,0,0
4799000,2318000,1,0,0,0,0,0,0,0,0,0,0,0,0,0,0
4799000,2319000,1,0,0,0,0,0,0,0,0,0,0,0,0,0,0
4799000,2323000,1,0,0,0,0,0,0,0,0,0,0,0,0,0,0
4799000,2330000,1,0,0,0,0,0,0,0,0,0,0,0,0,0,0
4799000,2594000,1,0,0,0,0,0,0,0,0,0,0,0,0,0,0
4800000,2294000,475,55829,2832,52997,9666,3843,1754,4476,382702,17902,364800,69758,31557,9067,30125
4800000,2295000,45,2615,109,2506,273,73,30,175,18866,772,18094,2273,584,161,1157
4800000,2296000,2,0,0,0,0,0,0,0,0,0,0,0,0,0,0
4800000,2297000,9,540,22,518,33,10,26,27,4123,139,3984,312,58,170,222
4800000,2299000,1,0,0,0,0,0,0,0,0,0,0,0,0,0,0
4800000,2302000,3,54,0,54,4,0,1,2,526,0,526,28,0,7,12
4800000,2310000,12,439,30,409,192,0,13,54,4034,209,3825,2025,0,65,434
4800000,2317000,3,243,13,230,34,1,19,10,454,14,440,138,1,21,22
4800000,2323000,1,0,0,0,0,0,0,0,0,0,0,0,0,0,0
4800000,2534000,4,60,12,48,1,4,5,1,93,22,71,4,5,5,1
4800000,2563000,2,0,0,0,0,0,0,0,0,0,0,0,0,0,0
4800000,2577000,1,0,0,0,0,0,0,0,0,0,0,0,0,0,0
4801000,2289000,1,0,0,0,0,0,0,0,0,0,0,0,0,0,0
4801000,2290000,16,678,32,646,48,31,3,19,5645,235,5410,503,215,29,169
4801000,2294000,2,0,0,0,0,0,0,0,0,0,0,0,0,0,0
4801000,2299000,26,1212,75,1137,143,196,11,43,11405,666,10739,1906,1797,117,365
4801000,2302000,24,1968,164,1804,450,303,69,105,14989,1102,13887,4306,2509,349,887
4801000,2304000,241,12223,921,11302,1390,733,288,304,98469,7041,91428,13996,6010,2364,2326
4801000,2315000,26,19010,1021,17989,2249,113,575,418,29200,1649,27551,5004,247,907,678
4801000,2316000,1,0,0,0,0,0,0,0,0,0,0,0,0,0,0
4801000,2317000,1,0,0,0,0,0,0,0,0,0,0,0,0,0,0
4801000,2574000,1,0,0,0,0,0,0,0,0,0,0,0,0,0,0
4801000,2617000,1,0,0,0,0,0,0,0,0,0,0,0,0,0,0
4802000,2289000,147,9895,408,9487,1070,505,171,483,75667,2358,73309,9480,3971,1075,3263
4802000,2290000,11,0,0,0,0,0,0,0,0,0,0,0,0,0,0
4802000,2293000,5,129,46,83,6,7,14,13,886,298,588,63,46,67,112
4802000,2294000,6,387,29,358,46,5,16,47,3043,232,2811,411,32,104,336
4802000,2295000,4,88,15,73,16,4,4,2,650,93,557,119,28,12,6
4802000,2299000,303,16279,1448,14831,1651,2103,366,622,138724,11847,126877,17844,19780,2925,6058
4802000,2300000,3,70,5,65,0,5,2,0,418,24,394,0,5,8,0
4802000,2309000,1,0,0,0,0,0,0,0,0,0,0,0,0,0,0
4802000,2315000,5,356,27,329,48,6,25,18,1014,57,957,165,17,51,31
4802000,2554000,1,0,0,0,0,0,0,0,0,0,0,0,0,0,0
4802000,2615000,3,0,0,0,0,0,0,0,0,0,0,0,0,0,0
4803000,2288000,57,3602,214,3388,255,148,56,99,30746,1859,28887,2987,1139,429,687
4803000,2289000,82,4664,235,4429,297,237,62,242,39445,2154,37291,2905,1898,458,2024
4803000,2298000,1,0,0,0,0,0,0,0,0,0,0,0,0,0,0
4803000,2326000,1,0,0,0,0,0,0,0,0,0,0,0,0,0,0
4803000,2329000,4,0,0,0,0,0,0,0,0,0,0,0,0,0,0
4803000,2575000,1,0,0,0,0,0,0,0,0,0,0,0,0,0,0
4803000,2619000,1,0,0,0,0,0,0,0,0,0,0,0,0,0,0
4804000,2284000,14,0,0,0,0,0,0,0,0,0,0,0,0,0,0
4804000,2285000,81,4651,149,4502,697,308,63,218,40204,1114,39090,7320,2872,485,1705
4804000,2286000,28,1212,30,1182,170,81,22,33,10259,325,9934,1770,592,173,229
4804000,2287000,23,2314,78,2236,126,159,22,121,15397,431,14966,1055,1174,130,727
4804000,2288000,297,20065,2078,17987,1743,763,369,1093,145767,13675,132092,13133,5742,2125,6320
4804000,2289000,23,1491,133,1358,117,64,29,25,11498,847,10651,1098,474,247,232
4804000,2291000,2,0,0,0,0,0,0,0,0,0,0,0,0,0,0
4804000,2297000,2,0,0,0,0,0,0,0,0,0,0,0,0,0,0
4804000,2304000,7,322,34,288,88,2,38,29,1688,66,1622,683,2,130,155
4804000,2324000,1,0,0,0,0,0,0,0,0,0,0,0,0,0,0
4804000,2325000,1,0,0,0,0,0,0,0,0,0,0,0,0,0,0
4804000,2326000,2,0,0,0,0,0,0,0,0,0,0,0,0,0,0
4804000,2334000,3,0,0,0,0,0,0,0,0,0,0,0,0,0,0
4804000,2618000,1,0,0,0,0,0,0,0,0,0,0,0,0,0,0
4805000,2285000,1,0,0,0,0,0,0,0,0,0,0,0,0,0,0
4805000,2286000,142,8597,303,8294,1310,427,94,328,73636,2181,71455,14023,3839,738,2828
4805000,2287000,16,1019,32,987,160,24,29,35,8557,178,8379,1617,176,110,379
4805000,2288000,67,4174,153,4021,659,293,38,345,37185,1198,35987,7255,2604,385,2820
4805000,2289000,102,6439,333,6106,758,297,43,173,52860,2345,50515,7839,2401,269,1431
4805000,2293000,1,0,0,0,0,0,0,0,0,0,0,0,0,0,0
4805000,2304000,1,0,0,0,0,0,0,0,0,0,0,0,0,0,0
4805000,2317000,4,0,0,0,0,0,0,0,0,0,0,0,0,0,0
4805000,2319000,2,0,0,0,0,0,0,0,0,0,0,0,0,0,0
4805000,2323000,1,0,0,0,0,0,0,0,0,0,0,0,0,0,0
4805000,2324000,3,367,55,312,75,0,28,14,1011,69,942,319,0,85,36
4805000,2337000,1,0,0,0,0,0,0,0,0,0,0,0,0,0,0
4805000,2517000,1,0,0,0,0,0,0,0,0,0,0,0,0,0,0
4805000,2541000,2,0,0,0,0,0,0,0,0,0,0,0,0,0,0
4805000,2557000,1,0,0,0,0,0,0,0,0,0,0,0,0,0,0
4805000,2616000,1,0,0,0,0,0,0,0,0,0,0,0,0,0,0
4805000,2618000,2,0,0,0,0,0,0,0,0,0,0,0,0,0,0
4805000,2619000,1,0,0,0,0,0,0,0,0,0,0,0,0,0,0
4806000,2284000,66,3630,181,3449,487,238,53,147,32459,1282,31177,4819,2151,538,1194
4806000,2285000,3,0,0,0,0,0,0,0,0,0,0,0,0,0,0
4806000,2287000,6,366,27,339,21,26,0,3,2486,155,2331,196,183,0,13
4806000,2289000,3,0,0,0,0,0,0,0,0,0,0,0,0,0,0
4806000,2290000,1,0,0,0,0,0,0,0,0,0,0,0,0,0,0
4806000,2304000,4,132,39,93,5,0,4,0,832,259,573,21,0,36,0
4806000,2324000,1,0,0,0,0,0,0,0,0,0,0,0,0,0,0
4806000,2327000,1,0,0,0,0,0,0,0,0,0,0,0,0,0,0
4806000,2335000,1,0,0,0,0,0,0,0,0,0,0,0,0,0,0
4806000,2339000,3,114,0,114,16,9,4,7,654,0,654,78,46,18,20
4806000,2393000,1,0,0,0,0,0,0,0,0,0,0,0,0,0,0
4806000,2505000,1,0,0,0,0,0,0,0,0,0,0,0,0,0,0
4806000,2508000,1,0,0,0,0,0,0,0,0,0,0,0,0,0,0
4806000,2561000,1,0,0,0,0,0,0,0,0,0,0,0,0,0,0
4806000,2581000,1,0,0,0,0,0,0,0,0,0,0,0,0,0,0
4806000,2618000,1,0,0,0,0,0,0,0,0,0,0,0,0,0,0
4806000,2619000,1,0,0,0,0,0,0,0,0,0,0,0,0,0,0
4807000,2284000,25,858,61,797,97,56,26,34,7543,546,6997,1190,471,186,264
4807000,2285000,4,130,3,127,45,13,0,7,1226,36,1190,461,98,0,67
4807000,2286000,9,461,3,458,134,15,10,30,4199,19,4180,1344,101,113,307
4807000,2290000,1,0,0,0,0,0,0,0,0,0,0,0,0,0,0
4807000,2295000,2,0,0,0,0,0,0,0,0,0,0,0,0,0,0
4807000,2307000,1,0,0,0,0,0,0,0,0,0,0,0,0,0,0
4807000,2314000,1,0,0,0,0,0,0,0,0,0,0,0,0,0,0
4807000,2316000,2,0,0,0,0,0,0,0,0,0,0,0,0,0,0
4807000,2320000,1,0,0,0,0,0,0,0,0,0,0,0,0,0,0
4807000,2562000,1,0,0,0,0,0,0,0,0,0,0,0,0,0,0
4807000,2591000,1,0,0,0,0,0,0,0,0,0,0,0,0,0,0
4807000,2615000,1,0,0,0,0,0,0,0,0,0,0,0,0,0,0
4807000,2618000,7,0,0,0,0,0,0,0,0,0,0,0,0,0,0
4807000,2619000,4,0,0,0,0,0,0,0,0,0,0,0,0,0,0
4807000,2620000,1,0,0,0,0,0,0,0,0,0,0,0,0,0,0
4808000,2326000,1,0,0,0,0,0,0,0,0,0,0,0,0,0,0
4808000,2339000,1,0,0,0,0,0,0,0,0,0,0,0,0,0,0
4808000,2543000,2,0,0,0,0,0,0,0,0,0,0,0,0,0,0
4808000,2621000,3,393,121,272,0,271,0,0,825,256,569,0,566,0,0
4808000,2622000,2,0,0,0,0,0,0,0,0,0,0,0,0,0,0
4809000,2288000,2,0,0,0,0,0,0,0,0,0,0,0,0,0,0
4809000,2294000,1,0,0,0,0,0,0,0,0,0,0,0,0,0,0
4809000,2316000,1,0,0,0,0,0,0,0,0,0,0,0,0,0,0
4809000,2324000,1,0,0,0,0,0,0,0,0,0,0,0,0,0,0
4809000,2584000,1,0,0,0,0,0,0,0,0,0,0,0,0,0,0
4809000,2597000,31,0,0,0,0,0,0,0,0,0,0,0,0,0,0
4809000,2613000,1,0,0,0,0,0,0,0,0,0,0,0,0,0,0
4809000,2618000,2,0,0,0,0,0,0,0,0,0,0,0,0,0,0
4809000,2622000,2,0,0,0,0,0,0,0,0,0,0,0,0,0,0
4810000,2285000,226,11303,275,11028,1306,728,127,514,100042,2020,98022,13850,7060,1122,4173
4810000,2319000,1,0,0,0,0,0,0,0,0,0,0,0,0,0,0
4810000,2337000,1,0,0,0,0,0,0,0,0,0,0,0,0,0,0
4810000,2500000,1,0,0,0,0,0,0,0,0,0,0,0,0,0,0
4810000,2582000,1,0,0,0,0,0,0,0,0,0,0,0,0,0,0
4810000,2600000,1,0,0,0,0,0,0,0,0,0,0,0,0,0,0
4810000,2602000,1,0,0,0,0,0,0,0,0,0,0,0,0,0,0
4810000,2609000,2,0,0,0,0,0,0,0,0,0,0,0,0,0,0
4810000,2621000,1,0,0,0,0,0,0,0,0,0,0,0,0,0,0
4811000,2228000,6,82,11,71,6,24,8,2,777,55,722,52,437,33,18
4811000,2503000,4,0,0,0,0,0,0,0,0,0,0,0,0,0,0
4811000,2580000,1,0,0,0,0,0,0,0,0,0,0,0,0,0,0
4811000,2592000,1,0,0,0,0,0,0,0,0,0,0,0,0,0,0
4811000,2611000,1,0,0,0,0,0,0,0,0,0,0,0,0,0,0
4811000,2614000,1,0,0,0,0,0,0,0,0,0,0,0,0,0,0
4811000,2619000,1,0,0,0,0,0,0,0,0,0,0,0,0,0,0
4812000,2295000,1,0,0,0,0,0,0,0,0,0,0,0,0,0,0
4812000,2320000,1,0,0,0,0,0,0,0,0,0,0,0,0,0,0
4812000,2329000,1,0,0,0,0,0,0,0,0,0,0,0,0,0,0
4812000,2501000,4,524,290,234,26,46,41,30,1142,624,518,52,111,110,45
4812000,2502000,1,0,0,0,0,0,0,0,0,0,0,0,0,0,0
4812000,2606000,2,0,0,0,0,0,0,0,0,0,0,0,0,0,0
4813000,2279000,6,264,5,259,26,17,2,61,2099,60,2039,180,160,20,472
4813000,2280000,1,0,0,0,0,0,0,0,0,0,0,0,0,0,0
4813000,2283000,3,54,0,54,16,4,0,0,429,0,429,127,36,0,0
4813000,2304000,1,0,0,0,0,0,0,0,0,0,0,0,0,0,0
4813000,2307000,1,0,0,0,0,0,0,0,0,0,0,0,0,0,0
4813000,2328000,1,0,0,0,0,0,0,0,0,0,0,0,0,0,0
4813000,2329000,3,0,0,0,0,0,0,0,0,0,0,0,0,0,0
4813000,2501000,1,0,0,0,0,0,0,0,0,0,0,0,0,0,0
4813000,2589000,2,0,0,0,0,0,0,0,0,0,0,0,0,0,0
4814000,2278000,1,0,0,0,0,0,0,0,0,0,0,0,0,0,0
4814000,2279000,23,896,112,784,121,113,25,69,8200,943,7257,1137,949,257,728
4814000,2280000,7,280,12,268,79,21,4,53,2627,90,2537,805,234,56,455
4814000,2285000,2,0,0,0,0,0,0,0,0,0,0,0,0,0,0
4814000,2288000,3,0,0,0,0,0,0,0,0,0,0,0,0,0,0
4814000,2289000,4,103,4,99,60,0,0,7,905,20,885,640,0,0,37
4814000,2295000,1,0,0,0,0,0,0,0,0,0,0,0,0,0,0
4814000,2296000,1,0,0,0,0,0,0,0,0,0,0,0,0,0,0
4814000,2302000,1,0,0,0,0,0,0,0,0,0,0,0,0,0,0
4814000,2609000,1,0,0,0,0,0,0,0,0,0,0,0,0,0,0
4814000,2621000,2,0,0,0,0,0,0,0,0,0,0,0,0,0,0
4815000,2279000,2,0,0,0,0,0,0,0,0,0,0,0,0,0,0
4815000,2284000,26,1215,42,1173,115,46,8,45,10761,279,10482,1333,400,31,451
4815000,2287000,59,2904,128,2776,289,74,39,38,24248,750,23498,3007,554,291,283
4815000,2288000,1,0,0,0,0,0,0,0,0,0,0,0,0,0,0
4815000,2289000,3,0,0,0,0,0,0,0,0,0,0,0,0,0,0
4815000,2290000,1,0,0,0,0,0,0,0,0,0,0,0,0,0,0
4815000,2306000,1,0,0,0,0,0,0,0,0,0,0,0,0,0,0
4815000,2497000,1,0,0,0,0,0,0,0,0,0,0,0,0,0,0
4816000,2278000,1,0,0,0,0,0,0,0,0,0,0,0,0,0,0
4816000,2283000,2,0,0,0,0,0,0,0,0,0,0,0,0,0,0
4816000,2284000,161,7838,250,7588,1672,454,124,344,70274,1835,68439,18529,4073,1075,2787
4816000,2285000,9,309,11,298,88,10,0,10,2820,88,2732,1024,66,0,115
4816000,2287000,100,6350,310,6040,727,315,126,165,47947,1950,45997,6960,2198,712,1191
4816000,2288000,9,393,60,333,43,27,7,4,3021,365,2656,437,210,37,15
4816000,2290000,1,0,0,0,0,0,0,0,0,0,0,0,0,0,0
4816000,2314000,1,0,0,0,0,0,0,0,0,0,0,0,0,0,0
4816000,2326000,5,407,156,251,26,4,31,16,1462,402,1060,135,6,138,39
4816000,2327000,1,0,0,0,0,0,0,0,0,0,0,0,0,0,0
4816000,2518000,1,0,0,0,0,0,0,0,0,0,0,0,0,0,0
4816000,2587000,18,0,0,0,0,0,0,0,0,0,0,0,0,0,0
4816000,2607000,10,8205,3479,4726,301,509,232,386,14510,6514,7996,903,991,397,659
4817000,2235000,21,1604,376,1228,94,116,51,37,10441,2257,8184,774,1062,282,320
4817000,2279000,1,0,0,0,0,0,0,0,0,0,0,0,0,0,0
4817000,2284000,13,833,5,828,199,44,6,81,7185,50,7135,2063,276,72,685
4817000,2287000,16,836,41,795,57,53,11,8,7000,308,6692,570,486,113,40
4817000,2288000,98,4103,229,3874,464,183,41,96,35213,1829,33384,4838,1584,320,830
4817000,2299000,2,0,0,0,0,0,0,0,0,0,0,0,0,0,0
4817000,2312000,1,0,0,0,0,0,0,0,0,0,0,0,0,0,0
4817000,2327000,2,0,0,0,0,0,0,0,0,0,0,0,0,0,0
4817000,2585000,1,0,0,0,0,0,0,0,0,0,0,0,0,0,0
4818000,2235000,168,15603,5201,10402,662,1648,394,367,95872,28693,67179,4549,11793,2613,2875
4818000,2278000,1,0,0,0,0,0,0,0,0,0,0,0,0,0,0
4818000,2280000,23,622,4,618,183,60,26,80,5807,42,5765,2010,608,292,695
4818000,2287000,9,679,1,678,214,9,15,40,5014,7,5007,1385,53,222,313
4818000,2288000,23,959,52,907,127,54,13,19,8617,377,8240,1586,457,159,184
4818000,2289000,10,270,12,258,53,0,15,0,2314,56,2258,669,0,61,0
4818000,2311000,1,0,0,0,0,0,0,0,0,0,0,0,0,0,0
4818000,2326000,1,0,0,0,0,0,0,0,0,0,0,0,0,0,0
4818000,2346000,5,0,0,0,0,0,0,0,0,0,0,0,0,0,0
4818000,2518000,1,0,0,0,0,0,0,0,0,0,0,0,0,0,0
4818000,2531000,3,0,0,0,0,0,0,0,0,0,0,0,0,0,0
4819000,2279000,1,0,0,0,0,0,0,0,0,0,0,0,0,0,0
4819000,2280000,7,116,0,116,22,11,5,11,985,0,985,254,114,20,77
4819000,2288000,2,0,0,0,0,0,0,0,0,0,0,0,0,0,0
4819000,2289000,1,0,0,0,0,0,0,0,0,0,0,0,0,0,0
4819000,2293000,1,0,0,0,0,0,0,0,0,0,0,0,0,0,0
4819000,2301000,1,0,0,0,0,0,0,0,0,0,0,0,0,0,0
4819000,2316000,1,0,0,0,0,0,0,0,0,0,0,0,0,0,0
4819000,2323000,1,0,0,0,0,0,0,0,0,0,0,0,0,0,0
4819000,2327000,2,0,0,0,0,0,0,0,0,0,0,0,0,0,0
4819000,2505000,12,0,0,0,0,0,0,0,0,0,0,0,0,0,0
4819000,2533000,1,0,0,0,0,0,0,0,0,0,0,0,0,0,0
4819000,2551000,2,0,0,0,0,0,0,0,0,0,0,0,0,0,0
4820000,2232000,1,0,0,0,0,0,0,0,0,0,0,0,0,0,0
4820000,2233000,3,0,0,0,0,0,0,0,0,0,0,0,0,0,0
4820000,2236000,1,0,0,0,0,0,0,0,0,0,0,0,0,0,0
4820000,2238000,3,0,0,0,0,0,0,0,0,0,0,0,0,0,0
4820000,2346000,2,0,0,0,0,0,0,0,0,0,0,0,0,0,0
4820000,2350000,1,0,0,0,0,0,0,0,0,0,0,0,0,0,0
4820000,2511000,1,0,0,0,0,0,0,0,0,0,0,0,0,0,0
4820000,2578000,2,0,0,0,0,0,0,0,0,0,0,0,0,0,0
4821000,2233000,2,0,0,0,0,0,0,0,0,0,0,0,0,0,0
4821000,2287000,227,43881,568,43313,10685,1365,1352,2223,335201,4394,330807,90979,9267,7955,17059
4821000,2288000,13,669,24,645,72,14,11,19,4703,191,4512,580,106,65,93
4821000,2297000,2,0,0,0,0,0,0,0,0,0,0,0,0,0,0
4821000,2301000,3,78,0,78,17,0,0,12,679,0,679,146,0,0,98
4821000,2315000,1,0,0,0,0,0,0,0,0,0,0,0,0,0,0
4822000,2233000,5,0,0,0,0,0,0,0,0,0,0,0,0,0,0
4822000,2287000,28,2496,77,2419,509,41,46,50,14081,408,13673,2752,212,216,253
4822000,2288000,4,155,7,148,44,6,8,8,1250,27,1223,460,30,35,62
4822000,2298000,1,0,0,0,0,0,0,0,0,0,0,0,0,0,0
4822000,2301000,2,0,0,0,0,0,0,0,0,0,0,0,0,0,0
4822000,2322000,1,0,0,0,0,0,0,0,0,0,0,0,0,0,0
4822000,2535000,1,0,0,0,0,0,0,0,0,0,0,0,0,0,0
4822000,2606000,1,0,0,0,0,0,0,0,0,0,0,0,0,0,0
4823000,2234000,2,0,0,0,0,0,0,0,0,0,0,0,0,0,0
4823000,2237000,1,0,0,0,0,0,0,0,0,0,0,0,0,0,0
4823000,2285000,32,1648,17,1631,366,64,22,110,14466,119,14347,3710,568,131,836
4823000,2286000,18,851,20,831,252,12,4,72,7142,86,7056,2534,100,32,642
4823000,2288000,21,1010,44,966,113,15,31,19,7736,261,7475,1096,117,136,133
4824000,2233000,1,0,0,0,0,0,0,0,0,0,0,0,0,0,0
4824000,2239000,1,0,0,0,0,0,0,0,0,0,0,0,0,0,0
4824000,2274000,11,318,22,296,41,68,5,37,3187,162,3025,418,679,35,313
4824000,2275000,59,3155,354,2801,453,245,81,224,23871,2947,20924,4022,2222,654,2028
4824000,2286000,112,5550,207,5343,858,248,119,283,45332,1467,43865,8453,2002,710,2241
4824000,2288000,204,106421,17544,88877,8506,3457,2337,1792,384891,56938,327953,54524,20842,7738,9402
4824000,2289000,1,0,0,0,0,0,0,0,0,0,0,0,0,0,0
4824000,2290000,3,0,0,0,0,0,0,0,0,0,0,0,0,0,0
4824000,2298000,1,0,0,0,0,0,0,0,0,0,0,0,0,0,0
4824000,2322000,1,0,0,0,0,0,0,0,0,0,0,0,0,0,0
4824000,2601000,1,0,0,0,0,0,0,0,0,0,0,0,0,0,0
4824000,2603000,1,0,0,0,0,0,0,0,0,0,0,0,0,0,0
4825000,2233000,1,0,0,0,0,0,0,0,0,0,0,0,0,0,0
4825000,2234000,8,275,37,238,29,7,14,16,1954,495,1459,196,49,119,154
4825000,2237000,161,16835,5045,11790,517,1841,525,158,78418,22565,55853,2707,11498,2324,958
4825000,2238000,12,884,194,690,40,26,28,4,3816,876,2940,206,223,153,15
4825000,2239000,9,354,66,288,7,77,35,15,3284,630,2654,71,1036,374,133
4825000,2275000,4,217,23,194,43,12,26,5,1909,99,1810,468,157,334,45
4825000,2286000,12,859,53,806,136,27,13,12,7245,328,6917,1463,212,122,65
4825000,2288000,14,719,8,711,125,12,13,27,5531,24,5507,1391,77,62,215
4825000,2289000,10,0,0,0,0,0,0,0,0,0,0,0,0,0,0
4825000,2324000,1,0,0,0,0,0,0,0,0,0,0,0,0,0,0
4825000,2508000,1,0,0,0,0,0,0,0,0,0,0,0,0,0,0
4826000,2233000,1,0,0,0,0,0,0,0,0,0,0,0,0,0,0
4826000,2237000,53,2424,351,2073,104,58,98,46,13558,2472,11086,531,326,730,342
4826000,2238000,2,0,0,0,0,0,0,0,0,0,0,0,0,0,0
4826000,2274000,1,0,0,0,0,0,0,0,0,0,0,0,0,0,0
4826000,2288000,135,19551,748,18803,1978,182,870,501,50166,1972,48194,6399,511,2101,1201
4826000,2289000,51,3008,102,2906,351,38,147,69,15730,439,15291,2476,206,598,433
4827000,2233000,12,0,0,0,0,0,0,0,0,0,0,0,0,0,0
4827000,2234000,75,3668,538,3130,247,634,356,133,29390,4017,25373,1987,6809,2870,1099
4827000,2238000,5,225,56,169,11,48,31,9,2066,483,1583,126,520,320,96
4827000,2285000,70,3702,106,3596,388,149,37,99,30386,780,29606,4161,1304,285,836
4827000,2286000,80,6881,142,6739,883,225,225,225,45599,983,44616,7426,1809,852,1693
4827000,2287000,157,10192,227,9965,1178,284,163,311,75736,1556,74180,11262,2240,1206,1959
4827000,2288000,376,53718,1915,51803,5699,697,2304,1452,175486,5381,170105,22969,3135,5966,5102
4827000,2289000,50,2292,47,2245,384,75,91,49,15288,205,15083,3775,589,415,326
4827000,2293000,4,95,1,94,55,0,1,0,988,13,975,687,0,18,0
4827000,2533000,1,0,0,0,0,0,0,0,0,0,0,0,0,0,0
4827000,2568000,5,0,0,0,0,0,0,0,0,0,0,0,0,0,0
4828000,2234000,19,498,102,396,39,70,28,23,4122,957,3165,398,876,190,162
4828000,2235000,1,0,0,0,0,0,0,0,0,0,0,0,0,0,0
4828000,2275000,16,428,42,386,85,70,8,18,3786,268,3518,804,615,148,140
4828000,2276000,1,0,0,0,0,0,0,0,0,0,0,0,0,0,0
4828000,2285000,543,37660,1306,36354,7259,1683,1024,1476,281699,9584,272115,62364,12351,5148,10710
4828000,2286000,222,14410,797,13613,1663,249,169,616,104797,5170,99627,16060,1732,1255,4249
4828000,2287000,61,4159,182,3977,380,102,66,100,30371,1200,29171,3299,663,439,687
4828000,2288000,20,769,28,741,84,42,22,28,5487,191,5296,851,305,188,166
4828000,2289000,19,1459,429,1030,107,74,48,36,7432,872,6560,976,463,231,239
4828000,2290000,2,0,0,0,0,0,0,0,0,0,0,0,0,0,0
4828000,2292000,12,330,15,315,74,7,4,0,2634,100,2534,704,47,8,0
4828000,2293000,6,150,0,150,26,0,0,0,1084,0,1084,216,0,0,0
4828000,2537000,1,0,0,0,0,0,0,0,0,0,0,0,0,0,0
4828000,2601000,1,0,0,0,0,0,0,0,0,0,0,0,0,0,0
4829000,2234000,1,0,0,0,0,0,0,0,0,0,0,0,0,0,0
4829000,2235000,2,0,0,0,0,0,0,0,0,0,0,0,0,0,0
4829000,2276000,5,93,18,75,20,10,0,7,1017,176,841,273,113,0,53
4829000,2277000,3,0,0,0,0,0,0,0,0,0,0,0,0,0,0
4829000,2285000,48,2335,83,2252,659,34,21,70,21319,741,20578,7099,269,129,672
4829000,2286000,61,3338,97,3241,576,76,56,124,27483,647,26836,5961,613,411,911
4829000,2288000,179,9625,398,9227,1372,423,169,270,73467,2760,70707,13260,3356,961,1923
4829000,2290000,2,0,0,0,0,0,0,0,0,0,0,0,0,0,0
4829000,2291000,4,100,0,100,29,0,0,17,956,0,956,351,0,0,140
4829000,2292000,1,0,0,0,0,0,0,0,0,0,0,0,0,0,0
4829000,2527000,1,0,0,0,0,0,0,0,0,0,0,0,0,0,0
4829000,2601000,1,0,0,0,0,0,0,0,0,0,0,0,0,0,0
4829000,2603000,1,0,0,0,0,0,0,0,0,0,0,0,0,0,0
4830000,2236000,44,2207,298,1909,154,445,123,91,20541,3377,17164,1408,4926,1314,853
4830000,2275000,9,235,6,229,59,1,17,13,1915,59,1856,508,8,158,88
4830000,2287000,4,237,17,220,33,6,9,11,1857,121,1736,345,60,51,92
4830000,2288000,177,29060,1334,27726,2761,950,552,594,125515,5028,120487,19020,6195,1839,3218
4830000,2290000,1,0,0,0,0,0,0,0,0,0,0,0,0,0,0
4830000,2294000,1,0,0,0,0,0,0,0,0,0,0,0,0,0,0
4830000,2297000,4,0,0,0,0,0,0,0,0,0,0,0,0,0,0
4830000,2574000,1,0,0,0,0,0,0,0,0,0,0,0,0,0,0
4830000,2593000,5,0,0,0,0,0,0,0,0,0,0,0,0,0,0
4830000,2603000,1,0,0,0,0,0,0,0,0,0,0,0,0,0,0
4831000,2272000,1,0,0,0,0,0,0,0,0,0,0,0,0,0,0
4831000,2274000,2,0,0,0,0,0,0,0,0,0,0,0,0,0,0
4831000,2275000,19,796,149,647,118,43,21,26,5484,650,4834,1019,374,156,148
4831000,2288000,34,2016,51,1965,415,128,18,96,17389,359,17030,4314,1073,144,865
4831000,2290000,2,0,0,0,0,0,0,0,0,0,0,0,0,0,0
4831000,2291000,3,310,28,282,18,16,3,0,2121,64,2057,127,93,25,0
4831000,2292000,2,0,0,0,0,0,0,0,0,0,0,0,0,0,0
4831000,2293000,5,219,0,219,41,0,0,18,2079,0,2079,405,0,0,158
4831000,2294000,5,373,7,366,63,0,11,13,2950,71,2879,761,0,77,89
4831000,2340000,3,0,0,0,0,0,0,0,0,0,0,0,0,0,0
4832000,2274000,1,0,0,0,0,0,0,0,0,0,0,0,0,0,0
4832000,2275000,32,1893,717,1176,205,142,41,75,15505,4906,10599,2367,1377,418,647
4832000,2276000,3,86,7,79,10,13,0,16,718,7,711,112,128,0,161
4832000,2287000,20,0,0,0,0,0,0,0,0,0,0,0,0,0,0
4832000,2288000,54,2802,65,2737,362,165,44,72,24619,512,24107,3726,1483,307,482
4832000,2292000,49,2279,154,2125,196,185,31,54,16706,1155,15551,1797,1997,174,351
4832000,2293000,19,653,9,644,144,17,0,46,5665,84,5581,1515,109,0,353
4832000,2294000,11,533,28,505,146,3,1,53,4274,29,4245,1457,30,7,405
4832000,2591000,1,0,0,0,0,0,0,0,0,0,0,0,0,0,0
4832000,2606000,2,0,0,0,0,0,0,0,0,0,0,0,0,0,0
4833000,2273000,1,0,0,0,0,0,0,0,0,0,0,0,0,0,0
4833000,2274000,13,266,61,205,26,82,3,20,2256,468,1788,257,821,24,173
4833000,2286000,1,0,0,0,0,0,0,0,0,0,0,0,0,0,0
4833000,2287000,51,3707,48,3659,344,147,32,97,30741,359,30382,3085,1290,249,730
4833000,2292000,195,23669,1922,21747,1937,1983,414,397,132122,7449,124673,14937,13970,1230,2629
4833000,2293000,125,4984,292,4692,933,90,163,161,36736,1775,34961,9257,652,658,1332
4833000,2294000,12,436,1,435,96,0,5,27,3630,3,3627,984,0,35,195
4833000,2295000,5,176,9,167,31,1,0,0,1175,45,1130,317,6,0,0
4833000,2303000,2,0,0,0,0,0,0,0,0,0,0,0,0,0,0
4833000,2559000,1,0,0,0,0,0,0,0,0,0,0,0,0,0,0
4834000,2274000,73,3616,765,2851,222,569,131,90,32143,6676,25467,2402,6029,1226,671
4834000,2275000,18,897,76,821,61,233,31,54,7732,532,7200,599,2297,298,418
4834000,2286000,25,1481,77,1404,50,156,7,17,12339,606,11733,520,1255,77,116
4834000,2287000,120,6799,94,6705,632,436,82,299,56551,717,55834,6490,3676,524,2608
4834000,2292000,11,885,17,868,124,60,5,11,4432,95,4337,710,377,30,48
4834000,2293000,146,7182,320,6862,776,233,213,125,44733,1630,43103,6331,1541,785,743
4834000,2294000,17,749,13,736,175,9,15,15,6027,40,5987,1723,39,122,105
4834000,2479000,5,0,0,0,0,0,0,0,0,0,0,0,0,0,0
4834000,2522000,1,0,0,0,0,0,0,0,0,0,0,0,0,0,0
4834000,2604000,1,0,0,0,0,0,0,0,0,0,0,0,0,0,0
4835000,2270000,2,0,0,0,0,0,0,0,0,0,0,0,0,0,0
4835000,2271000,18,709,73,636,184,22,21,56,6294,438,5856,1811,248,196,475
4835000,2286000,49,2750,57,2693,248,177,3,67,22394,419,21975,2426,1541,11,597
4835000,2293000,153,12827,1200,11627,1134,287,383,359,65554,3871,61683,8081,1705,1344,1815
4835000,2294000,9,358,0,358,82,3,15,4,3231,0,3231,928,12,194,19
4835000,2333000,1,0,0,0,0,0,0,0,0,0,0,0,0,0,0
4835000,2495000,1,0,0,0,0,0,0,0,0,0,0,0,0,0,0
4835000,2515000,1,0,0,0,0,0,0,0,0,0,0,0,0,0,0
4835000,2523000,1,0,0,0,0,0,0,0,0,0,0,0,0,0,0
4836000,2271000,1,0,0,0,0,0,0,0,0,0,0,0,0,0,0
4836000,2272000,10,503,50,453,103,55,19,24,4440,396,4044,1265,428,157,184
4836000,2273000,80,3162,369,2793,316,775,90,117,26487,2801,23686,2685,7167,778,1019
4836000,2293000,35,4072,474,3598,447,114,86,166,17402,1162,16240,2425,614,280,824
4836000,2294000,5,0,0,0,0,0,0,0,0,0,0,0,0,0,0
4836000,2306000,1,0,0,0,0,0,0,0,0,0,0,0,0,0,0
4836000,2340000,1,0,0,0,0,0,0,0,0,0,0,0,0,0,0
4836000,2580000,1,0,0,0,0,0,0,0,0,0,0,0,0,0,0
4837000,2164000,1,0,0,0,0,0,0,0,0,0,0,0,0,0,0
4837000,2269000,2,0,0,0,0,0,0,0,0,0,0,0,0,0,0
4837000,2271000,4,139,15,124,28,33,0,22,1429,164,1265,318,383,0,220
4837000,2272000,1,0,0,0,0,0,0,0,0,0,0,0,0,0,0
4837000,2273000,8,291,18,273,32,93,1,19,2763,107,2656,348,972,2,233
4837000,2293000,171,13684,1825,11859,1279,399,364,562,62951,5297,57654,9465,1921,1570,1993
4837000,2294000,14,576,4,572,107,0,10,57,4519,32,4487,991,0,69,401
4837000,2295000,1,0,0,0,0,0,0,0,0,0,0,0,0,0,0
4837000,2340000,1,0,0,0,0,0,0,0,0,0,0,0,0,0,0
4837000,2514000,1,0,0,0,0,0,0,0,0,0,0,0,0,0,0
4837000,2536000,3,0,0,0,0,0,0,0,0,0,0,0,0,0,0
4838000,2293000,95,3351,103,3248,445,48,82,96,23888,528,23360,4494,373,398,683
4838000,2294000,12,543,4,539,28,6,17,37,3774,16,3758,171,12,155,245
4838000,2304000,1,0,0,0,0,0,0,0,0,0,0,0,0,0,0
4838000,2305000,3,84,0,84,24,0,0,0,776,0,776,239,0,0,0
4838000,2537000,2,0,0,0,0,0,0,0,0,0,0,0,0,0,0
4838000,2545000,1,0,0,0,0,0,0,0,0,0,0,0,0,0,0
4839000,2293000,12,0,0,0,0,0,0,0,0,0,0,0,0,0,0
4839000,2294000,1,0,0,0,0,0,0,0,0,0,0,0,0,0,0
4839000,2298000,1,0,0,0,0,0,0,0,0,0,0,0,0,0,0
4839000,2333000,1,0,0,0,0,0,0,0,0,0,0,0,0,0,0
4839000,2578000,1,0,0,0,0,0,0,0,0,0,0,0,0,0,0
4840000,2288000,40,1711,23,1688,164,7,42,57,9533,92,9441,1014,27,292,341
4840000,2289000,1,0,0,0,0,0,0,0,0,0,0,0,0,0,0
4840000,2293000,83,3476,252,3224,460,67,137,95,22359,912,21447,4189,294,651,605
4840000,2294000,8,492,22,470,69,23,14,0,3004,97,2907,660,79,98,0
4840000,2301000,1,0,0,0,0,0,0,0,0,0,0,0,0,0,0
4840000,2314000,1,0,0,0,0,0,0,0,0,0,0,0,0,0,0
4840000,2332000,1,0,0,0,0,0,0,0,0,0,0,0,0,0,0
4840000,2501000,5,765,65,700,151,49,64,113,1371,116,1255,314,111,97,223
4841000,2250000,1,0,0,0,0,0,0,0,0,0,0,0,0,0,0
4841000,2288000,174,13257,345,12912,809,86,336,178,45022,999,44023,3260,360,933,536
4841000,2289000,403,28810,731,28079,1569,131,941,207,98503,2586,95917,6286,367,2950,563
4841000,2290000,7,383,26,357,7,4,26,5,1342,65,1277,26,8,84,7
4841000,2293000,6,258,1,257,12,1,17,0,1927,1,1926,65,20,178,0
4841000,2294000,1,0,0,0,0,0,0,0,0,0,0,0,0,0,0
4841000,2332000,1,0,0,0,0,0,0,0,0,0,0,0,0,0,0
4841000,2333000,1,0,0,0,0,0,0,0,0,0,0,0,0,0,0
4841000,2516000,1,0,0,0,0,0,0,0,0,0,0,0,0,0,0
4842000,2288000,386,49850,1892,47958,2200,216,1365,411,130409,3705,126704,6667,511,3228,1045
4842000,2289000,2346,377868,26625,351243,17152,2750,12406,3576,952620,54352,898268,54422,6436,29885,9094
4842000,2290000,44,2002,128,1874,127,6,60,14,7889,624,7265,519,18,171,65
4842000,2293000,5,117,4,113,34,0,9,0,851,84,767,308,0,54,0
4842000,2593000,1,0,0,0,0,0,0,0,0,0,0,0,0,0,0
4843000,2267000,13,516,22,494,47,73,26,53,4336,171,4165,460,699,174,538
4843000,2268000,4,127,17,110,10,24,9,2,1198,127,1071,202,197,98,12
4843000,2269000,8,944,48,896,86,35,49,33,6877,308,6569,812,274,295,302
4843000,2288000,249,40563,3755,36808,2005,318,1144,525,114500,7116,107384,6677,756,3474,1596
4843000,2289000,201,26260,5034,21226,1076,387,869,218,68935,8535,60400,3522,760,2339,738
4843000,2290000,71,33722,4706,29016,518,215,640,85,53765,7523,46242,1724,452,1528,206
4843000,2291000,9,271,7,264,22,5,16,0,1723,29,1694,128,36,58,0
4843000,2292000,1,0,0,0,0,0,0,0,0,0,0,0,0,0,0
4843000,2299000,5,0,0,0,0,0,0,0,0,0,0,0,0,0,0
4843000,2304000,1,0,0,0,0,0,0,0,0,0,0,0,0,0,0
4843000,2498000,1,0,0,0,0,0,0,0,0,0,0,0,0,0,0
4843000,2602000,1,0,0,0,0,0,0,0,0,0,0,0,0,0,0
4844000,2251000,8,1556,33,1523,61,19,39,9,6562,219,6343,293,125,206,74
4844000,2252000,15,1337,28,1309,69,2,59,31,6134,176,5958,573,10,391,182
4844000,2253000,1,0,0,0,0,0,0,0,0,0,0,0,0,0,0
4844000,2254000,2,0,0,0,0,0,0,0,0,0,0,0,0,0,0
4844000,2267000,4,135,12,123,16,5,0,0,1200,90,1110,197,63,0,0
4844000,2268000,10,606,44,562,56,34,61,25,3830,202,3628,446,180,438,223
4844000,2269000,138,12034,1044,10990,1126,999,313,700,84161,5845,78316,10420,7615,1760,4392
4844000,2272000,12,198,0,198,7,3,0,145,2103,0,2103,74,19,0,1626
4844000,2288000,39,35621,5873,29748,1876,392,677,714,90450,9746,80704,6386,801,1650,2295
4844000,2289000,78,2977,137,2840,179,20,208,30,12282,638,11644,776,76,898,135
4844000,2290000,44,1671,104,1567,119,17,131,22,6445,537,5908,729,57,434,68
4844000,2291000,4,102,7,95,1,0,12,0,673,17,656,3,0,109,0
4844000,2292000,2,0,0,0,0,0,0,0,0,0,0,0,0,0,0
4844000,2293000,44,18860,3677,15183,596,374,388,104,40819,7358,33461,2983,802,1047,334
4844000,2303000,1,0,0,0,0,0,0,0,0,0,0,0,0,0,0
4844000,2498000,1,0,0,0,0,0,0,0,0,0,0,0,0,0,0
4844000,2512000,1,0,0,0,0,0,0,0,0,0,0,0,0,0,0
4844000,2586000,1,0,0,0,0,0,0,0,0,0,0,0,0,0,0
4845000,2251000,748,180489,6673,173816,6718,3938,6451,2615,608888,22166,586722,36612,27191,30127,14110
4845000,2252000,9,772,11,761,43,9,30,30,3672,55,3617,367,101,146,233
4845000,2254000,1,0,0,0,0,0,0,0,0,0,0,0,0,0,0
4845000,2268000,2,0,0,0,0,0,0,0,0,0,0,0,0,0,0
4845000,2269000,2,0,0,0,0,0,0,0,0,0,0,0,0,0,0
4845000,2271000,27,887,38,849,115,66,47,62,6790,343,6447,1013,483,311,568
4845000,2272000,2,0,0,0,0,0,0,0,0,0,0,0,0,0,0
4845000,2274000,2,0,0,0,0,0,0,0,0,0,0,0,0,0,0
4845000,2275000,7,690,7,683,3,13,2,4,5537,44,5493,38,124,26,56
4845000,2288000,117,7780,291,7489,620,75,193,174,38623,831,37792,4244,376,689,817
4845000,2289000,134,7408,514,6894,481,89,502,81,28716,1660,27056,2565,340,1600,243
4845000,2290000,25,759,45,714,52,8,82,4,3214,121,3093,350,9,315,7
4845000,2291000,2,0,0,0,0,0,0,0,0,0,0,0,0,0,0
4845000,2292000,1,0,0,0,0,0,0,0,0,0,0,0,0,0,0
4845000,2293000,6,366,88,278,4,12,15,4,1472,145,1327,15,34,84,20
4846000,2251000,6,587,7,580,15,1,59,21,2529,132,2397,59,1,329,69
4846000,2271000,7,0,0,0,0,0,0,0,0,0,0,0,0,0,0
4846000,2275000,244,13303,1147,12156,1038,932,320,868,106245,8093,98152,9862,9417,2508,6350
4846000,2288000,27,0,0,0,0,0,0,0,0,0,0,0,0,0,0
4846000,2289000,87,4027,267,3760,320,35,213,65,17293,902,16391,1938,192,752,231
4846000,2290000,17,577,45,532,55,6,23,2,2566,212,2354,279,39,138,6
4846000,2291000,1,0,0,0,0,0,0,0,0,0,0,0,0,0,0
4846000,2292000,5,87,15,72,4,0,6,0,577,211,366,12,0,28,0
4846000,2293000,7,189,7,182,29,0,9,5,1462,61,1401,279,0,34,45
4846000,2294000,2,0,0,0,0,0,0,0,0,0,0,0,0,0,0
4846000,2295000,5,273,2,271,65,0,8,0,2375,16,2359,635,0,50,0
4846000,2307000,1,0,0,0,0,0,0,0,0,0,0,0,0,0,0
4846000,2308000,1,0,0,0,0,0,0,0,0,0,0,0,0,0,0
4846000,2315000,1,0,0,0,0,0,0,0,0,0,0,0,0,0,0
4846000,2496000,3,0,0,0,0,0,0,0,0,0,0,0,0,0,0
4846000,2512000,1,0,0,0,0,0,0,0,0,0,0,0,0,0,0
4846000,2557000,1,0,0,0,0,0,0,0,0,0,0,0,0,0,0
4846000,2578000,1,0,0,0,0,0,0,0,0,0,0,0,0,0,0
4846000,2582000,1,0,0,0,0,0,0,0,0,0,0,0,0,0,0
4847000,2271000,5,0,0,0,0,0,0,0,0,0,0,0,0,0,0
4847000,2275000,1,0,0,0,0,0,0,0,0,0,0,0,0,0,0
4847000,2288000,3,268,0,268,32,10,11,13,1611,0,1611,240,38,48,35
4847000,2289000,14,1120,11,1109,88,1,43,18,5405,47,5358,425,1,179,45
4847000,2290000,18,714,31,683,31,12,44,3,3272,67,3205,170,25,167,6
4847000,2291000,3,0,0,0,0,0,0,0,0,0,0,0,0,0,0
4847000,2292000,8,203,63,140,43,0,6,0,1418,468,950,401,0,36,0
4847000,2294000,12,504,51,453,88,4,14,20,3190,141,3049,783,40,49,103
4847000,2295000,3,84,1,83,17,0,0,2,710,2,708,128,0,0,12
4847000,2298000,2,0,0,0,0,0,0,0,0,0,0,0,0,0,0
4847000,2496000,2,0,0,0,0,0,0,0,0,0,0,0,0,0,0
4847000,2548000,1,0,0,0,0,0,0,0,0,0,0,0,0,0,0
4847000,2585000,6,0,0,0,0,0,0,0,0,0,0,0,0,0,0
4848000,2275000,2,0,0,0,0,0,0,0,0,0,0,0,0,0,0
4848000,2288000,47,2834,70,2764,302,38,125,74,15921,355,15566,2242,186,568,473
4848000,2289000,53,2535,104,2431,245,59,102,74,16485,740,15745,1848,304,463,455
4848000,2291000,1,0,0,0,0,0,0,0,0,0,0,0,0,0,0
4848000,2292000,8,523,5,518,91,0,0,10,3683,25,3658,809,0,0,80
4848000,2295000,5,167,5,162,22,2,7,25,1079,18,1061,230,7,22,152
4848000,2297000,1,0,0,0,0,0,0,0,0,0,0,0,0,0,0
4848000,2309000,1,0,0,0,0,0,0,0,0,0,0,0,0,0,0
4848000,2325000,1,0,0,0,0,0,0,0,0,0,0,0,0,0,0
4848000,2527000,1,0,0,0,0,0,0,0,0,0,0,0,0,0,0
4848000,2600000,1,0,0,0,0,0,0,0,0,0,0,0,0,0,0
4849000,2250000,29,3906,119,3787,324,346,250,201,19504,612,18892,2816,3074,1686,1679
4849000,2251000,13,1183,24,1159,117,140,72,60,7660,121,7539,972,1470,434,465
4849000,2254000,17,771,19,752,73,28,62,38,5230,112,5118,628,263,362,358
4849000,2275000,3,0,0,0,0,0,0,0,0,0,0,0,0,0,0
4849000,2288000,86,35584,586,34998,10064,1175,2072,1705,157081,1975,155106,49451,5624,5737,8686
4849000,2289000,40,2763,272,2491,225,38,134,28,14679,879,13800,1631,159,703,173
4849000,2290000,7,0,0,0,0,0,0,0,0,0,0,0,0,0,0
4849000,2291000,9,396,4,392,28,7,3,15,2650,26,2624,209,7,19,148
4849000,2292000,13,726,0,726,193,6,0,46,5876,0,5876,1770,30,0,319
4849000,2295000,1,0,0,0,0,0,0,0,0,0,0,0,0,0,0
4849000,2296000,2,0,0,0,0,0,0,0,0,0,0,0,0,0,0
4849000,2310000,2,0,0,0,0,0,0,0,0,0,0,0,0,0,0
4849000,2539000,1,0,0,0,0,0,0,0,0,0,0,0,0,0,0
4850000,2275000,58,3342,183,3159,400,239,101,132,27831,1547,26284,4042,2244,730,1019
4850000,2287000,72,6280,239,6041,523,123,129,158,43776,1201,42575,4572,741,763,1131
4850000,2288000,196,16943,1942,15001,1534,300,473,536,91512,5059,86453,11129,1303,2013,2680
4850000,2289000,61,3201,210,2991,400,62,106,97,20169,1031,19138,3182,295,608,574
4850000,2290000,25,965,71,894,142,17,44,24,6423,501,5922,1403,163,167,127
4850000,2291000,25,851,17,834,154,2,12,14,6089,96,5993,1434,24,75,124
4850000,2300000,5,0,0,0,0,0,0,0,0,0,0,0,0,0,0
4850000,2508000,5,0,0,0,0,0,0,0,0,0,0,0,0,0,0
4850000,2555000,1,0,0,0,0,0,0,0,0,0,0,0,0,0,0
4850000,2581000,1,0,0,0,0,0,0,0,0,0,0,0,0,0,0
4851000,2250000,13,0,0,0,0,0,0,0,0,0,0,0,0,0,0
4851000,2270000,7,122,16,106,23,0,2,5,1070,117,953,238,0,28,70
4851000,2275000,61,3092,258,2834,397,163,123,58,22235,1965,20270,3244,1410,805,388
4851000,2276000,10,9805,1328,8477,953,1433,203,262,61316,4966,56350,6893,8710,869,1904
4851000,2287000,233,75775,7038,68737,4920,1097,999,1664,303073,15256,287817,25849,4114,3812,7393
4851000,2288000,18,815,20,795,108,0,4,49,6394,132,6262,995,0,16,408
4851000,2290000,2,0,0,0,0,0,0,0,0,0,0,0,0,0,0
4851000,2291000,8,252,0,252,25,0,11,0,1937,0,1937,290,0,73,0
4851000,2319000,1,0,0,0,0,0,0,0,0,0,0,0,0,0,0
4851000,2555000,1,0,0,0,0,0,0,0,0,0,0,0,0,0,0
4851000,2556000,8,3032,1716,1316,196,121,131,100,6405,3107,3298,492,230,302,172
4852000,2252000,2,0,0,0,0,0,0,0,0,0,0,0,0,0,0
4852000,2263000,14,535,23,512,80,61,26,16,4533,167,4366,878,549,192,138
4852000,2275000,273,53237,3841,49396,6809,2818,829,1867,382579,16580,365999,58924,19392,4866,10836
4852000,2276000,53,4907,508,4399,292,238,269,127,27777,2626,25151,1642,1766,1709,846
4852000,2286000,9,347,12,335,53,6,9,18,2327,81,2246,441,48,31,94
4852000,2287000,13,957,47,910,105,37,19,32,6688,214,6474,812,257,117,245
4852000,2288000,11,849,43,806,107,7,39,27,5197,230,4967,1110,21,164,155
4852000,2291000,1,0,0,0,0,0,0,0,0,0,0,0,0,0,0
4852000,2304000,4,231,0,231,33,8,0,15,2045,0,2045,349,9,0,171
4852000,2306000,3,157,29,128,53,0,0,0,1223,48,1175,511,0,0,0
4852000,2556000,3,112,81,31,7,0,6,0,190,137,53,13,0,9,0
4852000,2557000,1,0,0,0,0,0,0,0,0,0,0,0,0,0,0
4853000,2263000,1,0,0,0,0,0,0,0,0,0,0,0,0,0,0
4853000,2271000,8,318,17,301,42,0,26,10,2252,98,2154,459,0,133,20
4853000,2272000,1,0,0,0,0,0,0,0,0,0,0,0,0,0,0
4853000,2273000,1,0,0,0,0,0,0,0,0,0,0,0,0,0,0
4853000,2275000,48,2060,190,1870,241,131,152,41,15350,872,14478,2273,1211,998,293
4853000,2276000,17,933,65,868,117,43,19,58,6537,252,6285,1173,370,38,452
4853000,2285000,71,7340,453,6887,612,269,149,205,44455,1708,42747,4155,1664,793,1255
4853000,2286000,130,9678,393,9285,967,362,172,258,67515,1848,65667,8147,2821,763,1581
4853000,2287000,4,114,2,112,23,0,0,15,860,15,845,212,0,0,154
4853000,2298000,13,0,0,0,0,0,0,0,0,0,0,0,0,0,0
4853000,2302000,4,0,0,0,0,0,0,0,0,0,0,0,0,0,0
4853000,2319000,2,0,0,0,0,0,0,0,0,0,0,0,0,0,0
4853000,2491000,1,0,0,0,0,0,0,0,0,0,0,0,0,0,0
4853000,2515000,1,0,0,0,0,0,0,0,0,0,0,0,0,0,0
4853000,2555000,1,0,0,0,0,0,0,0,0,0,0,0,0,0,0
4854000,2270000,6,165,18,147,50,0,10,19,1160,68,1092,485,0,78,158
4854000,2285000,7,341,4,337,43,3,8,13,2383,11,2372,378,6,34,93
4854000,2286000,3,478,21,457,44,13,11,23,2542,59,2483,314,47,45,112
4854000,2287000,2,0,0,0,0,0,0,0,0,0,0,0,0,0,0
4854000,2290000,1,0,0,0,0,0,0,0,0,0,0,0,0,0,0
4854000,2303000,1,0,0,0,0,0,0,0,0,0,0,0,0,0,0
4854000,2484000,1,0,0,0,0,0,0,0,0,0,0,0,0,0,0
4854000,2554000,2,0,0,0,0,0,0,0,0,0,0,0,0,0,0
4854000,2594000,1,0,0,0,0,0,0,0,0,0,0,0,0,0,0
4855000,2206000,1,0,0,0,0,0,0,0,0,0,0,0,0,0,0
4855000,2270000,3,259,21,238,16,0,3,1,1135,115,1020,167,0,12,3
4855000,2284000,2,0,0,0,0,0,0,0,0,0,0,0,0,0,0
4855000,2287000,1,0,0,0,0,0,0,0,0,0,0,0,0,0,0
4855000,2288000,16,796,2,794,304,1,0,59,7146,10,7136,3152,14,0,509
4855000,2289000,5,215,11,204,37,0,3,4,1269,55,1214,296,0,4,56
4855000,2291000,1,0,0,0,0,0,0,0,0,0,0,0,0,0,0
4855000,2311000,3,0,0,0,0,0,0,0,0,0,0,0,0,0,0
4855000,2315000,1,0,0,0,0,0,0,0,0,0,0,0,0,0,0
4855000,2316000,2,0,0,0,0,0,0,0,0,0,0,0,0,0,0
4855000,2320000,1,0,0,0,0,0,0,0,0,0,0,0,0,0,0
4855000,2559000,3,0,0,0,0,0,0,0,0,0,0,0,0,0,0
4856000,2253000,1,0,0,0,0,0,0,0,0,0,0,0,0,0,0
4856000,2263000,8,484,21,463,65,66,31,28,3597,222,3375,589,494,189,208
4856000,2272000,2,0,0,0,0,0,0,0,0,0,0,0,0,0,0
4856000,2273000,2,0,0,0,0,0,0,0,0,0,0,0,0,0,0
4856000,2275000,80,3022,151,2871,432,199,211,167,23639,1081,22558,4519,1729,1573,1498
4856000,2284000,5,241,6,235,11,6,6,4,1822,24,1798,93,28,20,50
4856000,2287000,2,0,0,0,0,0,0,0,0,0,0,0,0,0,0
4856000,2288000,1,0,0,0,0,0,0,0,0,0,0,0,0,0,0
4856000,2291000,6,259,0,259,89,0,0,11,2239,0,2239,964,0,0,77
4856000,2311000,9,10751,3821,6930,843,128,117,69,14853,7068,7785,961,268,288,124
4856000,2314000,1,0,0,0,0,0,0,0,0,0,0,0,0,0,0
4856000,2320000,2,0,0,0,0,0,0,0,0,0,0,0,0,0,0
4856000,2490000,1,0,0,0,0,0,0,0,0,0,0,0,0,0,0
4856000,2491000,1,0,0,0,0,0,0,0,0,0,0,0,0,0,0
4857000,2248000,29,2058,59,1999,208,255,29,114,17046,482,16564,1832,2324,152,842
4857000,2249000,8,412,19,393,30,21,6,13,3375,171,3204,254,277,72,126
4857000,2253000,2,0,0,0,0,0,0,0,0,0,0,0,0,0,0
4857000,2254000,14,478,72,406,47,23,69,7,3126,456,2670,498,199,389,59
4857000,2256000,16,651,20,631,98,10,39,14,4781,109,4672,872,64,286,103
4857000,2263000,3,149,1,148,8,12,4,9,1093,16,1077,70,65,38,45
4857000,2273000,8,549,32,517,71,14,65,14,3118,130,2988,526,99,370,64
4857000,2275000,20,549,37,512,112,46,41,18,4729,226,4503,1242,381,357,137
4857000,2276000,5,160,4,156,34,0,9,24,1476,29,1447,381,0,96,203
4857000,2284000,149,7301,238,7063,752,198,135,208,52663,1600,51063,6710,1479,945,1430
4857000,2285000,1,0,0,0,0,0,0,0,0,0,0,0,0,0,0
4857000,2287000,1,0,0,0,0,0,0,0,0,0,0,0,0,0,0
4857000,2300000,1,0,0,0,0,0,0,0,0,0,0,0,0,0,0
4857000,2309000,2,0,0,0,0,0,0,0,0,0,0,0,0,0,0
4857000,2311000,1,0,0,0,0,0,0,0,0,0,0,0,0,0,0
4857000,2318000,1,0,0,0,0,0,0,0,0,0,0,0,0,0,0
4857000,2491000,1,0,0,0,0,0,0,0,0,0,0,0,0,0,0
4858000,2253000,1,0,0,0,0,0,0,0,0,0,0,0,0,0,0
4858000,2254000,213,33255,5567,27688,1242,2577,1313,426,196418,31423,164995,9203,17927,7591,3146
4858000,2263000,1,0,0,0,0,0,0,0,0,0,0,0,0,0,0
4858000,2272000,7,0,0,0,0,0,0,0,0,0,0,0,0,0,0
4858000,2273000,1,0,0,0,0,0,0,0,0,0,0,0,0,0,0
4858000,2275000,175,14473,1980,12493,1921,953,392,452,101598,12198,89400,18552,8064,2506,3589
4858000,2283000,15,824,18,806,177,7,21,29,5881,109,5772,1695,49,107,199
4858000,2284000,1,0,0,0,0,0,0,0,0,0,0,0,0,0,0
4858000,2286000,1,0,0,0,0,0,0,0,0,0,0,0,0,0,0
4858000,2289000,1,0,0,0,0,0,0,0,0,0,0,0,0,0,0
4858000,2301000,3,101,2,99,19,0,0,3,897,18,879,187,0,0,15
4858000,2558000,2,0,0,0,0,0,0,0,0,0,0,0,0,0,0
4858000,2560000,1,0,0,0,0,0,0,0,0,0,0,0,0,0,0
4859000,2248000,20,3343,86,3257,849,352,83,246,25608,742,24866,5966,3416,489,1839
4859000,2252000,10,377,7,370,91,12,31,12,2434,37,2397,904,88,188,78
4859000,2253000,1,0,0,0,0,0,0,0,0,0,0,0,0,0,0
4859000,2262000,1,0,0,0,0,0,0,0,0,0,0,0,0,0,0
4859000,2275000,73,3080,311,2769,334,363,150,113,28639,2595,26044,3471,3683,1338,1249
4859000,2282000,15,0,0,0,0,0,0,0,0,0,0,0,0,0,0
4859000,2283000,146,6478,244,6234,669,187,114,242,48955,1685,47270,6374,1416,671,1774
4859000,2286000,3,161,1,160,68,0,2,0,1687,7,1680,803,0,14,0
4859000,2289000,1,0,0,0,0,0,0,0,0,0,0,0,0,0,0
4859000,2296000,2,0,0,0,0,0,0,0,0,0,0,0,0,0,0
4859000,2299000,1,0,0,0,0,0,0,0,0,0,0,0,0,0,0
4859000,2303000,1,0,0,0,0,0,0,0,0,0,0,0,0,0,0
4859000,2313000,1,0,0,0,0,0,0,0,0,0,0,0,0,0,0
4860000,2252000,3,0,0,0,0,0,0,0,0,0,0,0,0,0,0
4860000,2256000,1,0,0,0,0,0,0,0,0,0,0,0,0,0,0
4860000,2257000,1,0,0,0,0,0,0,0,0,0,0,0,0,0,0
4860000,2262000,1,0,0,0,0,0,0,0,0,0,0,0,0,0,0
4860000,2263000,11,11507,216,11291,1883,493,122,7612,87946,1099,86847,17577,2979,816,56352
4860000,2283000,1,0,0,0,0,0,0,0,0,0,0,0,0,0,0
4860000,2285000,3,117,0,117,39,0,0,0,1019,0,1019,422,0,0,0
4860000,2305000,2,0,0,0,0,0,0,0,0,0,0,0,0,0,0
4860000,2570000,1,0,0,0,0,0,0,0,0,0,0,0,0,0,0
4861000,2248000,10,427,18,409,13,36,8,10,4752,173,4579,124,627,77,77
4861000,2252000,2,0,0,0,0,0,0,0,0,0,0,0,0,0,0
4861000,2256000,2,0,0,0,0,0,0,0,0,0,0,0,0,0,0
4861000,2262000,17,740,96,644,42,149,8,30,6742,970,5772,362,1699,84,205
4861000,2263000,421,80105,5781,74324,8514,3112,4600,2447,473180,24183,448997,61537,22974,24964,15953
4861000,2283000,3,163,11,152,12,13,0,0,1207,69,1138,141,77,0,0
4861000,2284000,1,0,0,0,0,0,0,0,0,0,0,0,0,0,0
4861000,2285000,7,440,0,440,117,14,0,0,3814,0,3814,1220,98,0,0
4861000,2298000,1,0,0,0,0,0,0,0,0,0,0,0,0,0,0
4861000,2299000,1,0,0,0,0,0,0,0,0,0,0,0,0,0,0
4861000,2302000,1,0,0,0,0,0,0,0,0,0,0,0,0,0,0
4861000,2503000,1,0,0,0,0,0,0,0,0,0,0,0,0,0,0
4861000,2575000,1,0,0,0,0,0,0,0,0,0,0,0,0,0,0
4862000,2248000,72,6084,212,5872,248,964,94,94,55172,1809,53363,2819,9769,698,913
4862000,2251000,7,157,0,157,18,12,6,19,1763,0,1763,253,72,102,169
4862000,2252000,6,275,29,246,17,41,20,13,2665,445,2220,196,543,136,92
4862000,2256000,1,0,0,0,0,0,0,0,0,0,0,0,0,0,0
4862000,2263000,122,9287,646,8641,933,273,921,363,51565,3865,47700,6728,2435,5043,2626
4862000,2283000,491,36576,1324,35252,4673,641,331,1503,251240,6953,244287,39648,3998,1613,8908
4862000,2284000,2,0,0,0,0,0,0,0,0,0,0,0,0,0,0
4862000,2285000,3,0,0,0,0,0,0,0,0,0,0,0,0,0,0
4862000,2300000,1,0,0,0,0,0,0,0,0,0,0,0,0,0,0
4862000,2304000,5,174,12,162,81,0,0,17,1520,48,1472,887,0,0,98
4862000,2521000,2,0,0,0,0,0,0,0,0,0,0,0,0,0,0
4863000,2251000,2,0,0,0,0,0,0,0,0,0,0,0,0,0,0
4863000,2254000,22,1178,93,1085,130,71,76,39,8921,732,8189,1239,640,490,382
4863000,2256000,46,2005,84,1921,277,299,73,92,19044,810,18234,3209,3384,641,835
4863000,2257000,1,0,0,0,0,0,0,0,0,0,0,0,0,0,0
4863000,2283000,345,56122,3465,52657,9572,2656,1097,2499,308645,11698,296947,64750,13884,4243,13848
4863000,2284000,13,1116,60,1056,87,66,11,15,6471,320,6151,500,378,29,40
4863000,2285000,1,0,0,0,0,0,0,0,0,0,0,0,0,0,0
4863000,2286000,7,277,7,270,71,0,12,0,2298,7,2291,735,0,54,0
4863000,2296000,1,0,0,0,0,0,0,0,0,0,0,0,0,0,0
4863000,2487000,1,0,0,0,0,0,0,0,0,0,0,0,0,0,0
4864000,2248000,1,0,0,0,0,0,0,0,0,0,0,0,0,0,0
4864000,2250000,10,344,3,341,55,0,8,23,2631,55,2576,549,0,70,241
4864000,2251000,1,0,0,0,0,0,0,0,0,0,0,0,0,0,0
4864000,2253000,1,0,0,0,0,0,0,0,0,0,0,0,0,0,0
4864000,2254000,102,17154,1613,15541,2070,2850,721,941,133424,13018,120406,22926,22567,5225,8843
4864000,2270000,6,272,17,255,61,0,26,41,2264,77,2187,638,0,236,403
4864000,2281000,12,0,0,0,0,0,0,0,0,0,0,0,0,0,0
4864000,2282000,15,7349,231,7118,259,933,11,93,33554,586,32968,1785,5561,119,706
4864000,2283000,71,3831,86,3745,467,60,19,50,27162,436,26726,4005,314,105,268
4864000,2286000,18,729,3,726,265,0,1,63,7003,7,6996,2917,0,16,523
4864000,2300000,3,0,0,0,0,0,0,0,0,0,0,0,0,0,0
4864000,2302000,1,0,0,0,0,0,0,0,0,0,0,0,0,0,0
4864000,2303000,4,0,0,0,0,0,0,0,0,0,0,0,0,0,0
4865000,2228000,3,114,4,110,31,9,0,14,1057,36,1021,353,65,0,157
4865000,2231000,2,0,0,0,0,0,0,0,0,0,0,0,0,0,0
4865000,2232000,5,227,6,221,91,6,4,11,2261,42,2219,1105,98,32,140
4865000,2247000,1,0,0,0,0,0,0,0,0,0,0,0,0,0,0
4865000,2248000,14,903,29,874,177,227,37,101,9108,269,8839,1817,2454,377,932
4865000,2252000,37,1823,121,1702,195,72,192,47,11543,823,10720,1450,583,1222,343
4865000,2253000,9,408,21,387,46,43,14,20,3188,158,3030,489,447,100,214
4865000,2280000,16,1111,20,1091,78,42,6,37,8576,130,8446,619,330,102,301
4865000,2281000,30,5113,150,4963,422,113,70,225,30822,772,30050,3089,757,272,1245
4865000,2286000,3,81,0,81,36,0,6,0,944,0,944,463,0,60,0
4865000,2294000,2,0,0,0,0,0,0,0,0,0,0,0,0,0,0
4865000,2305000,2,0,0,0,0,0,0,0,0,0,0,0,0,0,0
4865000,2567000,1,0,0,0,0,0,0,0,0,0,0,0,0,0,0
4865000,2568000,1,0,0,0,0,0,0,0,0,0,0,0,0,0,0
4866000,2226000,7,240,23,217,18,76,12,12,2342,241,2101,219,874,112,164
4866000,2228000,1,0,0,0,0,0,0,0,0,0,0,0,0,0,0
4866000,2229000,1,0,0,0,0,0,0,0,0,0,0,0,0,0,0
4866000,2231000,246,9682,906,8776,1659,830,492,680,77475,5945,71530,17871,8558,3297,6538
4866000,2232000,1,0,0,0,0,0,0,0,0,0,0,0,0,0,0
4866000,2248000,75,4774,196,4578,796,980,222,332,40555,1568,38987,7395,9907,1524,2893
4866000,2252000,216,36891,3884,33007,3685,4546,1637,1292,241584,23052,218532,28942,36793,10077,9647
4866000,2253000,4,77,2,75,10,2,3,3,647,23,624,78,26,15,36
4866000,2273000,5,253,34,219,23,19,43,2,1526,224,1302,125,212,212,2
4866000,2280000,184,10076,131,9945,1046,240,67,264,76615,846,75769,9233,1912,509,1998
4866000,2285000,8,226,2,224,88,0,6,5,2290,4,2286,1070,0,42,70
4866000,2289000,1,0,0,0,0,0,0,0,0,0,0,0,0,0,0
4866000,2303000,2,0,0,0,0,0,0,0,0,0,0,0,0,0,0
4866000,2305000,1,0,0,0,0,0,0,0,0,0,0,0,0,0,0
4866000,2309000,1,0,0,0,0,0,0,0,0,0,0,0,0,0,0
4866000,2576000,2,0,0,0,0,0,0,0,0,0,0,0,0,0,0
4867000,2229000,10,262,9,253,62,19,0,38,2935,110,2825,867,213,0,436
4867000,2232000,1,0,0,0,0,0,0,0,0,0,0,0,0,0,0
4867000,2244000,1,0,0,0,0,0,0,0,0,0,0,0,0,0,0
4867000,2248000,2,0,0,0,0,0,0,0,0,0,0,0,0,0,0
4867000,2252000,1,0,0,0,0,0,0,0,0,0,0,0,0,0,0
4867000,2267000,3,338,12,326,56,0,22,18,1823,44,1779,483,0,119,104
4867000,2273000,87,2824,440,2384,308,258,112,69,21500,3544,17956,3374,2195,814,564
4867000,2280000,73,4195,112,4083,554,126,20,87,33043,788,32255,5669,906,119,821
4867000,2281000,3,0,0,0,0,0,0,0,0,0,0,0,0,0,0
4867000,2285000,4,158,0,158,70,1,0,11,1390,0,1390,744,1,0,114
4867000,2292000,2,0,0,0,0,0,0,0,0,0,0,0,0,0,0
4867000,2298000,2,0,0,0,0,0,0,0,0,0,0,0,0,0,0
4867000,2299000,1,0,0,0,0,0,0,0,0,0,0,0,0,0,0
4867000,2306000,2,0,0,0,0,0,0,0,0,0,0,0,0,0,0
4867000,2495000,2,0,0,0,0,0,0,0,0,0,0,0,0,0,0
4867000,2582000,1,0,0,0,0,0,0,0,0,0,0,0,0,0,0
4868000,2231000,2,0,0,0,0,0,0,0,0,0,0,0,0,0,0
4868000,2273000,7,262,17,245,47,22,26,10,1774,142,1632,339,164,81,42
4868000,2274000,1,0,0,0,0,0,0,0,0,0,0,0,0,0,0
4868000,2280000,9,599,7,592,90,10,3,27,4244,29,4215,875,48,24,223
4868000,2282000,7,236,2,234,111,0,4,12,2115,6,2109,1107,0,36,95
4868000,2283000,5,319,96,223,86,7,10,7,1620,198,1422,798,11,39,27
4868000,2285000,3,0,0,0,0,0,0,0,0,0,0,0,0,0,0
4869000,2226000,1,0,0,0,0,0,0,0,0,0,0,0,0,0,0
4869000,2230000,6,17190,2528,14662,933,1392,510,272,73247,7076,66171,4185,8261,1972,1174
4869000,2231000,1,0,0,0,0,0,0,0,0,0,0,0,0,0,0
4869000,2233000,2,0,0,0,0,0,0,0,0,0,0,0,0,0,0
4869000,2249000,4,720,16,704,81,13,28,17,2457,69,2388,301,92,74,92
4869000,2272000,1,0,0,0,0,0,0,0,0,0,0,0,0,0,0
4869000,2280000,10,744,6,738,82,3,6,23,5282,19,5263,743,13,33,206
4869000,2281000,2,0,0,0,0,0,0,0,0,0,0,0,0,0,0
4869000,2285000,3,0,0,0,0,0,0,0,0,0,0,0,0,0,0
4869000,2550000,1,0,0,0,0,0,0,0,0,0,0,0,0,0,0
4870000,2226000,1,0,0,0,0,0,0,0,0,0,0,0,0,0,0
4870000,2232000,1,0,0,0,0,0,0,0,0,0,0,0,0,0,0
4870000,2271000,1,0,0,0,0,0,0,0,0,0,0,0,0,0,0
4870000,2280000,143,18733,670,18063,2867,1379,200,464,129287,3919,125368,21906,8706,1163,3293
4870000,2281000,1,0,0,0,0,0,0,0,0,0,0,0,0,0,0
4870000,2282000,2,0,0,0,0,0,0,0,0,0,0,0,0,0,0
4870000,2284000,1,0,0,0,0,0,0,0,0,0,0,0,0,0,0
4870000,2298000,1,0,0,0,0,0,0,0,0,0,0,0,0,0,0
4870000,2304000,1,0,0,0,0,0,0,0,0,0,0,0,0,0,0
4870000,2547000,2,0,0,0,0,0,0,0,0,0,0,0,0,0,0
4870000,2557000,1,0,0,0,0,0,0,0,0,0,0,0,0,0,0
4870000,2558000,1,0,0,0,0,0,0,0,0,0,0,0,0,0,0
4870000,2586000,1,0,0,0,0,0,0,0,0,0,0,0,0,0,0
4871000,2225000,2,0,0,0,0,0,0,0,0,0,0,0,0,0,0
4871000,2232000,1,0,0,0,0,0,0,0,0,0,0,0,0,0,0
4871000,2250000,2,0,0,0,0,0,0,0,0,0,0,0,0,0,0
4871000,2280000,3,107,0,107,30,6,0,17,879,0,879,315,36,0,104
4871000,2282000,1,0,0,0,0,0,0,0,0,0,0,0,0,0,0
4871000,2283000,3,65,0,65,20,0,4,5,613,0,613,210,0,44,35
4871000,2289000,1,0,0,0,0,0,0,0,0,0,0,0,0,0,0
4872000,2280000,50,3761,174,3587,350,190,31,190,29052,1185,27867,3427,1499,226,1316
4872000,2283000,6,145,0,145,30,0,12,6,1358,0,1358,333,0,104,84
4872000,2286000,3,136,5,131,38,0,0,0,1185,10,1175,422,0,0,0
4873000,2280000,105,7786,265,7521,1278,176,92,222,60543,1920,58623,12505,1323,546,1583
4873000,2283000,2,0,0,0,0,0,0,0,0,0,0,0,0,0,0
4874000,2225000,1,0,0,0,0,0,0,0,0,0,0,0,0,0,0
4874000,2231000,1,0,0,0,0,0,0,0,0,0,0,0,0,0,0
4874000,2251000,1,0,0,0,0,0,0,0,0,0,0,0,0,0,0
4874000,2272000,1,0,0,0,0,0,0,0,0,0,0,0,0,0,0
4874000,2279000,9,611,2,609,55,1,0,20,5385,14,5371,560,14,0,205
4874000,2280000,25,2322,43,2279,583,45,11,128,18578,296,18282,4900,354,128,921
4874000,2283000,1,0,0,0,0,0,0,0,0,0,0,0,0,0,0
4874000,2284000,3,75,0,75,32,0,0,2,668,0,668,388,0,0,20
4875000,2224000,2,0,0,0,0,0,0,0,0,0,0,0,0,0,0
4875000,2225000,1,0,0,0,0,0,0,0,0,0,0,0,0,0,0
4875000,2252000,1,0,0,0,0,0,0,0,0,0,0,0,0,0,0
4875000,2272000,3,82,2,80,15,0,9,1,814,20,794,133,0,116,9
4875000,2273000,13,943,46,897,69,97,18,20,8448,413,8035,666,947,135,178
4875000,2279000,4,185,0,185,13,17,2,0,1651,0,1651,144,156,12,0
4875000,2280000,63,3369,44,3325,431,63,23,101,26929,309,26620,3909,496,243,752
4875000,2283000,1,0,0,0,0,0,0,0,0,0,0,0,0,0,0
4875000,2288000,2,0,0,0,0,0,0,0,0,0,0,0,0,0,0
4875000,2289000,1,0,0,0,0,0,0,0,0,0,0,0,0,0,0
4875000,2290000,1,0,0,0,0,0,0,0,0,0,0,0,0,0,0
4875000,2306000,1,0,0,0,0,0,0,0,0,0,0,0,0,0,0
4875000,2534000,1,0,0,0,0,0,0,0,0,0,0,0,0,0,0
4875000,2567000,1,0,0,0,0,0,0,0,0,0,0,0,0,0,0
4876000,2224000,2,0,0,0,0,0,0,0,0,0,0,0,0,0,0
4876000,2225000,5,220,7,213,9,68,7,5,2532,71,2461,75,805,80,12
4876000,2231000,3,92,12,80,14,8,6,3,990,116,874,208,96,38,24
4876000,2269000,3,0,0,0,0,0,0,0,0,0,0,0,0,0,0
4876000,2271000,3,0,0,0,0,0,0,0,0,0,0,0,0,0,0
4876000,2272000,68,2574,243,2331,295,202,81,63,22558,1770,20788,3003,1904,653,473
4876000,2280000,7,528,9,519,118,11,0,41,4291,63,4228,1190,88,0,355
4876000,2284000,1,0,0,0,0,0,0,0,0,0,0,0,0,0,0
4877000,2224000,1,0,0,0,0,0,0,0,0,0,0,0,0,0,0
4877000,2225000,6,375,9,366,28,82,11,5,3047,72,2975,240,914,88,16
4877000,2231000,315,16613,997,15616,2625,2154,635,1104,154515,7711,146804,29892,22609,5651,10663
4877000,2251000,2,0,0,0,0,0,0,0,0,0,0,0,0,0,0
4877000,2267000,1,0,0,0,0,0,0,0,0,0,0,0,0,0,0
4877000,2268000,6,0,0,0,0,0,0,0,0,0,0,0,0,0,0
4877000,2269000,1,0,0,0,0,0,0,0,0,0,0,0,0,0,0
4877000,2279000,26,1580,20,1560,155,49,25,88,12078,172,11906,1487,389,178,633
4877000,2280000,87,4769,82,4687,622,76,48,205,38444,514,37930,6001,632,369,1701
4877000,2282000,2,0,0,0,0,0,0,0,0,0,0,0,0,0,0
4877000,2284000,1,0,0,0,0,0,0,0,0,0,0,0,0,0,0
4877000,2288000,2,0,0,0,0,0,0,0,0,0,0,0,0,0,0
4877000,2289000,2,0,0,0,0,0,0,0,0,0,0,0,0,0,0
4877000,2290000,1,0,0,0,0,0,0,0,0,0,0,0,0,0,0
4878000,2224000,1,0,0,0,0,0,0,0,0,0,0,0,0,0,0
4878000,2225000,3,230,31,199,3,67,3,20,2251,295,1956,31,781,6,129
4878000,2231000,2,0,0,0,0,0,0,0,0,0,0,0,0,0,0
4878000,2266000,65,3395,75,3320,517,75,112,225,29371,716,28655,5120,639,785,2307
4878000,2267000,14,508,5,503,56,33,14,25,3981,35,3946,535,276,81,278
4878000,2279000,9,717,17,700,41,24,7,35,6006,60,5946,399,180,57,263
4878000,2282000,3,141,0,141,67,0,0,1,1013,0,1013,483,0,0,3
4878000,2283000,2,0,0,0,0,0,0,0,0,0,0,0,0,0,0
4878000,2288000,1,0,0,0,0,0,0,0,0,0,0,0,0,0,0
4879000,2267000,76,4302,210,4092,329,252,215,191,32624,1435,31189,2681,2048,1523,1666
4879000,2283000,6,268,23,245,36,0,16,20,1730,67,1663,358,0,132,140
4879000,2284000,3,70,16,54,13,0,1,2,379,56,323,42,0,5,14
4879000,2287000,1,0,0,0,0,0,0,0,0,0,0,0,0,0,0
4879000,2536000,1,0,0,0,0,0,0,0,0,0,0,0,0,0,0
4879000,2562000,1,0,0,0,0,0,0,0,0,0,0,0,0,0,0
4880000,2207000,11,0,0,0,0,0,0,0,0,0,0,0,0,0,0
4880000,2209000,16,933,173,760,83,191,63,45,7599,1163,6436,761,1960,615,425
4880000,2210000,8,0,0,0,0,0,0,0,0,0,0,0,0,0,0
4880000,2225000,1,0,0,0,0,0,0,0,0,0,0,0,0,0,0
4880000,2278000,24,2379,47,2332,119,85,40,88,17944,251,17693,945,576,252,612
4880000,2279000,4,0,0,0,0,0,0,0,0,0,0,0,0,0,0
4880000,2282000,1,0,0,0,0,0,0,0,0,0,0,0,0,0,0
4880000,2286000,2,0,0,0,0,0,0,0,0,0,0,0,0,0,0
4880000,2294000,4,0,0,0,0,0,0,0,0,0,0,0,0,0,0
4881000,2210000,1,0,0,0,0,0,0,0,0,0,0,0,0,0,0
4881000,2225000,19,687,79,608,56,102,93,33,6138,662,5476,647,1182,850,284
4881000,2252000,26,1408,71,1337,127,427,68,72,12422,583,11839,1125,4194,636,704
4881000,2253000,1,0,0,0,0,0,0,0,0,0,0,0,0,0,0
4881000,2278000,116,9944,192,9752,911,289,78,229,78977,1183,77794,8739,2143,392,1794
4881000,2281000,4,180,8,172,22,6,15,5,895,30,865,156,36,90,5
4881000,2284000,1,0,0,0,0,0,0,0,0,0,0,0,0,0,0
4881000,2295000,1,0,0,0,0,0,0,0,0,0,0,0,0,0,0
4881000,2504000,4,0,0,0,0,0,0,0,0,0,0,0,0,0,0
4882000,2225000,61,7004,641,6363,1321,522,301,381,41927,3325,38602,10646,4449,1983,2907
4882000,2277000,24,1892,29,1863,127,82,24,105,16171,252,15919,1184,704,132,991
4882000,2278000,32,1977,39,1938,332,58,27,71,15730,300,15430,3082,400,196,549
4882000,2285000,2,0,0,0,0,0,0,0,0,0,0,0,0,0,0
4882000,2286000,1,0,0,0,0,0,0,0,0,0,0,0,0,0,0
4882000,2289000,1,0,0,0,0,0,0,0,0,0,0,0,0,0,0
4882000,2290000,1,0,0,0,0,0,0,0,0,0,0,0,0,0,0
4883000,2276000,69,6542,319,6223,847,214,41,387,49008,2400,46608,7275,1763,287,2948
4883000,2277000,256,60972,3179,57793,14309,1549,672,2764,394591,15798,378793,87440,10300,3589,16576
4883000,2289000,1,0,0,0,0,0,0,0,0,0,0,0,0,0,0
4883000,2292000,4,0,0,0,0,0,0,0,0,0,0,0,0,0,0
4883000,2301000,2,0,0,0,0,0,0,0,0,0,0,0,0,0,0
4883000,2507000,3,0,0,0,0,0,0,0,0,0,0,0,0,0,0
4884000,2210000,24,1177,282,895,42,125,125,28,8498,1527,6971,299,1183,1148,223
4884000,2228000,2,0,0,0,0,0,0,0,0,0,0,0,0,0,0
4884000,2249000,1,0,0,0,0,0,0,0,0,0,0,0,0,0,0
4884000,2275000,8,7548,2090,5458,895,239,100,281,32252,4284,27968,5734,911,382,1334
4884000,2276000,476,90636,5127,85509,4529,4332,876,1580,607830,26921,580909,32585,32146,4066,9522
4884000,2277000,1,0,0,0,0,0,0,0,0,0,0,0,0,0,0
4884000,2283000,4,215,1,214,91,0,0,10,2074,7,2067,690,0,0,83
4884000,2291000,1,0,0,0,0,0,0,0,0,0,0,0,0,0,0
4884000,2296000,1,0,0,0,0,0,0,0,0,0,0,0,0,0,0
4884000,2298000,1,0,0,0,0,0,0,0,0,0,0,0,0,0,0
4884000,2497000,1,0,0,0,0,0,0,0,0,0,0,0,0,0,0
4884000,2525000,10,11361,8817,2544,241,464,126,200,46574,39253,7321,661,1633,281,396
4884000,2526000,1,0,0,0,0,0,0,0,0,0,0,0,0,0,0
4884000,2567000,3,0,0,0,0,0,0,0,0,0,0,0,0,0,0
4885000,2207000,14,935,212,723,55,224,125,44,7970,1704,6266,503,2315,954,412
4885000,2250000,2,0,0,0,0,0,0,0,0,0,0,0,0,0,0
4885000,2275000,165,27499,1330,26169,3077,868,260,765,188530,6181,182349,25677,6316,1615,4584
4885000,2276000,72,8115,380,7735,639,210,61,138,55352,2445,52907,4934,1324,332,749
4885000,2488000,1,0,0,0,0,0,0,0,0,0,0,0,0,0,0
4885000,2524000,3,0,0,0,0,0,0,0,0,0,0,0,0,0,0
4886000,2210000,21,993,281,712,72,137,53,37,5774,1552,4222,423,1024,263,271
4886000,2232000,1,0,0,0,0,0,0,0,0,0,0,0,0,0,0
4886000,2249000,3,80,1,79,6,1,0,7,684,7,677,42,14,0,106
4886000,2251000,1,0,0,0,0,0,0,0,0,0,0,0,0,0,0
4886000,2273000,43,5270,107,5163,206,192,13,109,39874,776,39098,1782,1548,145,898
4886000,2274000,4,0,0,0,0,0,0,0,0,0,0,0,0,0,0
4886000,2290000,1,0,0,0,0,0,0,0,0,0,0,0,0,0,0
4886000,2525000,1,0,0,0,0,0,0,0,0,0,0,0,0,0,0
4887000,2226000,1,0,0,0,0,0,0,0,0,0,0,0,0,0,0
4887000,2229000,69,3212,159,3053,428,233,156,120,26662,1377,25285,4438,2171,1198,998
4887000,2232000,1,0,0,0,0,0,0,0,0,0,0,0,0,0,0
4887000,2249000,84,4376,134,4242,296,478,125,126,36323,1110,35213,2782,4704,631,1094
4887000,2253000,1,0,0,0,0,0,0,0,0,0,0,0,0,0,0
4887000,2272000,4,469,4,465,44,4,2,17,2722,8,2714,305,18,15,73
4887000,2273000,168,15440,955,14485,930,462,112,240,113985,7111,106874,8151,3585,699,1488
4887000,2274000,39,2599,75,2524,208,59,26,29,18958,364,18594,1943,453,161,180
4887000,2275000,3,0,0,0,0,0,0,0,0,0,0,0,0,0,0
4887000,2276000,19,1423,3,1420,285,6,8,28,10416,7,10409,2944,24,30,238
4887000,2284000,2,0,0,0,0,0,0,0,0,0,0,0,0,0,0
4887000,2517000,1,0,0,0,0,0,0,0,0,0,0,0,0,0,0
4887000,2554000,1,0,0,0,0,0,0,0,0,0,0,0,0,0,0
4888000,2227000,1,0,0,0,0,0,0,0,0,0,0,0,0,0,0
4888000,2272000,76,5465,190,5275,475,222,59,124,41673,1284,40389,4482,1988,408,948
4888000,2273000,21,1006,48,958,99,44,19,22,6418,247,6171,704,326,84,101
4888000,2276000,2,0,0,0,0,0,0,0,0,0,0,0,0,0,0
4888000,2281000,1,0,0,0,0,0,0,0,0,0,0,0,0,0,0
4888000,2505000,1,0,0,0,0,0,0,0,0,0,0,0,0,0,0
4888000,2539000,1,0,0,0,0,0,0,0,0,0,0,0,0,0,0
4889000,2251000,1,0,0,0,0,0,0,0,0,0,0,0,0,0,0
4889000,2555000,2,0,0,0,0,0,0,0,0,0,0,0,0,0,0
4890000,2249000,4,104,0,104,12,5,2,7,1519,0,1519,124,46,33,70
4890000,2251000,2,0,0,0,0,0,0,0,0,0,0,0,0,0,0
4890000,2252000,1,0,0,0,0,0,0,0,0,0,0,0,0,0,0
4890000,2253000,1,0,0,0,0,0,0,0,0,0,0,0,0,0,0
4890000,2269000,47,9165,741,8424,705,205,182,288,52658,2907,49751,4348,1102,1117,1275
4890000,2270000,1028,169166,9730,159436,15790,4522,3886,6338,1036165,43492,992673,107779,24944,19943,30544
4890000,2271000,133,10560,430,10130,1046,162,296,281,76549,2512,74037,9293,1142,1632,1867
4890000,2272000,83,4637,70,4567,1172,47,127,236,36884,335,36549,11508,271,750,1748
4890000,2280000,9,0,0,0,0,0,0,0,0,0,0,0,0,0,0
4890000,2568000,1,0,0,0,0,0,0,0,0,0,0,0,0,0,0
4891000,2249000,2,0,0,0,0,0,0,0,0,0,0,0,0,0,0
4891000,2251000,1,0,0,0,0,0,0,0,0,0,0,0,0,0,0
4891000,2252000,10,611,14,597,15,200,12,4,6193,88,6105,201,2362,104,40
4891000,2269000,450,34655,3511,31144,2939,761,1614,1203,185157,11593,173564,18745,3928,8837,5690
4891000,2270000,200,14528,654,13874,1256,291,514,397,90912,3472,87440,10396,1766,3094,2538
4891000,2271000,6,0,0,0,0,0,0,0,0,0,0,0,0,0,0
4891000,2272000,13,640,0,640,162,8,1,50,5065,0,5065,1533,80,7,341
4892000,2252000,4,95,0,95,2,23,2,8,1226,0,1226,16,276,8,100
4892000,2268000,8,636,1,635,144,0,7,60,4534,3,4531,1321,0,37,467
4892000,2269000,10,377,6,371,55,12,17,0,2432,12,2420,509,65,67,0
4892000,2281000,9,0,0,0,0,0,0,0,0,0,0,0,0,0,0
4893000,2234000,2,0,0,0,0,0,0,0,0,0,0,0,0,0,0
4893000,2249000,3,181,2,179,0,16,0,2,1916,14,1902,0,207,0,10
4893000,2250000,1,0,0,0,0,0,0,0,0,0,0,0,0,0,0
4893000,2252000,3,183,4,179,0,14,0,2,1629,48,1581,0,122,0,14
4893000,2267000,36,24092,1152,22940,4924,448,234,1340,161115,5155,155960,37861,2862,1205,8449
4893000,2281000,1,0,0,0,0,0,0,0,0,0,0,0,0,0,0
4894000,2234000,15,363,61,302,41,40,25,10,3048,510,2538,467,397,210,104
4894000,2239000,2,0,0,0,0,0,0,0,0,0,0,0,0,0,0
4894000,2240000,2,0,0,0,0,0,0,0,0,0,0,0,0,0,0
4894000,2252000,1,0,0,0,0,0,0,0,0,0,0,0,0,0,0
4894000,2265000,35,4762,154,4608,498,142,19,221,31507,913,30594,4088,910,81,1564
4894000,2266000,252,27738,840,26898,3180,655,102,935,187164,4701,182463,24839,4787,518,5880
4894000,2267000,189,52620,2882,49738,10281,1090,389,2792,332021,12782,319239,74040,6803,1957,15807
4894000,2268000,2,0,0,0,0,0,0,0,0,0,0,0,0,0,0
4894000,2288000,2,0,0,0,0,0,0,0,0,0,0,0,0,0,0
4894000,2547000,2,0,0,0,0,0,0,0,0,0,0,0,0,0,0
4894000,2552000,6,1176,932,244,41,24,7,33,2811,2326,485,122,28,9,48
4895000,2231000,1,0,0,0,0,0,0,0,0,0,0,0,0,0,0
4895000,2234000,1,0,0,0,0,0,0,0,0,0,0,0,0,0,0
4895000,2240000,43,5778,182,5596,1353,1384,212,412,50703,1390,49313,12103,15038,1130,3988
4895000,2264000,7,422,10,412,41,8,1,4,3389,96,3293,431,76,1,28
4895000,2265000,34,3447,71,3376,143,96,14,75,25390,493,24897,1241,768,80,534
4895000,2266000,27,1997,77,1920,165,116,8,84,13120,430,12690,1363,757,50,541
4895000,2267000,8,0,0,0,0,0,0,0,0,0,0,0,0,0,0
4895000,2294000,1,0,0,0,0,0,0,0,0,0,0,0,0,0,0
4896000,2234000,69,2613,205,2408,279,699,123,78,22706,1619,21087,2912,7517,1046,747
4896000,2263000,62,4960,167,4793,199,102,40,56,39462,1225,38237,1808,790,224,442
4896000,2264000,318,57090,3365,53725,5694,791,572,1374,374909,15631,359278,39154,5160,2804,8124
4896000,2559000,1,0,0,0,0,0,0,0,0,0,0,0,0,0,0
4897000,2233000,2,0,0,0,0,0,0,0,0,0,0,0,0,0,0
4897000,2234000,1,0,0,0,0,0,0,0,0,0,0,0,0,0,0
4897000,2263000,57,4520,56,4464,207,74,27,44,36727,447,36280,1856,654,237,269
4897000,2264000,6,315,4,311,57,0,5,30,2758,56,2702,818,0,39,224
4897000,2284000,12,355,7,348,126,0,4,13,3381,49,3332,1423,0,20,147
4898000,2235000,1,0,0,0,0,0,0,0,0,0,0,0,0,0,0
4898000,2277000,1,0,0,0,0,0,0,0,0,0,0,0,0,0,0
4898000,2285000,5,164,0,164,84,0,8,6,1763,0,1763,1056,0,80,60
4898000,2290000,3,0,0,0,0,0,0,0,0,0,0,0,0,0,0
4899000,2235000,11,857,55,802,54,106,44,14,6321,372,5949,498,1011,173,138
4899000,2236000,2,0,0,0,0,0,0,0,0,0,0,0,0,0,0
4899000,2261000,107,7811,298,7513,452,266,114,101,60848,1971,58877,3327,1998,670,818
4899000,2262000,3,389,12,377,38,18,6,13,2381,53,2328,323,90,26,71
4899000,2289000,1,0,0,0,0,0,0,0,0,0,0,0,0,0,0
4899000,2492000,1,0,0,0,0,0,0,0,0,0,0,0,0,0,0
4900000,2233000,2,0,0,0,0,0,0,0,0,0,0,0,0,0,0
4900000,2235000,58,6469,420,6049,707,1960,86,268,64906,3985,60921,7256,22360,704,2762
4900000,2236000,9,908,39,869,115,112,15,58,6856,138,6718,1093,1086,66,478
4900000,2273000,2,0,0,0,0,0,0,0,0,0,0,0,0,0,0
4900000,2277000,2,0,0,0,0,0,0,0,0,0,0,0,0,0,0
4900000,2285000,13,0,0,0,0,0,0,0,0,0,0,0,0,0,0
4900000,2286000,1,0,0,0,0,0,0,0,0,0,0,0,0,0,0
4900000,2287000,1,0,0,0,0,0,0,0,0,0,0,0,0,0,0
4900000,2288000,8,294,0,294,118,0,0,16,3003,0,3003,1520,0,0,214
4900000,2489000,5,3165,1529,1636,279,67,207,84,6179,3036,3143,458,194,358,114
4901000,2230000,1,0,0,0,0,0,0,0,0,0,0,0,0,0,0
4901000,2231000,1,0,0,0,0,0,0,0,0,0,0,0,0,0,0
4901000,2232000,1,0,0,0,0,0,0,0,0,0,0,0,0,0,0
4901000,2233000,4,256,29,227,14,2,21,10,1395,170,1225,74,10,137,84
4901000,2235000,13,693,32,661,73,84,9,25,6223,252,5971,795,703,46,179
4901000,2236000,1,0,0,0,0,0,0,0,0,0,0,0,0,0,0
4901000,2259000,14,5703,69,5634,960,53,9,71,42930,433,42497,8885,246,46,556
4901000,2288000,1,0,0,0,0,0,0,0,0,0,0,0,0,0,0
4902000,2230000,1,0,0,0,0,0,0,0,0,0,0,0,0,0,0
4902000,2231000,1,0,0,0,0,0,0,0,0,0,0,0,0,0,0
4902000,2232000,3,74,7,67,15,2,5,1,562,39,523,175,22,32,2
4902000,2233000,151,9180,725,8455,807,875,498,313,56138,4390,51748,6729,8400,2669,2798
4902000,2235000,59,3860,279,3581,247,169,55,49,29667,1583,28084,2150,1720,342,365
4902000,2259000,127,8161,194,7967,264,95,43,37,66096,1390,64706,2511,814,384,292
4902000,2271000,2,0,0,0,0,0,0,0,0,0,0,0,0,0,0
4902000,2284000,2,0,0,0,0,0,0,0,0,0,0,0,0,0,0
4902000,2291000,1,0,0,0,0,0,0,0,0,0,0,0,0,0,0
4902000,2489000,1,0,0,0,0,0,0,0,0,0,0,0,0,0,0
4903000,2232000,2,0,0,0,0,0,0,0,0,0,0,0,0,0,0
4903000,2233000,258,58653,6914,51739,2667,1882,1451,1009,225639,33480,192159,14281,11404,6272,4969
4903000,2235000,2,0,0,0,0,0,0,0,0,0,0,0,0,0,0
4903000,2258000,188,46893,949,45944,2193,1243,327,2716,327196,6012,321184,15211,9488,1315,10915
4903000,2281000,1,0,0,0,0,0,0,0,0,0,0,0,0,0,0
4903000,2285000,2,0,0,0,0,0,0,0,0,0,0,0,0,0,0
4903000,2287000,1,0,0,0,0,0,0,0,0,0,0,0,0,0,0
4904000,2231000,2,0,0,0,0,0,0,0,0,0,0,0,0,0,0
4904000,2232000,20,4729,560,4169,224,210,136,98,29887,3164,26723,2015,1503,823,749
4904000,2233000,8,799,15,784,45,3,20,20,2778,62,2716,195,13,69,107
4904000,2235000,2,0,0,0,0,0,0,0,0,0,0,0,0,0,0
4904000,2271000,3,0,0,0,0,0,0,0,0,0,0,0,0,0,0
4905000,2230000,2,0,0,0,0,0,0,0,0,0,0,0,0,0,0
4905000,2231000,2,0,0,0,0,0,0,0,0,0,0,0,0,0,0
4905000,2232000,1,0,0,0,0,0,0,0,0,0,0,0,0,0,0
4905000,2236000,10,0,0,0,0,0,0,0,0,0,0,0,0,0,0
4905000,2240000,1,0,0,0,0,0,0,0,0,0,0,0,0,0,0
4905000,2251000,1,0,0,0,0,0,0,0,0,0,0,0,0,0,0
4905000,2281000,2,0,0,0,0,0,0,0,0,0,0,0,0,0,0
4905000,2282000,1,0,0,0,0,0,0,0,0,0,0,0,0,0,0
4905000,2284000,6,171,0,171,91,0,0,4,2144,0,2144,1350,0,0,28
4905000,2287000,8,1044,801,243,62,15,20,4,3055,1294,1761,681,24,38,7
4905000,2288000,15,0,0,0,0,0,0,0,0,0,0,0,0,0,0
4905000,2290000,1,0,0,0,0,0,0,0,0,0,0,0,0,0,0
4906000,2229000,19,841,100,741,63,136,68,22,6624,884,5740,572,1255,392,169
4906000,2230000,184,14324,1673,12651,1355,1278,728,389,96613,9935,86678,11631,13449,4937,3539
4906000,2231000,1,0,0,0,0,0,0,0,0,0,0,0,0,0,0
4906000,2235000,14,0,0,0,0,0,0,0,0,0,0,0,0,0,0
4906000,2240000,10,0,0,0,0,0,0,0,0,0,0,0,0,0,0
4906000,2252000,69,6197,397,5800,985,508,370,331,46407,2752,43655,7542,5213,2270,2802
4906000,2275000,1,0,0,0,0,0,0,0,0,0,0,0,0,0,0
4906000,2284000,2,0,0,0,0,0,0,0,0,0,0,0,0,0,0
4906000,2287000,5,0,0,0,0,0,0,0,0,0,0,0,0,0,0
4906000,2291000,2,0,0,0,0,0,0,0,0,0,0,0,0,0,0
4906000,2522000,3,0,0,0,0,0,0,0,0,0,0,0,0,0,0
4907000,2229000,33,1757,177,1580,185,181,91,64,12103,1125,10978,1447,1826,552,555
4907000,2235000,366,71328,5217,66111,9824,4569,1885,2598,500772,28651,472121,76118,34829,10040,17530
4907000,2236000,16,1023,58,965,70,35,20,9,8195,438,7757,705,274,100,39
4907000,2252000,1,0,0,0,0,0,0,0,0,0,0,0,0,0,0
4907000,2287000,1,0,0,0,0,0,0,0,0,0,0,0,0,0,0
4907000,2289000,1,0,0,0,0,0,0,0,0,0,0,0,0,0,0
4907000,2290000,1,0,0,0,0,0,0,0,0,0,0,0,0,0,0
4907000,2521000,1,0,0,0,0,0,0,0,0,0,0,0,0,0,0
4908000,2229000,6,356,56,300,18,37,13,29,2843,455,2388,136,452,87,262
4908000,2235000,14,965,34,931,36,28,37,12,7590,184,7406,295,225,330,52
4908000,2236000,22,2020,145,1875,135,45,30,13,17284,1347,15937,1439,332,130,160
4908000,2237000,1,0,0,0,0,0,0,0,0,0,0,0,0,0,0
4908000,2261000,1,0,0,0,0,0,0,0,0,0,0,0,0,0,0
4908000,2263000,1,0,0,0,0,0,0,0,0,0,0,0,0,0,0
4908000,2281000,1,0,0,0,0,0,0,0,0,0,0,0,0,0,0
4908000,2286000,1,0,0,0,0,0,0,0,0,0,0,0,0,0,0
4908000,2290000,1,0,0,0,0,0,0,0,0,0,0,0,0,0,0
4909000,2285000,1,0,0,0,0,0,0,0,0,0,0,0,0,0,0
4909000,2286000,8,430,36,394,134,7,14,25,3059,99,2960,1541,11,30,157
4909000,2288000,1,0,0,0,0,0,0,0,0,0,0,0,0,0,0
4909000,2530000,1,0,0,0,0,0,0,0,0,0,0,0,0,0,0
4909000,2563000,1,0,0,0,0,0,0,0,0,0,0,0,0,0,0
4910000,2236000,1,0,0,0,0,0,0,0,0,0,0,0,0,0,0
4910000,2239000,5,0,0,0,0,0,0,0,0,0,0,0,0,0,0
4910000,2255000,8,0,0,0,0,0,0,0,0,0,0,0,0,0,0
4910000,2256000,42,4482,64,4418,88,27,18,28,30873,445,30428,697,201,148,133
4910000,2290000,1,0,0,0,0,0,0,0,0,0,0,0,0,0,0
4911000,2236000,45,5735,342,5393,1185,484,159,205,42954,2065,40889,9038,4717,745,1448
4911000,2239000,1,0,0,0,0,0,0,0,0,0,0,0,0,0,0
4911000,2255000,18,1797,21,1776,124,32,22,12,12167,125,12042,1075,215,132,55
4911000,2256000,52,6469,198,6271,145,77,12,37,44408,1062,43346,1222,496,65,198
4911000,2260000,1,0,0,0,0,0,0,0,0,0,0,0,0,0,0
4911000,2266000,1,0,0,0,0,0,0,0,0,0,0,0,0,0,0
4911000,2487000,1,0,0,0,0,0,0,0,0,0,0,0,0,0,0
4912000,2235000,3,44,15,29,0,0,0,1,305,94,211,0,0,0,6
4912000,2255000,83,29096,464,28632,2757,769,225,366,183829,2389,181440,14364,4099,551,2080
4912000,2263000,2,0,0,0,0,0,0,0,0,0,0,0,0,0,0
4913000,2234000,1,0,0,0,0,0,0,0,0,0,0,0,0,0,0
4913000,2239000,8,6414,713,5701,252,431,30,134,42228,3119,39109,2351,2126,167,823
4913000,2240000,6,236,5,231,27,6,0,0,2161,48,2113,345,48,0,0
4913000,2254000,95,19397,4082,15315,1939,520,142,375,119787,16457,103330,15505,3847,754,2662
4913000,2255000,1,0,0,0,0,0,0,0,0,0,0,0,0,0,0
4913000,2548000,1,0,0,0,0,0,0,0,0,0,0,0,0,0,0
4914000,2234000,1,0,0,0,0,0,0,0,0,0,0,0,0,0,0
4914000,2239000,62,3938,193,3745,169,79,55,50,28476,1375,27101,1469,600,331,319
4914000,2240000,24,1740,73,1667,54,14,22,10,11943,258,11685,322,100,62,133
4914000,2253000,23,1649,37,1612,148,35,3,29,13319,241,13078,1509,305,22,242
4914000,2254000,15,0,0,0,0,0,0,0,0,0,0,0,0,0,0
4914000,2259000,1,0,0,0,0,0,0,0,0,0,0,0,0,0,0
4915000,2239000,24,2214,49,2165,391,114,58,132,18260,320,17940,3321,848,418,1224
4915000,2252000,28,2309,36,2273,87,24,6,9,16656,244,16412,699,204,26,55
4915000,2253000,88,10909,326,10583,847,378,273,134,69648,2226,67422,4338,2524,1008,623
4916000,2233000,21,1273,62,1211,172,88,7,43,12017,502,11515,1917,862,35,392
4916000,2252000,36,3074,75,2999,179,112,29,76,23117,509,22608,1503,875,153,590
4916000,2261000,3,0,0,0,0,0,0,0,0,0,0,0,0,0,0
4917000,2237000,3,0,0,0,0,0,0,0,0,0,0,0,0,0,0
4917000,2252000,87,6337,101,6236,134,77,20,40,49533,946,48587,1153,650,119,219
4918000,2234000,1,0,0,0,0,0,0,0,0,0,0,0,0,0,0
4918000,2237000,1,0,0,0,0,0,0,0,0,0,0,0,0,0,0
4918000,2252000,10,874,3,871,29,8,0,4,7245,9,7236,341,61,0,34
4918000,2261000,1,0,0,0,0,0,0,0,0,0,0,0,0,0,0
4919000,2238000,13,380,5,375,26,12,5,0,4125,41,4084,249,124,25,0
4919000,2250000,18,3156,57,3099,140,10,11,35,20501,350,20151,1017,45,35,145
4919000,2251000,243,51715,2979,48736,2818,2592,399,838,314396,11536,302860,16752,10655,1648,4232
4919000,2480000,1,0,0,0,0,0,0,0,0,0,0,0,0,0,0
4919000,2500000,1,0,0,0,0,0,0,0,0,0,0,0,0,0,0
4920000,2236000,5,131,20,111,9,7,0,4,1410,347,1063,86,84,0,42
4920000,2262000,4,975,274,701,61,9,41,7,1899,468,1431,216,15,53,7
4920000,2507000,1,0,0,0,0,0,0,0,0,0,0,0,0,0,0
4920000,2511000,4,0,0,0,0,0,0,0,0,0,0,0,0,0,0
4920000,2541000,6,906,425,481,8,46,136,92,3175,1594,1581,27,144,324,188
4921000,2230000,1,0,0,0,0,0,0,0,0,0,0,0,0,0,0
4921000,2231000,39,0,0,0,0,0,0,0,0,0,0,0,0,0,0
4921000,2500000,1,0,0,0,0,0,0,0,0,0,0,0,0,0,0
4922000,2216000,16,0,0,0,0,0,0,0,0,0,0,0,0,0,0
4922000,2258000,1,0,0,0,0,0,0,0,0,0,0,0,0,0,0
4922000,2499000,1,0,0,0,0,0,0,0,0,0,0,0,0,0,0
4922000,2500000,4,4434,3226,1208,156,178,109,75,10362,6503,3859,559,295,163,169
4922000,2524000,1,0,0,0,0,0,0,0,0,0,0,0,0,0,0
4923000,2215000,1,0,0,0,0,0,0,0,0,0,0,0,0,0,0
4923000,2249000,2,0,0,0,0,0,0,0,0,0,0,0,0,0,0
4923000,2501000,1,0,0,0,0,0,0,0,0,0,0,0,0,0,0
4924000,2215000,16,1105,91,1014,71,53,48,19,5294,568,4726,418,508,240,174
4924000,2236000,1,0,0,0,0,0,0,0,0,0,0,0,0,0,0
4924000,2259000,2,0,0,0,0,0,0,0,0,0,0,0,0,0,0
4924000,2479000,1,0,0,0,0,0,0,0,0,0,0,0,0,0,0
4924000,2489000,4,0,0,0,0,0,0,0,0,0,0,0,0,0,0
4925000,2214000,6,0,0,0,0,0,0,0,0,0,0,0,0,0,0
4925000,2216000,26,3120,241,2879,120,103,181,30,9941,1075,8866,548,755,584,111
4925000,2230000,38,0,0,0,0,0,0,0,0,0,0,0,0,0,0
4925000,2231000,2,0,0,0,0,0,0,0,0,0,0,0,0,0,0
4925000,2248000,4,486,13,473,184,8,16,32,1854,38,1816,832,36,30,103
4925000,2255000,1,0,0,0,0,0,0,0,0,0,0,0,0,0,0
4925000,2259000,1,0,0,0,0,0,0,0,0,0,0,0,0,0,0
4926000,2247000,21,933,157,776,166,42,73,21,3880,497,3383,1302,156,196,135
4926000,2248000,11,471,22,449,47,11,18,7,2281,80,2201,295,50,48,31
4926000,2249000,3,0,0,0,0,0,0,0,0,0,0,0,0,0,0
4926000,2481000,1,0,0,0,0,0,0,0,0,0,0,0,0,0,0
4927000,2216000,1,0,0,0,0,0,0,0,0,0,0,0,0,0,0
4927000,2232000,1,0,0,0,0,0,0,0,0,0,0,0,0,0,0
4927000,2246000,15,952,222,730,64,99,27,17,3848,593,3255,305,317,113,28
4927000,2488000,1,0,0,0,0,0,0,0,0,0,0,0,0,0,0
4928000,2230000,1,0,0,0,0,0,0,0,0,0,0,0,0,0,0
4928000,2231000,2,0,0,0,0,0,0,0,0,0,0,0,0,0,0
4928000,2234000,7,325,20,305,25,0,0,0,2503,311,2192,392,0,0,0
4928000,2235000,2,0,0,0,0,0,0,0,0,0,0,0,0,0,0
4928000,2246000,3,29,13,16,2,1,1,0,90,47,43,5,1,1,0
4928000,2247000,1,0,0,0,0,0,0,0,0,0,0,0,0,0,0
4928000,2550000,1,0,0,0,0,0,0,0,0,0,0,0,0,0,0
4929000,2232000,35,2228,157,2071,104,95,29,91,17405,906,16499,777,989,257,657
4929000,2233000,1,0,0,0,0,0,0,0,0,0,0,0,0,0,0
4929000,2234000,34,3066,116,2950,115,73,34,35,24024,1006,23018,1196,652,194,287
4929000,2235000,2,0,0,0,0,0,0,0,0,0,0,0,0,0,0
4929000,2243000,2,0,0,0,0,0,0,0,0,0,0,0,0,0,0
4930000,2228000,81,6158,352,5806,441,267,92,134,46002,2608,43394,3664,2181,574,1051
4930000,2231000,4,414,3,411,4,9,16,1,2935,20,2915,12,49,86,3
4930000,2232000,4,255,24,231,5,12,7,0,1999,179,1820,50,78,78,0
4930000,2243000,1,0,0,0,0,0,0,0,0,0,0,0,0,0,0
4930000,2245000,5,184,10,174,63,6,2,14,1422,17,1405,554,52,8,80
4930000,2246000,2,0,0,0,0,0,0,0,0,0,0,0,0,0,0
4930000,2510000,1,0,0,0,0,0,0,0,0,0,0,0,0,0,0
4931000,2228000,1,0,0,0,0,0,0,0,0,0,0,0,0,0,0
4931000,2231000,3,0,0,0,0,0,0,0,0,0,0,0,0,0,0
4931000,2240000,46,2611,74,2537,322,285,11,57,21976,477,21499,3485,1975,59,524
4931000,2241000,16,0,0,0,0,0,0,0,0,0,0,0,0,0,0
4931000,2246000,3,0,0,0,0,0,0,0,0,0,0,0,0,0,0
4932000,2213000,6,0,0,0,0,0,0,0,0,0,0,0,0,0,0
4932000,2215000,9,1771,266,1505,128,115,90,52,8246,1722,6524,604,1038,352,314
4932000,2238000,6,0,0,0,0,0,0,0,0,0,0,0,0,0,0
4932000,2495000,1,0,0,0,0,0,0,0,0,0,0,0,0,0,0
4933000,2228000,1,0,0,0,0,0,0,0,0,0,0,0,0,0,0
4933000,2237000,12,559,3,556,136,0,6,72,4949,28,4921,1404,0,37,629
4933000,2495000,2,0,0,0,0,0,0,0,0,0,0,0,0,0,0
4933000,2511000,1,0,0,0,0,0,0,0,0,0,0,0,0,0,0
4934000,2214000,1,0,0,0,0,0,0,0,0,0,0,0,0,0,0
4934000,2231000,7,322,68,254,34,2,9,12,2515,318,2197,289,14,73,103
4934000,2482000,1,0,0,0,0,0,0,0,0,0,0,0,0,0,0
4934000,2512000,1,0,0,0,0,0,0,0,0,0,0,0,0,0,0
4934000,2522000,1,0,0,0,0,0,0,0,0,0,0,0,0,0,0
4934000,2531000,1,0,0,0,0,0,0,0,0,0,0,0,0,0,0
4935000,2230000,48,3204,144,3060,138,64,71,20,26447,820,25627,1324,477,334,131
4935000,2245000,7,123,11,112,13,8,1,2,1015,74,941,180,50,4,14
4935000,2521000,1,0,0,0,0,0,0,0,0,0,0,0,0,0,0
4936000,2212000,1,0,0,0,0,0,0,0,0,0,0,0,0,0,0
4936000,2230000,9,0,0,0,0,0,0,0,0,0,0,0,0,0,0
4936000,2234000,17,1203,20,1183,109,43,28,41,9119,182,8937,997,335,153,291
4936000,2235000,27,2350,45,2305,211,68,82,22,18312,327,17985,2082,747,456,156
4936000,2236000,1,0,0,0,0,0,0,0,0,0,0,0,0,0,0
4936000,2523000,3,0,0,0,0,0,0,0,0,0,0,0,0,0,0
4937000,2230000,2,0,0,0,0,0,0,0,0,0,0,0,0,0,0
4937000,2234000,1,0,0,0,0,0,0,0,0,0,0,0,0,0,0
4937000,2235000,18,0,0,0,0,0,0,0,0,0,0,0,0,0,0
4937000,2511000,2,0,0,0,0,0,0,0,0,0,0,0,0,0,0
4938000,2212000,5,0,0,0,0,0,0,0,0,0,0,0,0,0,0
4938000,2226000,1,0,0,0,0,0,0,0,0,0,0,0,0,0,0
4938000,2234000,22,1569,42,1527,134,23,8,33,11815,287,11528,1200,205,32,236
4938000,2235000,45,6299,196,6103,340,147,114,114,43747,1245,42502,2908,928,861,589
4938000,2242000,2,0,0,0,0,0,0,0,0,0,0,0,0,0,0
4938000,2243000,1,0,0,0,0,0,0,0,0,0,0,0,0,0,0
4939000,2212000,2,0,0,0,0,0,0,0,0,0,0,0,0,0,0
4939000,2234000,5,0,0,0,0,0,0,0,0,0,0,0,0,0,0
4939000,2235000,20,1825,30,1795,86,27,16,25,12529,246,12283,678,192,80,155
4939000,2243000,1,0,0,0,0,0,0,0,0,0,0,0,0,0,0
4940000,2211000,3,56,3,53,13,0,0,0,460,19,441,146,0,0,0
4940000,2243000,1,0,0,0,0,0,0,0,0,0,0,0,0,0,0
4941000,2211000,2,0,0,0,0,0,0,0,0,0,0,0,0,0,0
4942000,2250000,1,0,0,0,0,0,0,0,0,0,0,0,0,0,0
4943000,2212000,23,1937,255,1682,134,45,142,56,8694,1340,7354,771,325,543,354
4943000,2213000,9,1151,160,991,65,28,92,14,3713,576,3137,377,221,262,92
4943000,2521000,1,0,0,0,0,0,0,0,0,0,0,0,0,0,0
4944000,2212000,3,0,0,0,0,0,0,0,0,0,0,0,0,0,0
4945000,2224000,1,0,0,0,0,0,0,0,0,0,0,0,0,0,0
4945000,2225000,1,0,0,0,0,0,0,0,0,0,0,0,0,0,0
4945000,2248000,8,0,0,0,0,0,0,0,0,0,0,0,0,0,0
4946000,2228000,4,157,11,146,8,0,8,7,766,57,709,32,0,46,14
4946000,2485000,1,0,0,0,0,0,0,0,0,0,0,0,0,0,0
4947000,2212000,2,0,0,0,0,0,0,0,0,0,0,0,0,0,0
4947000,2485000,2,0,0,0,0,0,0,0,0,0,0,0,0,0,0
4947000,2499000,1,0,0,0,0,0,0,0,0,0,0,0,0,0,0
4947000,2517000,1,0,0,0,0,0,0,0,0,0,0,0,0,0,0
4947000,2535000,1,0,0,0,0,0,0,0,0,0,0,0,0,0,0
4948000,2212000,22,1612,132,1480,109,70,82,15,7877,918,6959,724,627,556,139
4948000,2484000,1,0,0,0,0,0,0,0,0,0,0,0,0,0,0
4949000,2212000,17,0,0,0,0,0,0,0,0,0,0,0,0,0,0
4949000,2222000,5,0,0,0,0,0,0,0,0,0,0,0,0,0,0
4949000,2226000,3,0,0,0,0,0,0,0,0,0,0,0,0,0,0
4949000,2227000,3,0,0,0,0,0,0,0,0,0,0,0,0,0,0
4949000,2232000,1,0,0,0,0,0,0,0,0,0,0,0,0,0,0
4949000,2484000,1,0,0,0,0,0,0,0,0,0,0,0,0,0,0
4950000,2212000,1,0,0,0,0,0,0,0,0,0,0,0,0,0,0
4950000,2222000,1,0,0,0,0,0,0,0,0,0,0,0,0,0,0
4950000,2224000,23,2260,241,2019,130,40,162,34,5803,1070,4733,474,103,355,81
4950000,2226000,15,925,52,873,80,7,40,30,4822,275,4547,401,44,166,168
4950000,2232000,1,0,0,0,0,0,0,0,0,0,0,0,0,0,0
4950000,2482000,39,16395,7508,8887,1260,447,650,480,30992,14886,16106,2188,753,837,709
4950000,2483000,2,0,0,0,0,0,0,0,0,0,0,0,0,0,0
4951000,2224000,3,610,48,562,33,23,43,9,1700,235,1465,116,25,87,26
4951000,2225000,18,4192,789,3403,344,114,313,142,8978,1535,7443,1126,221,658,265
4951000,2487000,1,0,0,0,0,0,0,0,0,0,0,0,0,0,0
4951000,2519000,6,3874,2628,1246,104,157,84,86,7826,4993,2833,271,216,169,99
4951000,2520000,1,0,0,0,0,0,0,0,0,0,0,0,0,0,0
4952000,2222000,15,694,32,662,56,53,22,21,5071,156,4915,525,417,281,141
4952000,2223000,3,0,0,0,0,0,0,0,0,0,0,0,0,0,0
4953000,2210000,2,0,0,0,0,0,0,0,0,0,0,0,0,0,0
4954000,2230000,1,0,0,0,0,0,0,0,0,0,0,0,0,0,0
4955000,2208000,2,0,0,0,0,0,0,0,0,0,0,0,0,0,0
4955000,2209000,33,2781,261,2520,199,287,238,115,17522,1532,15990,1323,2610,1321,1046
4955000,2210000,2,0,0,0,0,0,0,0,0,0,0,0,0,0,0
4955000,2222000,1,0,0,0,0,0,0,0,0,0,0,0,0,0,0
4955000,2521000,1,0,0,0,0,0,0,0,0,0,0,0,0,0,0
4955000,2551000,3,694,403,291,27,22,89,48,1384,593,791,38,24,391,76
4956000,2528000,1,0,0,0,0,0,0,0,0,0,0,0,0,0,0
4956000,2551000,1,0,0,0,0,0,0,0,0,0,0,0,0,0,0
4957000,2228000,1,0,0,0,0,0,0,0,0,0,0,0,0,0,0
4957000,2551000,1,0,0,0,0,0,0,0,0,0,0,0,0,0,0
4958000,2222000,7,0,0,0,0,0,0,0,0,0,0,0,0,0,0
4961000,2221000,2,0,0,0,0,0,0,0,0,0,0,0,0,0,0
4962000,2487000,1,0,0,0,0,0,0,0,0,0,0,0,0,0,0
4963000,2222000,1,0,0,0,0,0,0,0,0,0,0,0,0,0,0
4963000,2487000,1,0,0,0,0,0,0,0,0,0,0,0,0,0,0
4964000,2220000,8,0,0,0,0,0,0,0,0,0,0,0,0,0,0
4964000,2221000,11,0,0,0,0,0,0,0,0,0,0,0,0,0,0
4964000,2223000,1,0,0,0,0,0,0,0,0,0,0,0,0,0,0
4965000,2213000,15,3619,233,3386,271,28,50,33,20645,1126,19519,2133,197,183,173
4965000,2214000,4,0,0,0,0,0,0,0,0,0,0,0,0,0,0
4965000,2219000,1,0,0,0,0,0,0,0,0,0,0,0,0,0,0
4965000,2220000,1,0,0,0,0,0,0,0,0,0,0,0,0,0,0
4966000,2213000,1,0,0,0,0,0,0,0,0,0,0,0,0,0,0
4966000,2219000,6,458,6,452,31,14,18,21,3432,41,3391,232,160,127,185
4966000,2220000,87,24292,945,23347,3573,414,521,539,123777,4031,119746,28298,2280,2239,3572
4966000,2221000,2,0,0,0,0,0,0,0,0,0,0,0,0,0,0
4967000,2220000,15,0,0,0,0,0,0,0,0,0,0,0,0,0,0
4968000,2484000,2,0,0,0,0,0,0,0,0,0,0,0,0,0,0
4968000,2546000,1,0,0,0,0,0,0,0,0,0,0,0,0,0,0
4969000,2212000,20,0,0,0,0,0,0,0,0,0,0,0,0,0,0
4969000,2219000,1,0,0,0,0,0,0,0,0,0,0,0,0,0,0
4970000,2212000,2,0,0,0,0,0,0,0,0,0,0,0,0,0,0
4970000,2500000,1,0,0,0,0,0,0,0,0,0,0,0,0,0,0
4972000,2209000,12,1035,18,1017,75,5,12,17,6860,116,6744,684,15,83,129
4972000,2210000,43,12241,456,11785,800,37,260,235,71641,1740,69901,5640,250,1350,1529
4972000,2216000,2,0,0,0,0,0,0,0,0,0,0,0,0,0,0
4973000,2214000,11,735,15,720,107,8,16,18,4994,191,4803,810,16,206,116
4973000,2215000,5,0,0,0,0,0,0,0,0,0,0,0,0,0,0
4974000,2213000,3,0,0,0,0,0,0,0,0,0,0,0,0,0,0
4974000,2544000,4,0,0,0,0,0,0,0,0,0,0,0,0,0,0
4975000,2212000,2,0,0,0,0,0,0,0,0,0,0,0,0,0,0
4975000,2213000,25,1915,45,1870,214,20,138,92,7405,222,7183,710,54,298,336
4975000,2216000,2,0,0,0,0,0,0,0,0,0,0,0,0,0,0
4975000,2542000,4,0,0,0,0,0,0,0,0,0,0,0,0,0,0
4977000,2209000,20,5131,30,5101,136,7,18,48,39305,105,39200,1167,50,83,418
4977000,2211000,3,97,1,96,9,7,4,0,537,5,532,82,31,28,0
4977000,2212000,34,8834,102,8732,1976,228,564,235,36306,636,35670,8167,576,1551,804
4977000,2214000,1,0,0,0,0,0,0,0,0,0,0,0,0,0,0
4977000,2215000,2,0,0,0,0,0,0,0,0,0,0,0,0,0,0
4977000,2523000,1,0,0,0,0,0,0,0,0,0,0,0,0,0,0
4977000,2541000,1,0,0,0,0,0,0,0,0,0,0,0,0,0,0
4978000,2208000,5,255,5,250,57,0,6,3,1562,11,1551,464,0,30,19
4978000,2209000,3,0,0,0,0,0,0,0,0,0,0,0,0,0,0
4978000,2211000,12,44268,1295,42973,3398,287,1299,647,178509,3766,174743,14468,933,3494,2441
4978000,2212000,9,561,11,550,55,2,29,11,3391,35,3356,468,12,264,67
4979000,2208000,2,0,0,0,0,0,0,0,0,0,0,0,0,0,0
4979000,2211000,10,1054,36,1018,49,12,83,2,5455,258,5197,301,20,321,2
4979000,2504000,1,0,0,0,0,0,0,0,0,0,0,0,0,0,0
4979000,2505000,1,0,0,0,0,0,0,0,0,0,0,0,0,0,0
4979000,2538000,1,0,0,0,0,0,0,0,0,0,0,0,0,0,0
4979000,2551000,1,0,0,0,0,0,0,0,0,0,0,0,0,0,0
4980000,2210000,1,0,0,0,0,0,0,0,0,0,0,0,0,0,0
4980000,2211000,31,1848,75,1773,193,24,132,81,11169,672,10497,1667,112,626,529
4980000,2212000,106,11676,632,11044,1373,95,589,253,54191,1646,52545,9291,417,2548,1742
4980000,2486000,4,615,330,285,46,22,59,6,1328,639,689,84,22,335,8
4980000,2502000,1,0,0,0,0,0,0,0,0,0,0,0,0,0,0
4980000,2506000,11,7795,4770,3025,324,223,166,255,15966,10621,5345,850,284,330,479
4980000,2533000,2,0,0,0,0,0,0,0,0,0,0,0,0,0,0
4980000,2534000,3,0,0,0,0,0,0,0,0,0,0,0,0,0,0
4981000,2210000,20,2725,72,2653,508,13,143,52,13871,156,13715,3953,49,453,259
4981000,2211000,22,2669,57,2612,206,46,194,84,12410,358,12052,1207,83,713,469
4981000,2212000,1,0,0,0,0,0,0,0,0,0,0,0,0,0,0
4982000,2207000,8,18929,1838,17091,1190,187,527,426,70738,4028,66710,5536,643,1855,1516
4982000,2208000,9,105395,8351,97044,4335,684,1514,1796,338291,21529,316762,20733,1720,4529,6772
4982000,2209000,9,0,0,0,0,0,0,0,0,0,0,0,0,0,0
4982000,2210000,2,0,0,0,0,0,0,0,0,0,0,0,0,0,0
4982000,2214000,1,0,0,0,0,0,0,0,0,0,0,0,0,0,0
4983000,2207000,271,65915,3062,62853,3262,382,2089,898,241910,8224,233686,14830,1145,7329,3280
4983000,2208000,208,96652,4226,92426,5538,456,2341,3353,391634,14907,376727,28687,1354,8380,18630
4983000,2209000,12,1016,10,1006,161,4,30,7,4975,57,4918,966,16,98,33
4983000,2535000,1,0,0,0,0,0,0,0,0,0,0,0,0,0,0
4984000,2206000,15,4673,249,4424,190,48,234,43,12210,633,11577,524,100,560,124
4984000,2207000,294,57593,4404,53189,2545,323,1925,708,190758,9437,181321,10034,707,6705,2211
4984000,2208000,160,45088,3627,41461,1746,167,1959,324,100798,7058,93740,4867,330,4841,958
4984000,2209000,9,0,0,0,0,0,0,0,0,0,0,0,0,0,0
4984000,2210000,5,0,0,0,0,0,0,0,0,0,0,0,0,0,0
4984000,2538000,2,0,0,0,0,0,0,0,0,0,0,0,0,0,0
4984000,2540000,1,0,0,0,0,0,0,0,0,0,0,0,0,0,0
4985000,2206000,83,54740,1725,53015,2531,458,769,862,179784,4118,175666,11003,1429,2288,3188
4985000,2207000,326,39476,516,38960,2086,113,1618,391,128464,1579,126885,7514,285,5239,1280
4985000,2208000,43,39986,5175,34811,2043,202,1176,421,75086,7912,67174,4156,348,2110,981
4985000,2209000,13,0,0,0,0,0,0,0,0,0,0,0,0,0,0
4985000,2210000,30,0,0,0,0,0,0,0,0,0,0,0,0,0,0
4986000,2206000,1253,433934,16662,417272,22495,2208,11601,6427,1297054,46412,1250642,70132,5597,29615,23246
4986000,2207000,73,10363,146,10217,555,37,378,151,30204,392,29812,1743,97,987,389
4986000,2209000,1,0,0,0,0,0,0,0,0,0,0,0,0,0,0
4986000,2210000,33,0,0,0,0,0,0,0,0,0,0,0,0,0,0
4987000,2206000,238,68017,1543,66474,2726,246,1078,915,221680,4285,217395,10303,722,3157,3211
4987000,2209000,2,0,0,0,0,0,0,0,0,0,0,0,0,0,0
4987000,2210000,18,0,0,0,0,0,0,0,0,0,0,0,0,0,0
4988000,2205000,4,0,0,0,0,0,0,0,0,0,0,0,0,0,0
4988000,2206000,69,13977,162,13815,786,53,292,202,46788,421,46367,3057,147,1105,797
4988000,2207000,8,901,11,890,73,6,37,11,4075,39,4036,499,18,110,69
4988000,2209000,6,0,0,0,0,0,0,0,0,0,0,0,0,0,0
4988000,2210000,10,2264,251,2013,161,25,164,39,8156,778,7378,627,29,391,80
4989000,2207000,3,0,0,0,0,0,0,0,0,0,0,0,0,0,0
4989000,2208000,2,0,0,0,0,0,0,0,0,0,0,0,0,0,0
4989000,2529000,2,0,0,0,0,0,0,0,0,0,0,0,0,0,0
4989000,2535000,2,0,0,0,0,0,0,0,0,0,0,0,0,0,0
4989000,2536000,2,0,0,0,0,0,0,0,0,0,0,0,0,0,0
4989000,2555000,6,4177,2564,1613,120,421,152,127,6304,3963,2341,271,456,174,172
4989000,2556000,1,0,0,0,0,0,0,0,0,0,0,0,0,0,0
4989000,2558000,1,0,0,0,0,0,0,0,0,0,0,0,0,0,0
4990000,2207000,1,0,0,0,0,0,0,0,0,0,0,0,0,0,0
4990000,2556000,3,138,91,47,4,2,4,0,435,299,136,13,2,4,0
4991000,2205000,1,0,0,0,0,0,0,0,0,0,0,0,0,0,0
4991000,2206000,2,0,0,0,0,0,0,0,0,0,0,0,0,0,0
4991000,2207000,2,0,0,0,0,0,0,0,0,0,0,0,0,0,0
4991000,2529000,1,0,0,0,0,0,0,0,0,0,0,0,0,0,0
4992000,2205000,18,1365,57,1308,91,7,52,8,8193,332,7861,716,56,227,53
4992000,2206000,11,438,26,412,46,0,21,12,3050,186,2864,332,0,85,102
4992000,2208000,4,0,0,0,0,0,0,0,0,0,0,0,0,0,0
4993000,2205000,97,55123,4306,50817,3250,550,1963,1471,174964,11909,163055,11771,1718,5460,5460
4993000,2206000,6,724,45,679,26,0,26,5,3998,327,3671,120,0,164,20
4993000,2207000,5,0,0,0,0,0,0,0,0,0,0,0,0,0,0
4993000,2560000,3,0,0,0,0,0,0,0,0,0,0,0,0,0,0
4994000,2205000,162,55595,5873,49722,7635,361,1557,918,254727,13950,240777,35033,1433,5185,4348
4995000,2200000,3,0,0,0,0,0,0,0,0,0,0,0,0,0,0
4995000,2201000,11,671,8,663,24,2,5,6,4340,18,4322,175,12,19,34
4995000,2204000,20,2806,68,2738,266,9,108,57,14472,286,14186,1761,33,357,337
4995000,2205000,38,3928,235,3693,313,25,182,47,20772,1036,19736,2246,77,798,231
4995000,2533000,1,0,0,0,0,0,0,0,0,0,0,0,0,0,0
4995000,2554000,1,0,0,0,0,0,0,0,0,0,0,0,0,0,0
4995000,2555000,1,0,0,0,0,0,0,0,0,0,0,0,0,0,0
4996000,2200000,221,74139,1837,72302,4238,315,1122,2402,426045,5895,420150,27027,1249,4418,14768
4996000,2201000,58,5974,137,5837,252,24,136,60,34093,441,33652,1306,93,669,270
4996000,2203000,26,6209,153,6056,416,55,284,69,20402,584,19818,1647,304,935,298
4996000,2204000,31,2797,60,2737,230,5,101,46,15746,290,15456,1542,31,456,229
4996000,2543000,1,0,0,0,0,0,0,0,0,0,0,0,0,0,0
4996000,2555000,8,3308,1170,2138,29,104,0,3,4479,2133,2346,58,124,0,6
4997000,2199000,7,0,0,0,0,0,0,0,0,0,0,0,0,0,0
4997000,2200000,33,2195,75,2120,83,16,118,25,12555,352,12203,427,96,533,192
4997000,2201000,44,2923,67,2856,133,8,130,21,17053,364,16689,791,20,711,101
4997000,2203000,7,374,19,355,17,4,26,4,2060,220,1840,119,32,158,20
4997000,2533000,3,0,0,0,0,0,0,0,0,0,0,0,0,0,0
4998000,2198000,2,0,0,0,0,0,0,0,0,0,0,0,0,0,0
4998000,2199000,9,1144,18,1126,69,7,18,14,3069,22,3047,312,8,33,43
4998000,2200000,13,1672,45,1627,87,15,90,21,5179,102,5077,410,170,299,229
4998000,2532000,2,0,0,0,0,0,0,0,0,0,0,0,0,0,0
4998000,2533000,2,0,0,0,0,0,0,0,0,0,0,0,0,0,0
4998000,2541000,1,0,0,0,0,0,0,0,0,0,0,0,0,0,0
4999000,2198000,3,221,10,211,9,0,0,6,517,18,499,19,0,0,36
4999000,2199000,2,0,0,0,0,0,0,0,0,0,0,0,0,0,0
4999000,2201000,1,0,0,0,0,0,0,0,0,0,0,0,0,0,0
4999000,2532000,2,0,0,0,0,0,0,0,0,0,0,0,0,0,0
4999000,2533000,3,0,0,0,0,0,0,0,0,0,0,0,0,0,0
4999000,2554000,5,386,250,136,13,10,2,25,745,448,297,26,20,6,44
5000000,2198000,4,152,0,152,2,3,6,5,876,0,876,22,18,22,30
5000000,2200000,2,0,0,0,0,0,0,0,0,0,0,0,0,0,0
5000000,2531000,1,0,0,0,0,0,0,0,0,0,0,0,0,0,0
5000000,2532000,75,28376,17801,10575,1120,867,572,699,55796,31416,24380,3067,1366,1945,1399
5000000,2534000,1,0,0,0,0,0,0,0,0,0,0,0,0,0,0
5001000,2197000,12,3917,650,3267,172,63,63,29,8399,1379,7020,358,111,85,106
5001000,2198000,2,0,0,0,0,0,0,0,0,0,0,0,0,0,0
5001000,2532000,1,0,0,0,0,0,0,0,0,0,0,0,0,0,0
5001000,2565000,2,0,0,0,0,0,0,0,0,0,0,0,0,0,0
5002000,2196000,1,0,0,0,0,0,0,0,0,0,0,0,0,0,0
5002000,2197000,7,479,1,478,29,0,15,5,1938,5,1933,218,0,51,20
5002000,2200000,2,0,0,0,0,0,0,0,0,0,0,0,0,0,0
5002000,2203000,1,0,0,0,0,0,0,0,0,0,0,0,0,0,0
5002000,2504000,3,0,0,0,0,0,0,0,0,0,0,0,0,0,0
5002000,2533000,1,0,0,0,0,0,0,0,0,0,0,0,0,0,0
5002000,2539000,16,1543,1116,427,62,24,19,9,3217,2299,918,244,28,40,24
5002000,2559000,2,0,0,0,0,0,0,0,0,0,0,0,0,0,0
5002000,2565000,3,0,0,0,0,0,0,0,0,0,0,0,0,0,0
5003000,2196000,3,179,2,177,11,0,11,3,888,6,882,41,0,39,18
5003000,2197000,1,0,0,0,0,0,0,0,0,0,0,0,0,0,0
5003000,2527000,2,0,0,0,0,0,0,0,0,0,0,0,0,0,0
5003000,2539000,3,0,0,0,0,0,0,0,0,0,0,0,0,0,0
5003000,2540000,2,0,0,0,0,0,0,0,0,0,0,0,0,0,0
5003000,2545000,1,0,0,0,0,0,0,0,0,0,0,0,0,0,0
5003000,2559000,1,0,0,0,0,0,0,0,0,0,0,0,0,0,0
5004000,2195000,1,0,0,0,0,0,0,0,0,0,0,0,0,0,0
5004000,2196000,1,0,0,0,0,0,0,0,0,0,0,0,0,0,0
5004000,2561000,5,0,0,0,0,0,0,0,0,0,0,0,0,0,0
5005000,2194000,1,0,0,0,0,0,0,0,0,0,0,0,0,0,0
5005000,2195000,5,230,9,221,20,0,8,5,1407,245,1162,68,0,40,32
5005000,2479000,1,0,0,0,0,0,0,0,0,0,0,0,0,0,0
5005000,2480000,3,259,137,122,28,3,11,2,457,283,174,36,3,11,3
5005000,2481000,7,1157,619,538,72,40,26,40,2349,1171,1178,170,159,51,75
5005000,2482000,1,0,0,0,0,0,0,0,0,0,0,0,0,0,0
5005000,2488000,1,0,0,0,0,0,0,0,0,0,0,0,0,0,0
5005000,2539000,9,0,0,0,0,0,0,0,0,0,0,0,0,0,0
5006000,2194000,1,0,0,0,0,0,0,0,0,0,0,0,0,0,0
5006000,2198000,1,0,0,0,0,0,0,0,0,0,0,0,0,0,0
5006000,2200000,1,0,0,0,0,0,0,0,0,0,0,0,0,0,0
5006000,2204000,1,0,0,0,0,0,0,0,0,0,0,0,0,0,0
5007000,2194000,5,230,5,225,26,2,9,5,821,23,798,109,2,16,17
5007000,2198000,2,0,0,0,0,0,0,0,0,0,0,0,0,0,0
5007000,2564000,3,0,0,0,0,0,0,0,0,0,0,0,0,0,0
5007000,2567000,2,0,0,0,0,0,0,0,0,0,0,0,0,0,0
5008000,2194000,2,0,0,0,0,0,0,0,0,0,0,0,0,0,0
5008000,2195000,1,0,0,0,0,0,0,0,0,0,0,0,0,0,0
5008000,2197000,1,0,0,0,0,0,0,0,0,0,0,0,0,0,0
5008000,2198000,3,274,10,264,29,0,3,6,1840,14,1826,388,0,14,45
5008000,2199000,1,0,0,0,0,0,0,0,0,0,0,0,0,0,0
5009000,2194000,1,0,0,0,0,0,0,0,0,0,0,0,0,0,0
5009000,2195000,11,494,32,462,36,3,20,7,3304,170,3134,193,3,81,47
5009000,2197000,1,0,0,0,0,0,0,0,0,0,0,0,0,0,0
5009000,2478000,2,0,0,0,0,0,0,0,0,0,0,0,0,0,0
5009000,2513000,1,0,0,0,0,0,0,0,0,0,0,0,0,0,0
5010000,2194000,2,0,0,0,0,0,0,0,0,0,0,0,0,0,0
5010000,2197000,1,0,0,0,0,0,0,0,0,0,0,0,0,0,0
5010000,2504000,2,0,0,0,0,0,0,0,0,0,0,0,0,0,0
5010000,2505000,15,9146,6516,2630,458,119,359,125,14126,9341,4785,985,239,622,454
5010000,2553000,3,0,0,0,0,0,0,0,0,0,0,0,0,0,0
5011000,2196000,3,228,2,226,9,0,0,0,1874,18,1856,119,0,0,0
5011000,2504000,1,0,0,0,0,0,0,0,0,0,0,0,0,0,0
5011000,2505000,3,0,0,0,0,0,0,0,0,0,0,0,0,0,0
5011000,2506000,1,0,0,0,0,0,0,0,0,0,0,0,0,0,0
5012000,2194000,2,0,0,0,0,0,0,0,0,0,0,0,0,0,0
5012000,2195000,1,0,0,0,0,0,0,0,0,0,0,0,0,0,0
5012000,2197000,1,0,0,0,0,0,0,0,0,0,0,0,0,0,0
5013000,2195000,3,0,0,0,0,0,0,0,0,0,0,0,0,0,0
5013000,2196000,1,0,0,0,0,0,0,0,0,0,0,0,0,0,0
5013000,2197000,6,382,2,380,59,0,1,6,3162,12,3150,496,0,3,84
5013000,2503000,2,0,0,0,0,0,0,0,0,0,0,0,0,0,0
5014000,2188000,9,237,1,236,26,4,4,11,1735,3,1732,288,26,18,87
5014000,2189000,2,0,0,0,0,0,0,0,0,0,0,0,0,0,0
5014000,2190000,2,0,0,0,0,0,0,0,0,0,0,0,0,0,0
5015000,2188000,43,4307,86,4221,902,173,197,215,26559,558,26001,4176,1111,1087,956
5015000,2190000,1,0,0,0,0,0,0,0,0,0,0,0,0,0,0
5016000,2190000,1,0,0,0,0,0,0,0,0,0,0,0,0,0,0
5016000,2510000,1,0,0,0,0,0,0,0,0,0,0,0,0,0,0
5019000,2186000,4,98,0,98,2,3,0,0,864,0,864,12,17,0,0
5019000,2187000,1,0,0,0,0,0,0,0,0,0,0,0,0,0,0
5019000,2532000,7,283,172,111,33,13,0,8,768,365,403,96,18,0,22
5020000,2186000,1,0,0,0,0,0,0,0,0,0,0,0,0,0,0
5021000,2478000,1,0,0,0,0,0,0,0,0,0,0,0,0,0,0
5021000,2515000,2,0,0,0,0,0,0,0,0,0,0,0,0,0,0
5021000,2517000,1,0,0,0,0,0,0,0,0,0,0,0,0,0,0
5022000,2471000,2,0,0,0,0,0,0,0,0,0,0,0,0,0,0
5022000,2516000,1,0,0,0,0,0,0,0,0,0,0,0,0,0,0
5022000,2528000,2,0,0,0,0,0,0,0,0,0,0,0,0,0,0
5023000,2513000,1,0,0,0,0,0,0,0,0,0,0,0,0,0,0
5023000,2514000,2,0,0,0,0,0,0,0,0,0,0,0,0,0,0
5024000,2512000,1,0,0,0,0,0,0,0,0,0,0,0,0,0,0
5024000,2514000,1,0,0,0,0,0,0,0,0,0,0,0,0,0,0
5025000,2512000,1,0,0,0,0,0,0,0,0,0,0,0,0,0,0
5025000,2513000,11,6503,4537,1966,339,123,136,135,11900,7836,4064,819,173,500,237
5026000,2498000,1,0,0,0,0,0,0,0,0,0,0,0,0,0,0
5026000,2512000,1,0,0,0,0,0,0,0,0,0,0,0,0,0,0
5027000,2512000,2,0,0,0,0,0,0,0,0,0,0,0,0,0,0
5028000,2533000,4,0,0,0,0,0,0,0,0,0,0,0,0,0,0
5029000,2512000,1,0,0,0,0,0,0,0,0,0,0,0,0,0,0
5033000,2508000,1,0,0,0,0,0,0,0,0,0,0,0,0,0,0
5034000,2481000,1,0,0,0,0,0,0,0,0,0,0,0,0,0,0
5039000,2494000,1,0,0,0,0,0,0,0,0,0,0,0,0,0,0
5039000,2505000,1,0,0,0,0,0,0,0,0,0,0,0,0,0,0
5046000,2503000,1,0,0,0,0,0,0,0,0,0,0,0,0,0,0
5054000,2503000,1,0,0,0,0,0,0,0,0,0,0,0,0,0,0
5055000,2500000,1,0,0,0,0,0,0,0,0,0,0,0,0,0,0
5055000,2503000,1,0,0,0,0,0,0,0,0,0,0,0,0,0,0
5056000,2503000,5,3658,2740,918,146,81,36,113,5072,3844,1228,234,83,41,161
