x,y,ACCOMMODATION UNITS (ROOMS APARTMENTS CAMPING SITES) - TOTAL,A_AUSTRIAN TOURISTS,A_DOMESTIC TOURISTS - TOTAL,A_FOREIGN TOURISTS - TOTAL,A_GERMAN TOURISTS,A_ITALIAN TOURISTS,A_SLOVENIAN TOURISTS,ESTABLISHMENTS - TOTAL,NUMBER OF PERMANENT BEDS,N_AUSTRIAN TOURISTS,N_DOMESTIC TOURISTS - TOTAL,N_FOREIGN TOURISTS - TOTAL,N_GERMAN TOURISTS,N_ITALIAN TOURISTS,N_SLOVENIAN TOURISTS,TOTAL ARRIVALS,TOTAL NIGHTS
0,72,1,0,0,0,0,0,0,1,2,0,0,0,0,0,0,0,0
0,74,21,23,3,341,55,8,0,10,55,241,55,2576,549,70,0,344,2631
0,75,1,0,0,0,0,0,0,1,2,0,0,0,0,0,0,0,0
0,77,4,0,0,0,0,0,0,1,11,0,0,0,0,0,0,0,0
0,78,627,941,1613,15541,2070,721,2850,102,1611,8843,13018,120406,22926,5225,22567,17154,133424
0,94,15,41,17,255,61,26,0,6,40,403,77,2187,638,236,0,272,2264
0,105,51,0,0,0,0,0,0,12,148,0,0,0,0,0,0,0,0
0,106,118,93,231,7118,259,11,933,15,255,706,586,32968,1785,119,5561,7349,33554
0,107,146,50,86,3745,467,19,60,71,476,268,436,26726,4005,105,314,3831,27162
0,110,27,63,3,726,265,1,0,18,92,523,7,6996,2917,16,0,729,7003
0,124,11,0,0,0,0,0,0,3,21,0,0,0,0,0,0,0,0
0,126,3,0,0,0,0,0,0,1,6,0,0,0,0,0,0,0,0
0,127,39,0,0,0,0,0,0,4,80,0,0,0,0,0,0,0,0
1,52,6,14,4,110,31,0,9,3,14,157,36,1021,353,0,65,114,1057
1,55,8,0,0,0,0,0,0,2,20,0,0,0,0,0,0,0,0
1,56,11,11,6,221,91,4,6,5,30,140,42,2219,1105,32,98,227,2261
1,71,3,0,0,0,0,0,0,1,10,0,0,0,0,0,0,0,0
1,72,40,101,29,874,177,37,227,14,112,932,269,8839,1817,377,2454,903,9108
1,76,79,47,121,1702,195,192,72,37,214,343,823,10720,1450,1222,583,1823,11543
1,77,21,20,21,387,46,14,43,9,57,214,158,3030,489,100,447,408,3188
1,104,71,37,20,1091,78,6,42,16,191,301,130,8446,619,102,330,1111,8576
1,105,180,225,150,4963,422,70,113,30,486,1245,772,30050,3089,272,757,5113,30822
1,110,3,0,0,81,36,6,0,3,13,0,0,944,463,60,0,81,944
1,118,2,0,0,0,0,0,0,2,8,0,0,0,0,0,0,0,0
2,50,10,12,23,217,18,12,76,7,32,164,241,2101,219,112,874,240,2342
2,52,1,0,0,0,0,0,0,1,4,0,0,0,0,0,0,0,0
2,53,4,0,0,0,0,0,0,1,8,0,0,0,0,0,0,0,0
2,55,493,680,906,8776,1659,492,830,246,1259,6538,5945,71530,17871,3297,8558,9682,77475
2,56,2,0,0,0,0,0,0,1,3,0,0,0,0,0,0,0,0
2,72,276,332,196,4578,796,222,980,75,779,2893,1568,38987,7395,1524,9907,4774,40555
2,76,1372,1292,3884,33007,3685,1637,4546,216,3459,9647,23052,218532,28942,10077,36793,36891,241584
2,77,5,3,2,75,10,3,2,4,14,36,23,624,78,15,26,77,647
2,97,15,2,34,219,23,43,19,5,37,2,224,1302,125,212,212,253,1526
2,104,585,264,131,9945,1046,67,240,184,1638,1998,846,75769,9233,509,1912,10076,76615
2,109,10,5,2,224,88,6,0,8,44,70,4,2286,1070,42,0,226,2290
2,113,1,0,0,0,0,0,0,1,4,0,0,0,0,0,0,0,0
2,127,19,0,0,0,0,0,0,2,44,0,0,0,0,0,0,0,0
3,53,18,38,9,253,62,0,19,10,50,436,110,2825,867,0,213,262,2935
3,56,1,0,0,0,0,0,0,1,2,0,0,0,0,0,0,0,0
3,68,4,0,0,0,0,0,0,1,8,0,0,0,0,0,0,0,0
3,72,2,0,0,0,0,0,0,2,6,0,0,0,0,0,0,0,0
3,76,1,0,0,0,0,0,0,1,4,0,0,0,0,0,0,0,0
3,91,8,18,12,326,56,22,0,3,17,104,44,1779,483,119,0,338,1823
3,97,154,69,440,2384,308,112,258,87,439,564,3544,17956,3374,814,2195,2824,21500
3,104,210,87,112,4083,554,20,126,73,609,821,788,32255,5669,119,906,4195,33043
3,105,4,0,0,0,0,0,0,3,13,0,0,0,0,0,0,0,0
3,109,6,11,0,158,70,0,1,4,19,114,0,1390,744,0,1,158,1390
3,116,2,0,0,0,0,0,0,2,10,0,0,0,0,0,0,0,0
3,122,7,0,0,0,0,0,0,2,18,0,0,0,0,0,0,0,0
3,123,1,0,0,0,0,0,0,1,6,0,0,0,0,0,0,0,0
4,55,6,0,0,0,0,0,0,2,12,0,0,0,0,0,0,0,0
4,97,12,10,17,245,47,26,22,7,29,42,142,1632,339,81,164,262,1774
4,98,1,0,0,0,0,0,0,1,5,0,0,0,0,0,0,0,0
4,104,37,27,7,592,90,3,10,9,110,223,29,4215,875,24,48,599,4244
4,106,9,12,2,234,111,4,0,7,32,95,6,2109,1107,36,0,236,2115
4,107,9,7,96,223,86,10,7,5,27,27,198,1422,798,39,11,319,1620
4,109,6,0,0,0,0,0,0,3,16,0,0,0,0,0,0,0,0
5,50,7,0,0,0,0,0,0,1,14,0,0,0,0,0,0,0,0
5,54,429,272,2528,14662,933,510,1392,6,928,1174,7076,66171,4185,1972,8261,17190,73247
5,55,3,0,0,0,0,0,0,1,6,0,0,0,0,0,0,0,0
5,57,2,0,0,0,0,0,0,2,4,0,0,0,0,0,0,0,0
5,73,4,17,16,704,81,28,13,4,18,92,69,2388,301,74,92,720,2457
5,96,1,0,0,0,0,0,0,1,4,0,0,0,0,0,0,0,0
5,104,29,23,6,738,82,6,3,10,82,206,19,5263,743,33,13,744,5282
5,105,7,0,0,0,0,0,0,2,18,0,0,0,0,0,0,0,0
5,109,3,0,0,0,0,0,0,3,16,0,0,0,0,0,0,0,0
6,50,4,0,0,0,0,0,0,1,8,0,0,0,0,0,0,0,0
6,56,2,0,0,0,0,0,0,1,4,0,0,0,0,0,0,0,0
6,95,1,0,0,0,0,0,0,1,2,0,0,0,0,0,0,0,0
6,104,775,464,670,18063,2867,200,1379,143,1915,3293,3919,125368,21906,1163,8706,18733,129287
6,105,1,0,0,0,0,0,0,1,2,0,0,0,0,0,0,0,0
6,106,2,0,0,0,0,0,0,2,10,0,0,0,0,0,0,0,0
6,108,5,0,0,0,0,0,0,1,10,0,0,0,0,0,0,0,0
6,122,1,0,0,0,0,0,0,1,6,0,0,0,0,0,0,0,0
7,49,5,0,0,0,0,0,0,2,12,0,0,0,0,0,0,0,0
7,56,2,0,0,0,0,0,0,1,3,0,0,0,0,0,0,0,0
7,74,6,0,0,0,0,0,0,2,12,0,0,0,0,0,0,0,0
7,104,3,17,0,107,30,0,6,3,18,104,0,879,315,0,36,107,879
7,106,1,0,0,0,0,0,0,1,5,0,0,0,0,0,0,0,0
7,107,4,5,0,65,20,4,0,3,18,35,0,613,210,44,0,65,613
7,113,2,0,0,0,0,0,0,1,8,0,0,0,0,0,0,0,0
8,104,173,190,174,3587,350,31,190,50,434,1316,1185,27867,3427,226,1499,3761,29052
8,107,9,6,0,145,30,12,0,6,28,84,0,1358,333,104,0,145,1358
8,110,10,0,5,131,38,0,0,3,22,0,10,1175,422,0,0,136,1185
9,104,370,222,265,7521,1278,92,176,105,1003,1583,1920,58623,12505,546,1323,7786,60543
9,107,5,0,0,0,0,0,0,2,14,0,0,0,0,0,0,0,0
10,49,3,0,0,0,0,0,0,1,8,0,0,0,0,0,0,0,0
10,55,3,0,0,0,0,0,0,1,10,0,0,0,0,0,0,0,0
10,75,1,0,0,0,0,0,0,1,4,0,0,0,0,0,0,0,0
10,96,4,0,0,0,0,0,0,1,8,0,0,0,0,0,0,0,0
10,103,33,20,2,609,55,0,1,9,106,205,14,5371,560,0,14,611,5385
10,104,104,128,43,2279,583,11,45,25,297,921,296,18282,4900,128,354,2322,18578
10,107,1,0,0,0,0,0,0,1,6,0,0,0,0,0,0,0,0
10,108,3,2,0,75,32,0,0,3,16,20,0,668,388,0,0,75,668
11,48,5,0,0,0,0,0,0,2,20,0,0,0,0,0,0,0,0
11,49,4,0,0,0,0,0,0,1,14,0,0,0,0,0,0,0,0
11,76,3,0,0,0,0,0,0,1,10,0,0,0,0,0,0,0,0
11,96,3,1,2,80,15,9,0,3,13,9,20,794,133,116,0,82,814
11,97,40,20,46,897,69,18,97,13,114,178,413,8035,666,135,947,943,8448
11,103,10,0,0,185,13,2,17,4,30,0,0,1651,144,12,156,185,1651
11,104,179,101,44,3325,431,23,63,63,509,752,309,26620,3909,243,496,3369,26929
11,107,4,0,0,0,0,0,0,1,8,0,0,0,0,0,0,0,0
11,112,2,0,0,0,0,0,0,2,12,0,0,0,0,0,0,0,0
11,113,1,0,0,0,0,0,0,1,6,0,0,0,0,0,0,0,0
11,114,4,0,0,0,0,0,0,1,8,0,0,0,0,0,0,0,0
12,48,2,0,0,0,0,0,0,2,9,0,0,0,0,0,0,0,0
12,49,11,5,7,213,9,7,68,5,41,12,71,2461,75,80,805,220,2532
12,55,5,3,12,80,14,6,8,3,16,24,116,874,208,38,96,92,990
12,93,4,0,0,0,0,0,0,3,16,0,0,0,0,0,0,0,0
12,95,3,0,0,0,0,0,0,3,10,0,0,0,0,0,0,0,0
12,96,147,63,243,2331,295,81,202,68,426,473,1770,20788,3003,653,1904,2574,22558
12,104,16,41,9,519,118,0,11,7,49,355,63,4228,1190,0,88,528,4291
12,108,4,0,0,0,0,0,0,1,8,0,0,0,0,0,0,0,0
13,48,2,0,0,0,0,0,0,1,10,0,0,0,0,0,0,0,0
13,49,15,5,9,366,28,11,82,6,57,16,72,2975,240,88,914,375,3047
13,55,828,1104,997,15616,2625,635,2154,315,2470,10663,7711,146804,29892,5651,22609,16613,154515
13,75,2,0,0,0,0,0,0,2,14,0,0,0,0,0,0,0,0
13,91,1,0,0,0,0,0,0,1,4,0,0,0,0,0,0,0,0
13,92,15,0,0,0,0,0,0,6,37,0,0,0,0,0,0,0,0
13,93,1,0,0,0,0,0,0,1,4,0,0,0,0,0,0,0,0
13,103,70,88,20,1560,155,25,49,26,207,633,172,11906,1487,178,389,1580,12078
13,104,256,205,82,4687,622,48,76,87,748,1701,514,37930,6001,369,632,4769,38444
13,106,5,0,0,0,0,0,0,2,14,0,0,0,0,0,0,0,0
13,108,1,0,0,0,0,0,0,1,4,0,0,0,0,0,0,0,0
13,112,2,0,0,0,0,0,0,2,8,0,0,0,0,0,0,0,0
13,113,5,0,0,0,0,0,0,2,12,0,0,0,0,0,0,0,0
13,114,1,0,0,0,0,0,0,1,4,0,0,0,0,0,0,0,0
14,48,2,0,0,0,0,0,0,1,8,0,0,0,0,0,0,0,0
14,49,12,20,31,199,3,3,67,3,25,129,295,1956,31,6,781,230,2251
14,55,6,0,0,0,0,0,0,2,18,0,0,0,0,0,0,0,0
14,90,171,225,75,3320,517,112,75,65,484,2307,716,28655,5120,785,639,3395,29371
14,91,27,25,5,503,56,14,33,14,82,278,35,3946,535,81,276,508,3981
14,103,20,35,17,700,41,7,24,9,66,263,60,5946,399,57,180,717,6006
14,106,6,1,0,141,67,0,0,3,16,3,0,1013,483,0,0,141,1013
14,107,3,0,0,0,0,0,0,2,13,0,0,0,0,0,0,0,0
14,112,1,0,0,0,0,0,0,1,5,0,0,0,0,0,0,0,0
15,91,190,191,210,4092,329,215,252,76,521,1666,1435,31189,2681,1523,2048,4302,32624
15,107,11,20,23,245,36,16,0,6,48,140,67,1663,358,132,0,268,1730
15,108,3,2,16,54,13,1,0,3,11,14,56,323,42,5,0,70,379
15,111,2,0,0,0,0,0,0,1,8,0,0,0,0,0,0,0,0
16,31,98,0,0,0,0,0,0,11,204,0,0,0,0,0,0,0,0
16,33,61,45,173,760,83,63,191,16,151,425,1163,6436,761,615,1960,933,7599
16,34,23,0,0,0,0,0,0,8,59,0,0,0,0,0,0,0,0
16,49,1,0,0,0,0,0,0,1,6,0,0,0,0,0,0,0,0
16,102,111,88,47,2332,119,40,85,24,262,612,251,17693,945,252,576,2379,17944
16,103,10,0,0,0,0,0,0,4,27,0,0,0,0,0,0,0,0
16,106,1,0,0,0,0,0,0,1,6,0,0,0,0,0,0,0,0
16,110,2,0,0,0,0,0,0,2,8,0,0,0,0,0,0,0,0
16,118,12,0,0,0,0,0,0,4,27,0,0,0,0,0,0,0,0
17,34,4,0,0,0,0,0,0,1,8,0,0,0,0,0,0,0,0
17,49,39,33,79,608,56,93,102,19,115,284,662,5476,647,850,1182,687,6138
17,76,85,72,71,1337,127,68,427,26,226,704,583,11839,1125,636,4194,1408,12422
17,77,6,0,0,0,0,0,0,1,13,0,0,0,0,0,0,0,0
17,102,442,229,192,9752,911,78,289,116,1104,1794,1183,77794,8739,392,2143,9944,78977
17,105,8,5,8,172,22,15,6,4,22,5,30,865,156,90,36,180,895
17,108,5,0,0,0,0,0,0,1,10,0,0,0,0,0,0,0,0
17,119,1,0,0,0,0,0,0,1,6,0,0,0,0,0,0,0,0
18,49,192,381,641,6363,1321,301,522,61,501,2907,3325,38602,10646,1983,4449,7004,41927
18,101,90,105,29,1863,127,24,82,24,221,991,252,15919,1184,132,704,1892,16171
18,102,92,71,39,1938,332,27,58,32,251,549,300,15430,3082,196,400,1977,15730
18,109,2,0,0,0,0,0,0,2,8,0,0,0,0,0,0,0,0
18,110,1,0,0,0,0,0,0,1,4,0,0,0,0,0,0,0,0
18,113,1,0,0,0,0,0,0,1,6,0,0,0,0,0,0,0,0
18,114,1,0,0,0,0,0,0,1,6,0,0,0,0,0,0,0,0
19,100,295,387,319,6223,847,41,214,69,724,2948,2400,46608,7275,287,1763,6542,49008
19,101,1802,2764,3179,57793,14309,672,1549,256,4043,16576,15798,378793,87440,3589,10300,60972,394591
19,113,4,0,0,0,0,0,0,1,8,0,0,0,0,0,0,0,0
19,116,5,0,0,0,0,0,0,4,24,0,0,0,0,0,0,0,0
19,125,7,0,0,0,0,0,0,2,14,0,0,0,0,0,0,0,0
20,34,75,28,282,895,42,125,125,24,172,223,1527,6971,299,1148,1183,1177,8498
20,52,2,0,0,0,0,0,0,2,8,0,0,0,0,0,0,0,0
20,73,1,0,0,0,0,0,0,1,4,0,0,0,0,0,0,0,0
20,99,91,281,2090,5458,895,100,239,8,178,1334,4284,27968,5734,382,911,7548,32252
20,100,3045,1580,5127,85509,4529,876,4332,476,7827,9522,26921,580909,32585,4066,32146,90636,607830
20,101,2,0,0,0,0,0,0,1,4,0,0,0,0,0,0,0,0
20,107,6,10,1,214,91,0,0,4,24,83,7,2067,690,0,0,215,2074
20,115,1,0,0,0,0,0,0,1,6,0,0,0,0,0,0,0,0
20,120,1,0,0,0,0,0,0,1,4,0,0,0,0,0,0,0,0
20,122,3,0,0,0,0,0,0,1,7,0,0,0,0,0,0,0,0
21,31,60,44,212,723,55,125,224,14,182,412,1704,6266,503,954,2315,935,7970
21,74,6,0,0,0,0,0,0,2,18,0,0,0,0,0,0,0,0
21,99,820,765,1330,26169,3077,260,868,165,1906,4584,6181,182349,25677,1615,6316,27499,188530
21,100,286,138,380,7735,639,61,210,72,681,749,2445,52907,4934,332,1324,8115,55352
22,34,50,37,281,712,72,53,137,21,114,271,1552,4222,423,263,1024,993,5774
22,56,1,0,0,0,0,0,0,1,4,0,0,0,0,0,0,0,0
22,73,4,7,1,79,6,0,1,3,14,106,7,677,42,0,14,80,684
22,75,2,0,0,0,0,0,0,1,5,0,0,0,0,0,0,0,0
22,97,218,109,107,5163,206,13,192,43,524,898,776,39098,1782,145,1548,5270,39874
22,98,22,0,0,0,0,0,0,4,54,0,0,0,0,0,0,0,0
22,114,1,0,0,0,0,0,0,1,6,0,0,0,0,0,0,0,0
23,50,2,0,0,0,0,0,0,1,10,0,0,0,0,0,0,0,0
23,53,169,120,159,3053,428,156,233,69,540,998,1377,25285,4438,1198,2171,3212,26662
23,56,4,0,0,0,0,0,0,1,7,0,0,0,0,0,0,0,0
23,73,231,126,134,4242,296,125,478,84,645,1094,1110,35213,2782,631,4704,4376,36323
23,77,1,0,0,0,0,0,0,1,7,0,0,0,0,0,0,0,0
23,96,19,17,4,465,44,2,4,4,53,73,8,2714,305,15,18,469,2722
23,97,613,240,955,14485,930,112,462,168,1502,1488,7111,106874,8151,699,3585,15440,113985
23,98,111,29,75,2524,208,26,59,39,273,180,364,18594,1943,161,453,2599,18958
23,99,3,0,0,0,0,0,0,3,18,0,0,0,0,0,0,0,0
23,100,41,28,3,1420,285,8,6,19,93,238,7,10409,2944,30,24,1423,10416
23,108,6,0,0,0,0,0,0,2,12,0,0,0,0,0,0,0,0
24,51,1,0,0,0,0,0,0,1,4,0,0,0,0,0,0,0,0
24,96,252,124,190,5275,475,59,222,76,660,948,1284,40389,4482,408,1988,5465,41673
24,97,43,22,48,958,99,19,44,21,96,101,247,6171,704,84,326,1006,6418
24,100,5,0,0,0,0,0,0,2,10,0,0,0,0,0,0,0,0
24,105,2,0,0,0,0,0,0,1,8,0,0,0,0,0,0,0,0
25,75,1,0,0,0,0,0,0,1,5,0,0,0,0,0,0,0,0
26,73,4,7,0,104,12,2,5,4,15,70,0,1519,124,33,46,104,1519
26,75,2,0,0,0,0,0,0,2,9,0,0,0,0,0,0,0,0
26,76,2,0,0,0,0,0,0,1,9,0,0,0,0,0,0,0,0
26,77,2,0,0,0,0,0,0,1,10,0,0,0,0,0,0,0,0
26,93,212,288,741,8424,705,182,205,47,534,1275,2907,49751,4348,1117,1102,9165,52658
26,94,4807,6338,9730,159436,15790,3886,4522,1028,11522,30544,43492,992673,107779,19943,24944,169166,1036165
26,95,488,281,430,10130,1046,296,162,133,1201,1867,2512,74037,9293,1632,1142,10560,76549
26,96,175,236,70,4567,1172,127,47,83,494,1748,335,36549,11508,750,271,4637,36884
26,104,17,0,0,0,0,0,0,9,56,0,0,0,0,0,0,0,0
27,73,3,0,0,0,0,0,0,2,13,0,0,0,0,0,0,0,0
27,75,6,0,0,0,0,0,0,1,16,0,0,0,0,0,0,0,0
27,76,31,4,14,597,15,12,200,10,91,40,88,6105,201,104,2362,611,6193
27,93,1032,1203,3511,31144,2939,1614,761,450,2707,5690,11593,173564,18745,8837,3928,34655,185157
27,94,485,397,654,13874,1256,514,291,200,1312,2538,3472,87440,10396,3094,1766,14528,90912
27,95,6,0,0,0,0,0,0,6,24,0,0,0,0,0,0,0,0
27,96,23,50,0,640,162,1,8,13,77,341,0,5065,1533,7,80,640,5065
28,76,6,8,0,95,2,2,23,4,23,100,0,1226,16,8,276,95,1226
28,92,27,60,1,635,144,7,0,8,69,467,3,4531,1321,37,0,636,4534
28,93,13,0,6,371,55,17,12,10,39,0,12,2420,509,67,65,377,2432
28,105,22,0,0,0,0,0,0,9,77,0,0,0,0,0,0,0,0
29,58,6,0,0,0,0,0,0,2,18,0,0,0,0,0,0,0,0
29,73,10,2,2,179,0,0,16,3,26,10,14,1902,0,0,207,181,1916
29,74,1,0,0,0,0,0,0,1,2,0,0,0,0,0,0,0,0
29,76,11,2,4,179,0,0,14,3,31,14,48,1581,0,0,122,183,1629
29,91,638,1340,1152,22940,4924,234,448,36,1343,8449,5155,155960,37861,1205,2862,24092,161115
29,105,1,0,0,0,0,0,0,1,4,0,0,0,0,0,0,0,0
30,58,31,10,61,302,41,25,40,15,85,104,510,2538,467,210,397,363,3048
30,63,10,0,0,0,0,0,0,2,20,0,0,0,0,0,0,0,0
30,64,8,0,0,0,0,0,0,2,17,0,0,0,0,0,0,0,0
30,76,5,0,0,0,0,0,0,1,16,0,0,0,0,0,0,0,0
30,89,152,221,154,4608,498,19,142,35,384,1564,913,30594,4088,81,910,4762,31507
30,90,1011,935,840,26898,3180,102,655,252,2497,5880,4701,182463,24839,518,4787,27738,187164
30,91,1270,2792,2882,49738,10281,389,1090,189,2847,15807,12782,319239,74040,1957,6803,52620,332021
30,92,2,0,0,0,0,0,0,2,6,0,0,0,0,0,0,0,0
30,112,7,0,0,0,0,0,0,2,19,0,0,0,0,0,0,0,0
31,55,2,0,0,0,0,0,0,1,4,0,0,0,0,0,0,0,0
31,58,2,0,0,0,0,0,0,1,4,0,0,0,0,0,0,0,0
31,64,244,412,182,5596,1353,212,1384,43,591,3988,1390,49313,12103,1130,15038,5778,50703
31,88,22,4,10,412,41,1,8,7,64,28,96,3293,431,1,76,422,3389
31,89,153,75,71,3376,143,14,96,34,361,534,493,24897,1241,80,768,3447,25390
31,90,102,84,77,1920,165,8,116,27,242,541,430,12690,1363,50,757,1997,13120
31,91,13,0,0,0,0,0,0,8,41,0,0,0,0,0,0,0,0
31,118,1,0,0,0,0,0,0,1,6,0,0,0,0,0,0,0,0
32,58,145,78,205,2408,279,123,699,69,448,747,1619,21087,2912,1046,7517,2613,22706
32,87,195,56,167,4793,199,40,102,62,528,442,1225,38237,1808,224,790,4960,39462
32,88,1618,1374,3365,53725,5694,572,791,318,4149,8124,15631,359278,39154,2804,5160,57090,374909
33,57,4,0,0,0,0,0,0,2,16,0,0,0,0,0,0,0,0
33,58,2,0,0,0,0,0,0,1,8,0,0,0,0,0,0,0,0
33,87,169,44,56,4464,207,27,74,57,445,269,447,36280,1856,237,654,4520,36727
33,88,17,30,4,311,57,5,0,6,53,224,56,2702,818,39,0,315,2758
33,108,17,13,7,348,126,4,0,12,73,147,49,3332,1423,20,0,355,3381
34,59,1,0,0,0,0,0,0,1,2,0,0,0,0,0,0,0,0
34,101,1,0,0,0,0,0,0,1,6,0,0,0,0,0,0,0,0
34,109,7,6,0,164,84,8,0,5,34,60,0,1763,1056,80,0,164,1763
34,114,6,0,0,0,0,0,0,3,20,0,0,0,0,0,0,0,0
35,59,60,14,55,802,54,44,106,11,137,138,372,5949,498,173,1011,857,6321
35,60,6,0,0,0,0,0,0,2,12,0,0,0,0,0,0,0,0
35,85,411,101,298,7513,452,114,266,107,1042,818,1971,58877,3327,670,1998,7811,60848
35,86,16,13,12,377,38,6,18,3,38,71,53,2328,323,26,90,389,2381
35,113,1,0,0,0,0,0,0,1,6,0,0,0,0,0,0,0,0
36,57,6,0,0,0,0,0,0,2,19,0,0,0,0,0,0,0,0
36,59,477,268,420,6049,707,86,1960,58,1290,2762,3985,60921,7256,704,22360,6469,64906
36,60,42,58,39,869,115,15,112,9,111,478,138,6718,1093,66,1086,908,6856
36,97,4,0,0,0,0,0,0,2,12,0,0,0,0,0,0,0,0
36,101,2,0,0,0,0,0,0,2,7,0,0,0,0,0,0,0,0
36,109,21,0,0,0,0,0,0,13,79,0,0,0,0,0,0,0,0
36,110,1,0,0,0,0,0,0,1,6,0,0,0,0,0,0,0,0
36,111,1,0,0,0,0,0,0,1,6,0,0,0,0,0,0,0,0
36,112,15,16,0,294,118,0,0,8,54,214,0,3003,1520,0,0,294,3003
37,54,3,0,0,0,0,0,0,1,6,0,0,0,0,0,0,0,0
37,55,1,0,0,0,0,0,0,1,4,0,0,0,0,0,0,0,0
37,56,1,0,0,0,0,0,0,1,4,0,0,0,0,0,0,0,0
37,57,8,10,29,227,14,21,2,4,26,84,170,1225,74,137,10,256,1395
37,59,42,25,32,661,73,9,84,13,95,179,252,5971,795,46,703,693,6223
37,60,4,0,0,0,0,0,0,1,9,0,0,0,0,0,0,0,0
37,83,169,71,69,5634,960,9,53,14,366,556,433,42497,8885,46,246,5703,42930
37,112,1,0,0,0,0,0,0,1,6,0,0,0,0,0,0,0,0
38,54,1,0,0,0,0,0,0,1,2,0,0,0,0,0,0,0,0
38,55,2,0,0,0,0,0,0,1,4,0,0,0,0,0,0,0,0
38,56,5,1,7,67,15,5,2,3,14,2,39,523,175,32,22,74,562
38,57,395,313,725,8455,807,498,875,151,1197,2798,4390,51748,6729,2669,8400,9180,56138
38,59,219,49,279,3581,247,55,169,59,466,365,1583,28084,2150,342,1720,3860,29667
38,83,411,37,194,7967,264,43,95,127,1078,292,1390,64706,2511,384,814,8161,66096
38,95,2,0,0,0,0,0,0,2,4,0,0,0,0,0,0,0,0
38,108,5,0,0,0,0,0,0,2,14,0,0,0,0,0,0,0,0
38,115,4,0,0,0,0,0,0,1,8,0,0,0,0,0,0,0,0
39,56,12,0,0,0,0,0,0,2,26,0,0,0,0,0,0,0,0
39,57,1196,1009,6914,51739,2667,1451,1882,258,2833,4969,33480,192159,14281,6272,11404,58653,225639
39,59,52,0,0,0,0,0,0,2,154,0,0,0,0,0,0,0,0
39,82,1695,2716,949,45944,2193,327,1243,188,4219,10915,6012,321184,15211,1315,9488,46893,327196
39,105,6,0,0,0,0,0,0,1,12,0,0,0,0,0,0,0,0
39,109,5,0,0,0,0,0,0,2,14,0,0,0,0,0,0,0,0
39,111,2,0,0,0,0,0,0,1,4,0,0,0,0,0,0,0,0
40,55,4,0,0,0,0,0,0,2,12,0,0,0,0,0,0,0,0
40,56,136,98,560,4169,224,136,210,20,381,749,3164,26723,2015,823,1503,4729,29887
40,57,16,20,15,784,45,20,3,8,34,107,62,2716,195,69,13,799,2778
40,59,9,0,0,0,0,0,0,2,24,0,0,0,0,0,0,0,0
40,95,3,0,0,0,0,0,0,3,12,0,0,0,0,0,0,0,0
41,54,3,0,0,0,0,0,0,2,8,0,0,0,0,0,0,0,0
41,55,3,0,0,0,0,0,0,2,8,0,0,0,0,0,0,0,0
41,56,2,0,0,0,0,0,0,1,4,0,0,0,0,0,0,0,0
41,60,41,0,0,0,0,0,0,10,86,0,0,0,0,0,0,0,0
41,64,4,0,0,0,0,0,0,1,8,0,0,0,0,0,0,0,0
41,75,1,0,0,0,0,0,0,1,4,0,0,0,0,0,0,0,0
41,105,6,0,0,0,0,0,0,2,12,0,0,0,0,0,0,0,0
41,106,4,0,0,0,0,0,0,1,8,0,0,0,0,0,0,0,0
41,108,18,4,0,171,91,0,0,6,40,28,0,2144,1350,0,0,171,2144
41,111,37,4,801,243,62,20,15,8,99,7,1294,1761,681,38,24,1044,3055
41,112,55,0,0,0,0,0,0,15,135,0,0,0,0,0,0,0,0
41,114,3,0,0,0,0,0,0,1,6,0,0,0,0,0,0,0,0
42,53,43,22,100,741,63,68,136,19,100,169,884,5740,572,392,1255,841,6624
42,54,629,389,1673,12651,1355,728,1278,184,1596,3539,9935,86678,11631,4937,13449,14324,96613
42,55,1,0,0,0,0,0,0,1,4,0,0,0,0,0,0,0,0
42,59,44,0,0,0,0,0,0,14,96,0,0,0,0,0,0,0,0
42,64,34,0,0,0,0,0,0,10,99,0,0,0,0,0,0,0,0
42,76,261,331,397,5800,985,370,508,69,697,2802,2752,43655,7542,2270,5213,6197,46407
42,99,1,0,0,0,0,0,0,1,4,0,0,0,0,0,0,0,0
42,108,6,0,0,0,0,0,0,2,16,0,0,0,0,0,0,0,0
42,111,15,0,0,0,0,0,0,5,36,0,0,0,0,0,0,0,0
42,115,4,0,0,0,0,0,0,2,12,0,0,0,0,0,0,0,0
43,53,77,64,177,1580,185,91,181,33,195,555,1125,10978,1447,552,1826,1757,12103
43,59,2692,2598,5217,66111,9824,1885,4569,366,6462,17530,28651,472121,76118,10040,34829,71328,500772
43,60,52,9,58,965,70,20,35,16,109,39,438,7757,705,100,274,1023,8195
43,76,4,0,0,0,0,0,0,1,8,0,0,0,0,0,0,0,0
43,111,3,0,0,0,0,0,0,1,6,0,0,0,0,0,0,0,0
43,113,3,0,0,0,0,0,0,1,6,0,0,0,0,0,0,0,0
43,114,3,0,0,0,0,0,0,1,6,0,0,0,0,0,0,0,0
44,53,10,29,56,300,18,13,37,6,31,262,455,2388,136,87,452,356,2843
44,59,59,12,34,931,36,37,28,14,123,52,184,7406,295,330,225,965,7590
44,60,104,13,145,1875,135,30,45,22,223,160,1347,15937,1439,130,332,2020,17284
44,61,1,0,0,0,0,0,0,1,6,0,0,0,0,0,0,0,0
44,85,1,0,0,0,0,0,0,1,6,0,0,0,0,0,0,0,0
44,87,1,0,0,0,0,0,0,1,4,0,0,0,0,0,0,0,0
44,105,1,0,0,0,0,0,0,1,5,0,0,0,0,0,0,0,0
44,110,2,0,0,0,0,0,0,1,10,0,0,0,0,0,0,0,0
44,114,1,0,0,0,0,0,0,1,6,0,0,0,0,0,0,0,0
45,109,3,0,0,0,0,0,0,1,6,0,0,0,0,0,0,0,0
45,110,17,25,36,394,134,14,7,8,47,157,99,2960,1541,30,11,430,3059
45,112,3,0,0,0,0,0,0,1,6,0,0,0,0,0,0,0,0
46,60,2,0,0,0,0,0,0,1,8,0,0,0,0,0,0,0,0
46,63,21,0,0,0,0,0,0,5,64,0,0,0,0,0,0,0,0
46,79,26,0,0,0,0,0,0,8,56,0,0,0,0,0,0,0,0
46,80,187,28,64,4418,88,18,27,42,443,133,445,30428,697,148,201,4482,30873
46,114,1,0,0,0,0,0,0,1,6,0,0,0,0,0,0,0,0
47,60,257,205,342,5393,1185,159,484,45,638,1448,2065,40889,9038,745,4717,5735,42954
47,63,4,0,0,0,0,0,0,1,8,0,0,0,0,0,0,0,0
47,79,73,12,21,1776,124,22,32,18,179,55,125,12042,1075,132,215,1797,12167
47,80,261,37,198,6271,145,12,77,52,613,198,1062,43346,1222,65,496,6469,44408
47,84,3,0,0,0,0,0,0,1,6,0,0,0,0,0,0,0,0
47,90,4,0,0,0,0,0,0,1,8,0,0,0,0,0,0,0,0
48,59,5,1,15,29,0,0,0,3,12,6,94,211,0,0,0,44,305
48,79,785,366,464,28632,2757,225,769,83,1800,2080,2389,181440,14364,551,4099,29096,183829
48,87,8,0,0,0,0,0,0,2,16,0,0,0,0,0,0,0,0
49,58,3,0,0,0,0,0,0,1,8,0,0,0,0,0,0,0,0
49,63,142,134,713,5701,252,30,431,8,309,823,3119,39109,2351,167,2126,6414,42228
49,64,18,0,5,231,27,0,6,6,35,0,48,2113,345,0,48,236,2161
49,78,531,375,4082,15315,1939,142,520,95,1429,2662,16457,103330,15505,754,3847,19397,119787
49,79,4,0,0,0,0,0,0,1,10,0,0,0,0,0,0,0,0
50,58,5,0,0,0,0,0,0,1,10,0,0,0,0,0,0,0,0
50,63,207,50,193,3745,169,55,79,62,468,319,1375,27101,1469,331,600,3938,28476
50,64,78,10,73,1667,54,22,14,24,199,133,258,11685,322,62,100,1740,11943
50,77,79,29,37,1612,148,3,35,23,189,242,241,13078,1509,22,305,1649,13319
50,78,54,0,0,0,0,0,0,15,126,0,0,0,0,0,0,0,0
50,83,1,0,0,0,0,0,0,1,4,0,0,0,0,0,0,0,0
51,63,75,132,49,2165,391,58,114,24,184,1224,320,17940,3321,418,848,2214,18260
51,76,130,9,36,2273,87,6,24,28,302,55,244,16412,699,26,204,2309,16656
51,77,456,134,326,10583,847,273,378,88,1224,623,2226,67422,4338,1008,2524,10909,69648
52,57,75,43,62,1211,172,7,88,21,168,392,502,11515,1917,35,862,1273,12017
52,76,130,76,75,2999,179,29,112,36,334,590,509,22608,1503,153,875,3074,23117
52,85,4,0,0,0,0,0,0,3,10,0,0,0,0,0,0,0,0
53,61,11,0,0,0,0,0,0,3,24,0,0,0,0,0,0,0,0
53,76,279,40,101,6236,134,20,77,87,696,219,946,48587,1153,119,650,6337,49533
54,58,1,0,0,0,0,0,0,1,6,0,0,0,0,0,0,0,0
54,61,1,0,0,0,0,0,0,1,6,0,0,0,0,0,0,0,0
54,76,32,4,3,871,29,0,8,10,77,34,9,7236,341,0,61,874,7245
54,85,1,0,0,0,0,0,0,1,2,0,0,0,0,0,0,0,0
55,62,34,0,5,375,26,5,12,13,76,0,41,4084,249,25,124,380,4125
55,74,108,35,57,3099,140,11,10,18,236,145,350,20151,1017,35,45,3156,20501
55,75,1651,838,2979,48736,2818,399,2592,243,3760,4232,11536,302860,16752,1648,10655,51715,314396
56,60,12,4,20,111,9,0,7,5,24,42,347,1063,86,0,84,131,1410
56,86,26,7,274,701,61,41,9,4,56,7,468,1431,216,53,15,975,1899
57,54,5,0,0,0,0,0,0,1,10,0,0,0,0,0,0,0,0
57,55,136,0,0,0,0,0,0,39,319,0,0,0,0,0,0,0,0
58,40,217,0,0,0,0,0,0,16,457,0,0,0,0,0,0,0,0
58,82,3,0,0,0,0,0,0,1,15,0,0,0,0,0,0,0,0
59,39,4,0,0,0,0,0,0,1,11,0,0,0,0,0,0,0,0
59,73,6,0,0,0,0,0,0,2,11,0,0,0,0,0,0,0,0
60,39,33,19,91,1014,71,48,53,16,77,174,568,4726,418,240,508,1105,5294
60,60,1,0,0,0,0,0,0,1,4,0,0,0,0,0,0,0,0
60,83,10,0,0,0,0,0,0,2,20,0,0,0,0,0,0,0,0
61,38,26,0,0,0,0,0,0,6,54,0,0,0,0,0,0,0,0
61,40,88,30,241,2879,120,181,103,26,200,111,1075,8866,548,584,755,3120,9941
61,54,103,0,0,0,0,0,0,38,222,0,0,0,0,0,0,0,0
61,55,4,0,0,0,0,0,0,2,8,0,0,0,0,0,0,0,0
61,72,17,32,13,473,184,16,8,4,49,103,38,1816,832,30,36,486,1854
61,79,2,0,0,0,0,0,0,1,4,0,0,0,0,0,0,0,0
61,83,3,0,0,0,0,0,0,1,6,0,0,0,0,0,0,0,0
62,71,48,21,157,776,166,73,42,21,126,135,497,3383,1302,196,156,933,3880
62,72,20,7,22,449,47,18,11,11,51,31,80,2201,295,48,50,471,2281
62,73,10,0,0,0,0,0,0,3,27,0,0,0,0,0,0,0,0
63,40,2,0,0,0,0,0,0,1,5,0,0,0,0,0,0,0,0
63,56,2,0,0,0,0,0,0,1,4,0,0,0,0,0,0,0,0
63,70,57,17,222,730,64,27,99,15,145,28,593,3255,305,113,317,952,3848
64,54,1,0,0,0,0,0,0,1,6,0,0,0,0,0,0,0,0
64,55,3,0,0,0,0,0,0,2,8,0,0,0,0,0,0,0,0
64,58,20,0,20,305,25,0,0,7,48,0,311,2192,392,0,0,325,2503
64,59,5,0,0,0,0,0,0,2,16,0,0,0,0,0,0,0,0
64,70,6,0,13,16,2,1,1,3,16,0,47,43,5,1,1,29,90
64,71,4,0,0,0,0,0,0,1,8,0,0,0,0,0,0,0,0
65,56,112,91,157,2071,104,29,95,35,304,657,906,16499,777,257,989,2228,17405
65,57,1,0,0,0,0,0,0,1,4,0,0,0,0,0,0,0,0
65,58,138,35,116,2950,115,34,73,34,354,287,1006,23018,1196,194,652,3066,24024
65,59,3,0,0,0,0,0,0,2,9,0,0,0,0,0,0,0,0
65,67,6,0,0,0,0,0,0,2,13,0,0,0,0,0,0,0,0
66,52,312,134,352,5806,441,92,267,81,808,1051,2608,43394,3664,574,2181,6158,46002
66,55,18,1,3,411,4,16,9,4,44,3,20,2915,12,86,49,414,2935
66,56,12,0,24,231,5,7,12,4,30,0,179,1820,50,78,78,255,1999
66,67,1,0,0,0,0,0,0,1,6,0,0,0,0,0,0,0,0
66,69,13,14,10,174,63,2,6,5,31,80,17,1405,554,8,52,184,1422
66,70,7,0,0,0,0,0,0,2,16,0,0,0,0,0,0,0,0
67,52,1,0,0,0,0,0,0,1,2,0,0,0,0,0,0,0,0
67,55,14,0,0,0,0,0,0,3,43,0,0,0,0,0,0,0,0
67,64,102,57,74,2537,322,11,285,46,276,524,477,21499,3485,59,1975,2611,21976
67,65,43,0,0,0,0,0,0,16,115,0,0,0,0,0,0,0,0
67,70,4,0,0,0,0,0,0,3,11,0,0,0,0,0,0,0,0
68,37,18,0,0,0,0,0,0,6,53,0,0,0,0,0,0,0,0
68,39,59,52,266,1505,128,90,115,9,166,314,1722,6524,604,352,1038,1771,8246
68,62,22,0,0,0,0,0,0,6,58,0,0,0,0,0,0,0,0
69,52,2,0,0,0,0,0,0,1,8,0,0,0,0,0,0,0,0
69,61,25,72,3,556,136,6,0,12,67,629,28,4921,1404,37,0,559,4949
70,38,3,0,0,0,0,0,0,1,6,0,0,0,0,0,0,0,0
70,55,13,12,68,254,34,9,2,7,36,103,318,2197,289,73,14,322,2515
71,54,155,20,144,3060,138,71,64,48,469,131,820,25627,1324,334,477,3204,26447
71,69,15,2,11,112,13,1,8,7,37,14,74,941,180,4,50,123,1015
72,36,1,0,0,0,0,0,0,1,4,0,0,0,0,0,0,0,0
72,54,78,0,0,0,0,0,0,9,228,0,0,0,0,0,0,0,0
72,58,49,41,20,1183,109,28,43,17,147,291,182,8937,997,153,335,1203,9119
72,59,105,22,45,2305,211,82,68,27,251,156,327,17985,2082,456,747,2350,18312
72,60,5,0,0,0,0,0,0,1,9,0,0,0,0,0,0,0,0
73,54,8,0,0,0,0,0,0,2,21,0,0,0,0,0,0,0,0
73,58,4,0,0,0,0,0,0,1,10,0,0,0,0,0,0,0,0
73,59,59,0,0,0,0,0,0,18,155,0,0,0,0,0,0,0,0
74,36,58,0,0,0,0,0,0,5,169,0,0,0,0,0,0,0,0
74,50,2,0,0,0,0,0,0,1,10,0,0,0,0,0,0,0,0
74,58,62,33,42,1527,134,8,23,22,165,236,287,11528,1200,32,205,1569,11815
74,59,254,114,196,6103,340,114,147,45,716,589,1245,42502,2908,861,928,6299,43747
74,66,104,0,0,0,0,0,0,2,302,0,0,0,0,0,0,0,0
74,67,6,0,0,0,0,0,0,1,18,0,0,0,0,0,0,0,0
75,36,5,0,0,0,0,0,0,2,10,0,0,0,0,0,0,0,0
75,58,15,0,0,0,0,0,0,5,35,0,0,0,0,0,0,0,0
75,59,61,25,30,1795,86,16,27,20,156,155,246,12283,678,80,192,1825,12529
75,67,2,0,0,0,0,0,0,1,7,0,0,0,0,0,0,0,0
76,35,5,0,3,53,13,0,0,3,13,0,19,441,146,0,0,56,460
76,67,6,0,0,0,0,0,0,1,11,0,0,0,0,0,0,0,0
77,35,2,0,0,0,0,0,0,2,9,0,0,0,0,0,0,0,0
78,74,10,0,0,0,0,0,0,1,20,0,0,0,0,0,0,0,0
79,36,56,56,255,1682,134,142,45,23,144,354,1340,7354,771,543,325,1937,8694
79,37,24,14,160,991,65,92,28,9,55,92,576,3137,377,262,221,1151,3713
80,36,4,0,0,0,0,0,0,3,10,0,0,0,0,0,0,0,0
81,48,2,0,0,0,0,0,0,1,4,0,0,0,0,0,0,0,0
81,49,1,0,0,0,0,0,0,1,2,0,0,0,0,0,0,0,0
81,72,98,0,0,0,0,0,0,8,238,0,0,0,0,0,0,0,0
82,52,5,7,11,146,8,8,0,4,15,14,57,709,32,46,0,157,766
83,36,2,0,0,0,0,0,0,2,13,0,0,0,0,0,0,0,0
84,36,45,15,132,1480,109,82,70,22,128,139,918,6959,724,556,627,1612,7877
85,36,30,0,0,0,0,0,0,17,71,0,0,0,0,0,0,0,0
85,46,270,0,0,0,0,0,0,5,810,0,0,0,0,0,0,0,0
85,50,4,0,0,0,0,0,0,3,9,0,0,0,0,0,0,0,0
85,51,8,0,0,0,0,0,0,3,14,0,0,0,0,0,0,0,0
85,56,4,0,0,0,0,0,0,1,8,0,0,0,0,0,0,0,0
86,36,2,0,0,0,0,0,0,1,8,0,0,0,0,0,0,0,0
86,46,1,0,0,0,0,0,0,1,2,0,0,0,0,0,0,0,0
86,48,40,34,241,2019,130,162,40,23,101,81,1070,4733,474,355,103,2260,5803
86,50,37,30,52,873,80,40,7,15,83,168,275,4547,401,166,44,925,4822
86,56,3,0,0,0,0,0,0,1,6,0,0,0,0,0,0,0,0
87,48,8,9,48,562,33,43,23,3,19,26,235,1465,116,87,25,610,1700
87,49,54,142,789,3403,344,313,114,18,126,265,1535,7443,1126,658,221,4192,8978
88,46,42,21,32,662,56,22,53,15,88,141,156,4915,525,281,417,694,5071
88,47,11,0,0,0,0,0,0,3,23,0,0,0,0,0,0,0,0
89,34,3,0,0,0,0,0,0,2,12,0,0,0,0,0,0,0,0
90,54,3,0,0,0,0,0,0,1,6,0,0,0,0,0,0,0,0
91,32,5,0,0,0,0,0,0,2,14,0,0,0,0,0,0,0,0
91,33,112,115,261,2520,199,238,287,33,264,1046,1532,15990,1323,1321,2610,2781,17522
91,34,8,0,0,0,0,0,0,2,16,0,0,0,0,0,0,0,0
91,46,2,0,0,0,0,0,0,1,4,0,0,0,0,0,0,0,0
93,52,1,0,0,0,0,0,0,1,4,0,0,0,0,0,0,0,0
94,46,11,0,0,0,0,0,0,7,28,0,0,0,0,0,0,0,0
97,45,4,0,0,0,0,0,0,2,10,0,0,0,0,0,0,0,0
99,46,4,0,0,0,0,0,0,1,8,0,0,0,0,0,0,0,0
100,44,35,0,0,0,0,0,0,8,85,0,0,0,0,0,0,0,0
100,45,54,0,0,0,0,0,0,11,147,0,0,0,0,0,0,0,0
100,47,3,0,0,0,0,0,0,1,6,0,0,0,0,0,0,0,0
101,37,117,33,233,3386,271,50,28,15,250,173,1126,19519,2133,183,197,3619,20645
101,38,19,0,0,0,0,0,0,4,40,0,0,0,0,0,0,0,0
101,43,3,0,0,0,0,0,0,1,8,0,0,0,0,0,0,0,0
101,44,3,0,0,0,0,0,0,1,6,0,0,0,0,0,0,0,0
102,37,3,0,0,0,0,0,0,1,6,0,0,0,0,0,0,0,0
102,43,17,21,6,452,31,18,14,6,48,185,41,3391,232,127,160,458,3432
102,44,528,539,945,23347,3573,521,414,87,1239,3572,4031,119746,28298,2239,2280,24292,123777
102,45,9,0,0,0,0,0,0,2,27,0,0,0,0,0,0,0,0
103,44,46,0,0,0,0,0,0,15,112,0,0,0,0,0,0,0,0
105,36,71,0,0,0,0,0,0,20,158,0,0,0,0,0,0,0,0
105,43,3,0,0,0,0,0,0,1,6,0,0,0,0,0,0,0,0
106,36,3,0,0,0,0,0,0,2,12,0,0,0,0,0,0,0,0
108,33,40,17,18,1017,75,12,5,12,94,129,116,6744,684,83,15,1035,6860
108,34,352,235,456,11785,800,260,37,43,747,1529,1740,69901,5640,1350,250,12241,71641
108,40,2,0,0,0,0,0,0,2,6,0,0,0,0,0,0,0,0
109,38,19,18,15,720,107,16,8,11,62,116,191,4803,810,206,16,735,4994
109,39,9,0,0,0,0,0,0,5,24,0,0,0,0,0,0,0,0
110,37,5,0,0,0,0,0,0,3,13,0,0,0,0,0,0,0,0
111,36,5,0,0,0,0,0,0,2,11,0,0,0,0,0,0,0,0
111,37,83,92,45,1870,214,138,20,25,209,336,222,7183,710,298,54,1915,7405
111,40,2,0,0,0,0,0,0,2,6,0,0,0,0,0,0,0,0
113,33,188,48,30,5101,136,18,7,20,442,418,105,39200,1167,83,50,5131,39305
113,35,6,0,1,96,9,4,7,3,14,0,5,532,82,28,31,97,537
113,36,162,235,102,8732,1976,564,228,34,442,804,636,35670,8167,1551,576,8834,36306
113,38,1,0,0,0,0,0,0,1,6,0,0,0,0,0,0,0,0
113,39,2,0,0,0,0,0,0,2,7,0,0,0,0,0,0,0,0
114,32,12,3,5,250,57,6,0,5,31,19,11,1551,464,30,0,255,1562
114,33,3,0,0,0,0,0,0,3,13,0,0,0,0,0,0,0,0
114,35,429,647,1295,42973,3398,1299,287,12,1237,2441,3766,174743,14468,3494,933,44268,178509
114,36,15,11,11,550,55,29,2,9,41,67,35,3356,468,264,12,561,3391
115,32,4,0,0,0,0,0,0,2,12,0,0,0,0,0,0,0,0
115,35,29,2,36,1018,49,83,12,10,68,2,258,5197,301,321,20,1054,5455
116,34,1,0,0,0,0,0,0,1,4,0,0,0,0,0,0,0,0
116,35,71,81,75,1773,193,132,24,31,176,529,672,10497,1667,626,112,1848,11169
116,36,339,253,632,11044,1373,589,95,106,789,1742,1646,52545,9291,2548,417,11676,54191
117,34,89,52,72,2653,508,143,13,20,207,259,156,13715,3953,453,49,2725,13871
117,35,63,84,57,2612,206,194,46,22,143,469,358,12052,1207,713,83,2669,12410
117,36,1,0,0,0,0,0,0,1,4,0,0,0,0,0,0,0,0
118,31,227,426,1838,17091,1190,527,187,8,462,1516,4028,66710,5536,1855,643,18929,70738
118,32,773,1796,8351,97044,4335,1514,684,9,1558,6772,21529,316762,20733,4529,1720,105395,338291
118,33,20,0,0,0,0,0,0,9,48,0,0,0,0,0,0,0,0
118,34,4,0,0,0,0,0,0,2,10,0,0,0,0,0,0,0,0
118,38,2,0,0,0,0,0,0,1,4,0,0,0,0,0,0,0,0
119,31,777,898,3062,62853,3262,2089,382,271,1800,3280,8224,233686,14830,7329,1145,65915,241910
119,32,1197,3353,4226,92426,5538,2341,456,208,2670,18630,14907,376727,28687,8380,1354,96652,391634
119,33,34,7,10,1006,161,30,4,12,83,33,57,4918,966,98,16,1016,4975
120,30,33,43,249,4424,190,234,48,15,91,124,633,11577,524,560,100,4673,12210
120,31,598,708,4404,53189,2545,1925,323,294,1506,2211,9437,181321,10034,6705,707,57593,190758
120,32,370,324,3627,41461,1746,1959,167,160,880,958,7058,93740,4867,4841,330,45088,100798
120,33,16,0,0,0,0,0,0,9,36,0,0,0,0,0,0,0,0
120,34,7,0,0,0,0,0,0,5,19,0,0,0,0,0,0,0,0
121,30,471,862,1725,53015,2531,769,458,83,1013,3188,4118,175666,11003,2288,1429,54740,179784
121,31,522,391,516,38960,2086,1618,113,326,1333,1280,1579,126885,7514,5239,285,39476,128464
121,32,174,421,5175,34811,2043,1176,202,43,392,981,7912,67174,4156,2110,348,39986,75086
121,33,18,0,0,0,0,0,0,13,58,0,0,0,0,0,0,0,0
121,34,83,0,0,0,0,0,0,30,205,0,0,0,0,0,0,0,0
122,30,4283,6427,16662,417272,22495,11601,2208,1253,10054,23246,46412,1250642,70132,29615,5597,433934,1297054
122,31,125,151,146,10217,555,378,37,73,311,389,392,29812,1743,987,97,10363,30204
122,33,2,0,0,0,0,0,0,1,6,0,0,0,0,0,0,0,0
122,34,50,0,0,0,0,0,0,33,129,0,0,0,0,0,0,0,0
123,30,703,915,1543,66474,2726,1078,246,238,1619,3211,4285,217395,10303,3157,722,68017,221680
123,33,3,0,0,0,0,0,0,2,11,0,0,0,0,0,0,0,0
123,34,36,0,0,0,0,0,0,18,85,0,0,0,0,0,0,0,0
124,29,8,0,0,0,0,0,0,4,16,0,0,0,0,0,0,0,0
124,30,144,202,162,13815,786,292,53,69,356,797,421,46367,3057,1105,147,13977,46788
124,31,17,11,11,890,73,37,6,8,49,69,39,4036,499,110,18,901,4075
124,33,23,0,0,0,0,0,0,6,48,0,0,0,0,0,0,0,0
124,34,31,39,251,2013,161,164,25,10,108,80,778,7378,627,391,29,2264,8156
125,31,5,0,0,0,0,0,0,3,12,0,0,0,0,0,0,0,0
125,32,5,0,0,0,0,0,0,2,12,0,0,0,0,0,0,0,0
126,31,1,0,0,0,0,0,0,1,4,0,0,0,0,0,0,0,0
127,29,1,0,0,0,0,0,0,1,2,0,0,0,0,0,0,0,0
127,30,3,0,0,0,0,0,0,2,9,0,0,0,0,0,0,0,0
127,31,7,0,0,0,0,0,0,2,16,0,0,0,0,0,0,0,0
