x,y,ACCOMMODATION UNITS (ROOMS APARTMENTS CAMPING SITES) - TOTAL,A_AUSTRIAN TOURISTS,A_DOMESTIC TOURISTS - TOTAL,A_FOREIGN TOURISTS - TOTAL,A_GERMAN TOURISTS,A_ITALIAN TOURISTS,A_SLOVENIAN TOURISTS,ESTABLISHMENTS - TOTAL,NUMBER OF PERMANENT BEDS,N_AUSTRIAN TOURISTS,N_DOMESTIC TOURISTS - TOTAL,N_FOREIGN TOURISTS - TOTAL,N_GERMAN TOURISTS,N_ITALIAN TOURISTS,N_SLOVENIAN TOURISTS,TOTAL ARRIVALS,TOTAL NIGHTS
0,47,11888,94397,43461,530809,123547,70692,43503,2050,31347,508588,124977,3210716,1067151,339652,160707,574270,3335693
0,49,1,0,0,0,0,0,0,1,4,0,0,0,0,0,0,0,0
0,51,158,147,24,1375,760,59,18,93,489,932,82,11719,7162,352,104,1399,11801
0,52,98,265,94,2308,1098,248,55,54,302,1760,310,18469,10646,1116,249,2402,18779
0,53,176,345,260,4141,1539,616,283,80,534,1929,669,26111,13977,2215,806,4401,26780
0,54,101,172,32,1727,1030,98,31,58,337,1163,166,15286,10334,690,157,1759,15452
0,55,54,70,36,834,468,101,39,25,142,470,142,7361,4601,592,111,870,7503
0,56,263,0,0,0,0,0,0,117,672,0,0,0,0,0,0,0,0
0,57,8,0,0,0,0,0,0,1,14,0,0,0,0,0,0,0,0
0,58,30,80,8,518,175,0,10,12,79,514,23,4330,1784,0,27,526,4353
0,59,31,168,28,853,207,113,15,10,72,587,82,4261,1848,232,17,881,4343
0,60,31,24,9,149,34,10,8,14,98,129,24,1125,382,88,54,158,1149
0,61,55,53,20,774,511,40,20,22,133,393,68,6788,5120,113,52,794,6856
1,46,54,0,0,0,0,0,0,7,152,0,0,0,0,0,0,0,0
1,47,791,36,0,216,127,0,0,10,2358,254,0,1766,1123,0,0,216,1766
1,48,34,230,54,1508,305,199,26,10,112,1118,201,8625,2439,984,106,1562,8826
1,49,203,476,260,4877,1571,918,114,87,499,3162,1055,31239,13607,4123,373,5137,32294
1,50,55,0,0,0,0,0,0,22,129,0,0,0,0,0,0,0,0
1,51,20,0,0,0,0,0,0,9,44,0,0,0,0,0,0,0,0
1,52,47,71,33,653,219,113,39,26,136,401,58,4546,2194,407,174,686,4604
1,53,33,0,0,0,0,0,0,9,110,0,0,0,0,0,0,0,0
1,54,135,200,82,1489,463,82,97,43,291,973,196,10458,4309,365,179,1571,10654
1,55,142,242,158,2081,749,123,63,53,316,1586,436,14404,6921,483,204,2239,14840
1,56,68,0,0,0,0,0,0,28,163,0,0,0,0,0,0,0,0
1,57,26,68,14,513,163,0,1,10,64,410,50,4108,1416,0,7,527,4158
1,58,11,0,0,0,0,0,0,4,24,0,0,0,0,0,0,0,0
1,59,95,356,311,2060,338,295,228,30,250,1145,1344,8598,2142,713,656,2371,9942
1,60,5,27,23,190,31,36,15,4,10,83,33,763,279,73,29,213,796
1,61,57,166,66,1086,448,65,53,21,140,837,219,7014,3885,191,108,1152,7233
2,44,14,17,6,266,38,46,119,5,30,112,46,1665,254,281,777,272,1711
2,46,4,0,0,0,0,0,0,1,8,0,0,0,0,0,0,0,0
2,47,5,0,0,0,0,0,0,2,14,0,0,0,0,0,0,0,0
2,48,19,44,41,514,166,116,10,11,64,244,220,3466,1581,550,27,555,3686
2,49,119,27,8,297,136,49,7,46,275,200,26,2245,1223,317,26,305,2271
2,50,35,18,12,323,225,7,7,16,88,222,84,3300,2353,40,79,335,3384
2,51,82,116,48,787,295,36,28,33,194,626,73,6067,2907,361,89,835,6140
2,52,199,411,61,2384,1152,53,12,70,459,2751,267,20238,10742,314,50,2445,20505
2,53,39,18,9,288,191,4,0,16,99,187,35,2904,1909,28,0,297,2939
2,54,24,0,0,0,0,0,0,7,50,0,0,0,0,0,0,0,0
2,55,45,0,0,0,0,0,0,14,101,0,0,0,0,0,0,0,0
2,56,40,0,0,0,0,0,0,16,99,0,0,0,0,0,0,0,0
2,57,74,0,0,0,0,0,0,32,176,0,0,0,0,0,0,0,0
2,58,16,0,0,0,0,0,0,4,34,0,0,0,0,0,0,0,0
2,59,27,72,4,222,111,0,0,10,62,482,28,1713,928,0,0,226,1741
2,60,6,0,0,0,0,0,0,2,12,0,0,0,0,0,0,0,0
3,43,5,0,0,0,0,0,0,2,16,0,0,0,0,0,0,0,0
3,44,76,178,30,1549,900,74,44,39,223,1357,168,13940,9307,520,238,1579,14108
3,45,55,143,63,1471,495,175,106,24,166,911,326,10951,4851,1033,451,1534,11277
3,46,818,5688,1834,44905,12289,7574,11553,96,2285,34090,5809,284678,105344,37977,69140,46739,290487
3,48,26,53,74,830,283,175,21,10,57,330,153,4835,2372,460,31,904,4988
3,49,119,195,229,2169,989,183,56,49,266,1169,660,15905,9020,885,97,2398,16565
3,50,14,0,0,0,0,0,0,6,34,0,0,0,0,0,0,0,0
3,51,99,145,3,1028,510,32,0,39,236,1064,8,8831,4653,253,0,1031,8839
3,52,96,24,3,321,210,5,3,38,219,163,9,2824,1969,54,21,324,2833
3,53,62,79,14,919,570,1,11,25,146,704,83,9080,5895,21,57,933,9163
3,54,59,105,8,750,460,27,19,25,142,848,41,6896,4424,178,75,758,6937
3,55,42,66,6,381,204,15,2,17,103,525,12,2649,1356,97,26,387,2661
3,56,32,27,9,416,223,8,0,17,91,197,56,3746,2338,63,0,425,3802
3,57,66,81,190,1374,418,128,86,26,145,450,397,8584,3624,227,150,1564,8981
3,58,15,0,0,0,0,0,0,6,30,0,0,0,0,0,0,0,0
3,59,12,0,5,36,19,0,2,6,26,0,37,310,223,0,8,41,347
3,60,2,0,0,0,0,0,0,1,4,0,0,0,0,0,0,0,0
4,41,41,246,131,1284,298,179,36,18,97,1741,553,8453,2386,1084,240,1415,9006
4,42,3797,7809,7267,126743,37708,14470,19307,708,11099,51275,42467,949785,332000,92496,107839,134010,992252
4,43,618,838,1586,17681,4013,831,5865,227,1836,5344,6694,116462,38935,4148,38584,19267,123156
4,44,3,0,0,0,0,0,0,2,10,0,0,0,0,0,0,0,0
4,45,4,0,0,0,0,0,0,2,14,0,0,0,0,0,0,0,0
4,48,54,71,3,647,460,24,2,22,128,519,27,6140,4869,170,8,650,6167
4,49,4,0,0,0,0,0,0,4,17,0,0,0,0,0,0,0,0
4,50,54,75,37,595,322,6,2,14,110,633,211,4953,2829,28,8,632,5164
4,51,93,166,23,1682,802,10,6,35,210,1410,84,15695,8006,33,60,1705,15779
4,52,74,65,15,1298,759,23,7,27,197,599,88,12149,7724,89,49,1313,12237
4,53,50,158,100,1031,526,36,5,19,138,1239,253,9126,5375,129,12,1131,9379
4,54,15,62,45,473,212,35,1,9,62,462,85,3890,2323,124,2,518,3975
4,55,7,0,0,0,0,0,0,2,15,0,0,0,0,0,0,0,0
4,56,48,58,14,676,372,0,0,17,101,456,86,6576,3674,0,0,690,6662
4,57,488,394,291,4130,1117,341,213,52,1333,852,566,9494,2877,506,408,4421,10060
4,58,313,13,0,87,51,0,0,18,515,103,0,883,531,0,0,87,883
4,59,38,95,71,539,138,14,58,12,84,242,119,2646,1141,18,87,610,2765
5,38,585,0,0,0,0,0,0,7,1750,0,0,0,0,0,0,0,0
5,39,591,1608,726,19458,4992,1938,1035,258,1631,8978,2436,124998,41431,10862,5877,20184,127434
5,40,7938,24988,36856,327772,61969,38684,21409,2145,21595,119298,94308,1673546,415378,178277,92912,364628,1767854
5,41,225,364,227,6456,1609,825,285,115,596,2376,993,42288,14300,4767,1415,6683,43281
5,42,191,374,229,4791,1847,565,149,104,551,2699,815,37213,17864,3664,670,5020,38028
5,43,298,656,371,7578,2749,522,1198,162,876,4574,2185,61667,26883,3785,7787,7949,63852
5,45,76,336,59,1908,1154,43,18,29,199,2393,180,17233,11599,336,31,1967,17413
5,46,57,136,4,798,573,0,1,16,113,1081,12,7906,6129,0,3,802,7918
5,47,13,26,10,243,136,0,0,5,28,210,44,2310,1346,0,0,253,2354
5,48,93,101,69,1173,667,12,28,35,203,680,160,10252,6532,63,95,1242,10412
5,49,103,84,56,1943,1030,105,50,47,241,640,195,16545,10678,547,329,1999,16740
5,50,56,73,47,873,411,51,28,22,133,543,140,7083,4091,273,127,920,7223
5,51,22,7,16,305,175,4,0,9,48,98,91,2995,1745,28,0,321,3086
5,52,91,184,57,1667,1016,17,29,38,209,1485,389,16609,10986,86,125,1724,16998
5,53,21,26,1,340,230,11,0,10,61,275,14,3305,2311,61,0,341,3319
5,54,21,3,16,137,50,8,0,10,53,21,72,1209,532,56,0,153,1281
5,55,31,65,158,1006,441,44,32,14,90,322,336,6112,3368,109,46,1164,6448
5,56,10,0,0,0,0,0,0,4,22,0,0,0,0,0,0,0,0
5,57,14,0,0,0,0,0,0,4,27,0,0,0,0,0,0,0,0
5,58,11,0,0,0,0,0,0,5,22,0,0,0,0,0,0,0,0
5,59,4,0,0,0,0,0,0,2,8,0,0,0,0,0,0,0,0
5,60,8,0,0,0,0,0,0,4,20,0,0,0,0,0,0,0,0
6,38,1517,5405,2836,51657,15736,4224,5469,327,4143,33010,10498,367532,138558,25051,39499,54493,378030
6,39,360,782,201,9257,3208,1098,260,186,962,5071,839,69394,30323,6432,1055,9458,70233
6,40,74,128,107,2351,639,367,57,49,208,754,804,14344,5617,1749,168,2458,15148
6,41,8,0,0,0,0,0,0,4,23,0,0,0,0,0,0,0,0
6,42,8,10,4,192,92,8,2,5,22,70,9,1727,838,40,4,196,1736
6,45,70,104,20,550,261,3,5,21,139,592,101,4574,2567,15,15,570,4675
6,46,287,394,23,3803,2444,61,74,87,613,3138,216,36748,25280,414,407,3826,36964
6,47,78,123,10,1091,591,39,22,30,171,912,19,9669,5950,229,87,1101,9688
6,48,98,86,79,1329,709,39,10,40,207,725,261,12601,7512,271,24,1408,12862
6,49,53,16,0,242,208,0,0,17,117,161,0,2835,2454,0,0,242,2835
6,50,46,29,36,443,245,29,14,21,117,260,183,3989,2477,83,89,479,4172
6,51,32,10,7,118,72,0,3,14,77,64,16,1225,869,0,15,125,1241
6,52,24,66,14,468,280,11,0,13,78,509,48,4344,2736,77,0,482,4392
6,53,58,99,174,929,346,89,4,18,143,539,312,6677,2986,252,4,1103,6989
6,54,31,17,50,311,123,14,6,13,74,95,133,2363,1270,66,21,361,2496
6,55,3,0,0,0,0,0,0,2,10,0,0,0,0,0,0,0,0
6,58,6,0,0,0,0,0,0,2,14,0,0,0,0,0,0,0,0
6,59,26,0,0,0,0,0,0,9,54,0,0,0,0,0,0,0,0
6,60,5,0,0,0,0,0,0,4,10,0,0,0,0,0,0,0,0
6,61,4,0,0,0,0,0,0,1,8,0,0,0,0,0,0,0,0
6,62,1,0,0,0,0,0,0,1,4,0,0,0,0,0,0,0,0
7,37,62,266,6,794,101,146,56,35,188,1462,32,4198,764,602,170,800,4230
7,38,3299,14660,1388,104251,20296,19443,25949,541,9489,85388,7721,626292,153207,100774,144994,105639,634013
7,39,85,327,24,1920,856,169,99,42,199,2513,114,15607,8033,984,593,1944,15721
7,40,87,194,37,2045,924,160,27,52,250,1486,204,16808,9062,971,175,2082,17012
7,41,13,0,0,156,72,11,0,5,31,0,0,1371,745,66,0,156,1371
7,42,121,310,69,2770,1590,122,8,60,329,2362,282,24689,16107,846,37,2839,24971
7,43,2,0,0,0,0,0,0,2,8,0,0,0,0,0,0,0,0
7,44,27,18,0,177,75,0,0,8,71,116,0,1638,838,0,0,177,1638
7,45,68,89,53,1206,655,69,15,28,145,557,215,10772,7077,351,121,1259,10987
7,46,22,14,0,191,127,0,0,8,46,86,0,2048,1477,0,0,191,2048
7,47,42,0,0,0,0,0,0,16,102,0,0,0,0,0,0,0,0
7,48,7,0,0,0,0,0,0,3,18,0,0,0,0,0,0,0,0
7,49,58,147,60,1190,619,34,12,20,134,1166,207,10246,6162,138,34,1250,10453
7,50,49,13,2,619,443,11,0,18,138,101,10,6116,4486,82,0,621,6126
7,51,6,0,0,0,0,0,0,3,21,0,0,0,0,0,0,0,0
7,52,15,13,7,163,83,0,4,7,37,74,18,1257,861,0,8,170,1275
7,53,13,0,1,108,67,0,0,5,36,0,7,1222,774,0,0,109,1229
7,54,42,78,2236,1543,171,401,111,13,91,210,4370,5044,447,800,165,3779,9414
7,55,5,0,0,0,0,0,0,2,10,0,0,0,0,0,0,0,0
7,56,3,0,0,0,0,0,0,2,7,0,0,0,0,0,0,0,0
7,57,4,0,0,0,0,0,0,2,7,0,0,0,0,0,0,0,0
7,58,14,0,0,0,0,0,0,5,32,0,0,0,0,0,0,0,0
7,59,7,0,0,0,0,0,0,3,16,0,0,0,0,0,0,0,0
7,60,109,669,1755,5836,654,589,336,21,222,1667,3526,16320,2438,1067,449,7591,19846
7,61,9,36,8,358,184,0,2,4,19,351,16,2877,1553,0,2,366,2893
8,38,5992,32963,6069,178361,52929,21444,15422,1037,16426,197597,24643,1234484,461139,127794,79385,184430,1259127
8,39,501,1175,217,11308,5319,1141,407,226,1321,7599,1094,94173,51871,8052,2082,11525,95267
8,40,198,616,396,5192,2574,608,140,82,479,3917,769,40500,24740,3190,538,5588,41269
8,41,97,309,30,1810,955,109,10,40,234,2275,174,16453,10317,664,55,1840,16627
8,42,112,167,24,1950,1014,166,22,54,274,1251,168,16466,9923,956,66,1974,16634
8,43,106,124,24,2131,1374,135,28,48,256,868,124,20077,14456,874,73,2155,20201
8,44,12,0,0,0,0,0,0,5,26,0,0,0,0,0,0,0,0
8,45,112,326,138,2246,1127,141,27,39,253,1995,488,17066,10409,727,91,2384,17554
8,46,37,69,0,450,284,4,0,18,99,490,0,4467,3111,48,0,450,4467
8,47,92,262,252,2061,1236,54,70,37,216,1744,387,19266,13075,316,190,2313,19653
8,48,69,165,19,934,359,57,51,20,145,1040,142,7311,3082,286,145,953,7453
8,49,40,0,0,104,75,11,0,15,91,0,0,989,830,54,0,104,989
8,50,5,0,0,0,0,0,0,2,14,0,0,0,0,0,0,0,0
8,51,6,0,0,0,0,0,0,3,14,0,0,0,0,0,0,0,0
8,52,6,0,0,0,0,0,0,2,12,0,0,0,0,0,0,0,0
8,53,1,0,0,0,0,0,0,1,4,0,0,0,0,0,0,0,0
8,54,17,7,132,167,43,29,2,7,41,40,588,1042,318,243,2,299,1630
8,55,5,0,0,0,0,0,0,2,10,0,0,0,0,0,0,0,0
8,56,5,0,0,0,0,0,0,2,12,0,0,0,0,0,0,0,0
8,57,1,0,0,0,0,0,0,1,4,0,0,0,0,0,0,0,0
8,58,7,0,0,0,0,0,0,4,14,0,0,0,0,0,0,0,0
8,59,16,0,0,0,0,0,0,7,33,0,0,0,0,0,0,0,0
8,60,21,0,0,0,0,0,0,8,41,0,0,0,0,0,0,0,0
8,61,6,0,0,0,0,0,0,3,16,0,0,0,0,0,0,0,0
9,38,44,92,35,980,467,58,50,21,108,675,305,8341,4519,412,272,1015,8646
9,39,3,0,0,0,0,0,0,1,6,0,0,0,0,0,0,0,0
9,42,172,378,151,3442,1790,150,71,67,411,2660,1025,29346,17283,922,325,3593,30371
9,43,85,116,28,1537,996,88,12,39,206,839,149,15513,11377,583,94,1565,15662
9,44,9,0,0,0,0,0,0,5,18,0,0,0,0,0,0,0,0
9,45,86,135,41,1354,831,47,12,36,199,1046,57,12518,8185,239,45,1395,12575
9,46,23,100,7,527,375,8,1,14,56,891,38,5209,3824,56,7,534,5247
9,47,33,22,3,419,265,9,3,18,68,160,9,4080,2777,34,21,422,4089
9,48,49,42,1,615,418,23,9,19,104,311,13,5752,4333,122,58,616,5765
9,49,15,0,0,0,0,0,0,5,36,0,0,0,0,0,0,0,0
9,50,20,10,5,192,95,9,18,8,48,70,63,1584,1005,23,38,197,1647
9,51,8,0,0,0,0,0,0,6,31,0,0,0,0,0,0,0,0
9,52,35,80,70,770,483,10,4,17,87,370,270,6595,4769,62,10,840,6865
9,53,25,24,78,450,112,78,20,12,60,104,178,2226,889,257,32,528,2404
9,55,8,0,0,0,0,0,0,3,24,0,0,0,0,0,0,0,0
9,56,6,0,0,0,0,0,0,3,16,0,0,0,0,0,0,0,0
9,57,5,0,0,0,0,0,0,4,16,0,0,0,0,0,0,0,0
9,59,18,0,0,75,38,0,0,9,33,0,0,602,364,0,0,75,602
9,60,13,0,0,0,0,0,0,9,32,0,0,0,0,0,0,0,0
9,61,2,0,0,0,0,0,0,1,7,0,0,0,0,0,0,0,0
9,62,1,0,0,0,0,0,0,1,2,0,0,0,0,0,0,0,0
10,43,101,104,29,1353,780,49,59,43,239,624,190,11932,7714,429,512,1382,12122
10,44,679,929,3360,13283,3846,1123,2493,162,1882,5605,18976,95872,37543,6597,15034,16643,114848
10,45,22,56,0,585,328,123,0,10,52,381,0,5168,3392,747,0,585,5168
10,46,75,173,1,1496,981,25,11,36,178,1209,7,14459,10505,155,74,1497,14466
10,47,31,141,36,938,397,24,31,11,69,690,86,6059,3574,97,61,974,6145
10,48,42,21,8,453,303,5,0,19,102,253,53,4644,3307,10,0,461,4697
10,49,42,91,22,704,384,15,16,25,133,672,116,6721,4011,61,121,726,6837
10,50,79,114,29,1608,943,105,30,36,187,743,105,13784,9617,531,78,1637,13889
10,51,2,0,0,0,0,0,0,1,4,0,0,0,0,0,0,0,0
10,52,46,82,0,554,330,3,4,19,108,464,0,4878,3289,9,28,554,4878
10,53,21,116,19,655,222,29,40,9,54,523,49,3980,2054,64,70,674,4029
10,54,6,0,0,0,0,0,0,3,18,0,0,0,0,0,0,0,0
10,55,1,0,0,0,0,0,0,1,4,0,0,0,0,0,0,0,0
10,56,7,0,0,0,0,0,0,3,19,0,0,0,0,0,0,0,0
10,58,19,73,104,812,160,84,22,11,42,193,178,1969,620,130,46,916,2147
10,59,14,49,56,506,27,187,41,9,32,217,153,1574,137,361,86,562,1727
10,60,38,0,0,0,0,0,0,22,85,0,0,0,0,0,0,0,0
10,61,3,0,0,0,0,0,0,1,7,0,0,0,0,0,0,0,0
11,44,17,36,14,475,139,93,4,6,56,246,96,3644,1407,658,24,489,3740
11,46,56,215,40,1260,663,23,3,30,148,1470,154,10494,6442,177,9,1300,10648
11,47,85,88,58,1493,1063,52,6,40,224,654,209,14741,11467,356,36,1551,14950
11,48,143,159,68,2490,1620,107,29,70,370,1079,372,24759,17671,863,118,2558,25131
11,49,116,224,65,2155,1282,122,37,61,314,1482,197,19665,13343,735,167,2220,19862
11,50,33,30,0,421,267,7,0,17,97,205,0,3898,2816,33,0,421,3898
11,51,68,181,42,1365,760,26,59,27,175,1152,102,11877,7398,245,174,1407,11979
11,52,11,0,0,0,0,0,0,8,44,0,0,0,0,0,0,0,0
11,53,9,0,0,0,0,0,0,5,27,0,0,0,0,0,0,0,0
11,54,9,0,0,0,0,0,0,5,22,0,0,0,0,0,0,0,0
11,56,13,0,0,0,0,0,0,5,28,0,0,0,0,0,0,0,0
11,57,1,0,0,0,0,0,0,1,4,0,0,0,0,0,0,0,0
11,58,3,0,0,0,0,0,0,2,13,0,0,0,0,0,0,0,0
11,59,1,0,0,0,0,0,0,1,6,0,0,0,0,0,0,0,0
11,60,8,0,0,0,0,0,0,2,16,0,0,0,0,0,0,0,0
11,61,1,0,0,0,0,0,0,1,3,0,0,0,0,0,0,0,0
12,44,240,126,37,858,367,74,13,34,668,836,196,7096,3489,597,90,895,7292
12,45,44,0,0,128,73,6,0,21,114,0,0,1105,653,60,0,128,1105
12,46,28,8,8,133,90,12,4,13,66,77,36,1206,780,144,40,141,1242
12,47,15,13,2,222,113,11,7,9,35,83,8,1802,1081,32,31,224,1810
12,48,204,412,138,4940,2319,485,131,99,522,2625,420,38815,23297,2418,529,5078,39235
12,49,217,498,796,6447,2306,1135,187,126,575,2319,2623,38006,20197,3596,481,7243,40629
12,50,138,360,153,3155,1906,199,17,75,445,2592,870,29333,19994,1123,62,3308,30203
12,51,62,31,11,377,227,5,19,24,157,217,72,3777,2581,23,97,388,3849
12,52,78,100,53,1078,521,46,13,35,188,824,174,9848,5357,271,68,1131,10022
12,53,29,12,17,177,99,2,0,15,73,132,303,1759,1096,14,0,194,2062
12,54,12,19,0,205,128,22,0,4,27,157,0,2000,1460,127,0,205,2000
12,55,4,0,0,0,0,0,0,1,8,0,0,0,0,0,0,0,0
12,56,14,0,0,0,0,0,0,5,32,0,0,0,0,0,0,0,0
12,57,3,0,0,0,0,0,0,1,6,0,0,0,0,0,0,0,0
12,58,12,0,0,0,0,0,0,4,27,0,0,0,0,0,0,0,0
13,45,155,336,44,2907,1333,202,81,85,389,2270,271,23572,13276,1168,393,2951,23843
13,46,186,799,106,4882,2302,286,116,62,470,5092,400,37065,21358,1391,657,4988,37465
13,47,433,0,0,0,0,0,0,55,1289,0,0,0,0,0,0,0,0
13,48,3638,34626,7984,179793,47315,15475,15154,445,8639,176054,23446,1119049,371082,72573,57301,187777,1142495
13,49,95,301,25,2197,1264,148,29,40,230,2025,86,17090,11299,568,90,2222,17176
13,50,23,0,0,0,0,0,0,10,67,0,0,0,0,0,0,0,0
13,51,49,47,127,648,161,142,4,21,141,204,559,3426,1144,702,9,775,3985
13,52,32,54,4,445,209,26,10,12,69,292,45,4217,2357,124,63,449,4262
13,54,12,0,0,0,0,0,0,4,24,0,0,0,0,0,0,0,0
13,57,6,0,0,0,0,0,0,2,12,0,0,0,0,0,0,0,0
13,58,1,0,0,0,0,0,0,1,2,0,0,0,0,0,0,0,0
13,62,3,0,0,0,0,0,0,1,6,0,0,0,0,0,0,0,0
14,49,34,98,4,654,401,8,7,18,85,751,16,5883,3814,56,49,658,5899
14,50,51,154,154,1497,612,267,42,22,134,396,303,6869,4092,499,90,1651,7172
14,51,5,0,0,0,0,0,0,2,12,0,0,0,0,0,0,0,0
14,52,2,0,0,0,0,0,0,1,4,0,0,0,0,0,0,0,0
14,57,9,0,0,0,0,0,0,1,18,0,0,0,0,0,0,0,0
14,63,3,0,0,0,0,0,0,2,6,0,0,0,0,0,0,0,0
14,64,3,0,0,0,0,0,0,3,8,0,0,0,0,0,0,0,0
15,51,24,66,6,577,286,29,0,10,60,437,55,4423,2737,95,0,583,4478
15,52,131,356,40,3425,911,465,101,51,333,1719,99,21037,7582,1912,413,3465,21136
15,53,39,48,11,614,330,59,10,24,100,298,22,5052,3291,351,40,625,5074
15,54,919,9526,1690,43454,8643,5875,4249,228,2215,42271,5653,199747,51758,24490,17567,45144,205400
15,55,91,248,40,1773,667,187,48,36,238,1373,128,10977,5388,798,244,1813,11105
15,56,73,0,0,0,0,0,0,37,201,0,0,0,0,0,0,0,0
15,57,64,170,147,1539,511,124,32,41,201,911,962,9361,4432,622,68,1686,10323
15,58,3,0,0,0,0,0,0,1,8,0,0,0,0,0,0,0,0
15,60,6,16,6,189,57,27,0,5,19,59,16,930,444,87,0,195,946
15,61,21,101,58,444,158,25,14,7,48,303,148,3274,1431,64,63,502,3422
15,63,4,0,0,0,0,0,0,2,9,0,0,0,0,0,0,0,0
16,32,70,0,0,0,0,0,0,34,190,0,0,0,0,0,0,0,0
16,50,15,54,23,387,124,35,26,11,42,355,181,3186,1185,285,247,410,3367
16,55,399,1192,618,15977,3585,1339,2730,36,1162,4935,2467,63489,16797,4910,11251,16595,65956
16,56,1098,9486,13022,66439,11146,6791,5274,216,2497,38387,33027,246060,60402,23745,13733,79461,279087
16,57,1463,5781,1958,43065,10430,3817,1666,393,3598,24546,6823,201737,63441,13632,5793,45023,208560
16,58,1183,16062,12454,92182,13770,9981,6455,201,2485,55555,30074,303705,65812,26015,14585,104636,333779
16,59,46,99,81,1232,401,216,43,28,128,419,222,7048,3417,751,78,1313,7270
16,60,17,39,73,432,55,120,21,10,39,141,151,1381,268,314,27,505,1532
16,61,14,0,0,0,0,0,0,5,34,0,0,0,0,0,0,0,0
16,63,23,0,0,0,0,0,0,8,58,0,0,0,0,0,0,0,0
17,49,1,0,0,0,0,0,0,1,6,0,0,0,0,0,0,0,0
17,50,4,0,0,0,0,0,0,3,12,0,0,0,0,0,0,0,0
17,58,2061,36910,37729,184043,18204,19668,12011,380,4254,134718,81547,572788,86410,48819,25863,221772,654335
17,59,418,1670,3467,19314,3650,4231,646,251,1169,5899,10759,80131,24972,10681,1674,22781,90890
17,60,3,0,0,0,0,0,0,2,6,0,0,0,0,0,0,0,0
17,63,2,0,0,0,0,0,0,1,4,0,0,0,0,0,0,0,0
18,27,58,493,225,1196,127,114,220,36,177,4445,1290,9835,1204,867,1528,1421,11125
18,41,4,0,0,0,0,0,0,4,13,0,0,0,0,0,0,0,0
18,42,6,28,0,121,16,39,3,5,16,168,0,746,100,236,12,121,746
18,50,81,0,0,0,0,0,0,11,225,0,0,0,0,0,0,0,0
18,58,122,336,705,6150,1014,1311,172,101,347,1410,2739,27944,7072,4320,523,6855,30683
18,59,86,104,328,2862,573,504,46,52,225,365,834,12027,4318,1437,91,3190,12861
18,60,49,72,355,1028,420,147,31,22,125,535,752,7917,4176,1242,73,1383,8669
18,62,1,0,0,0,0,0,0,1,2,0,0,0,0,0,0,0,0
19,38,173,315,176,3366,360,535,1736,82,467,2558,1293,26449,3441,3743,13753,3542,27742
19,39,703,187,43,1258,164,595,115,83,2070,1578,272,10270,1452,4695,958,1301,10542
19,41,1,0,0,0,0,0,0,1,4,0,0,0,0,0,0,0,0
19,42,184,1417,126,5485,1482,1119,349,47,502,9127,519,35969,10994,7491,2360,5611,36488
19,44,2,0,0,0,0,0,0,2,5,0,0,0,0,0,0,0,0
19,45,8,8,1,101,15,7,43,8,16,50,10,1048,161,34,495,102,1058
19,58,298,107,467,2486,338,462,60,52,728,325,2052,8033,1999,1127,137,2953,10085
19,59,21,51,43,681,63,116,3,20,56,171,120,2270,239,236,21,724,2390
19,60,16,28,106,253,47,56,15,9,42,104,278,1024,340,156,19,359,1302
20,29,5,0,0,0,0,0,0,2,13,0,0,0,0,0,0,0,0
20,30,4,44,0,169,41,9,27,3,15,314,0,1582,516,56,265,169,1582
20,31,3,0,0,0,0,0,0,2,8,0,0,0,0,0,0,0,0
20,32,29,96,78,701,133,126,56,21,102,789,524,5733,1222,855,441,779,6257
20,33,1210,1886,1257,39971,6796,3556,22858,119,3791,12966,6642,307505,58330,25388,181635,41228,314147
20,34,504,1273,373,14101,5351,1397,2836,19,1502,8781,2310,97571,39721,9887,23293,14474,99881
20,36,16,65,4,404,36,173,21,11,54,379,32,2859,236,1229,257,408,2891
20,38,31,160,19,657,146,168,37,19,91,1346,114,5216,1322,1340,261,676,5330
20,40,4,9,19,168,14,69,12,3,10,21,52,503,68,248,34,187,555
20,41,10,18,25,220,23,98,17,6,22,104,125,1157,128,593,101,245,1282
20,43,3,6,13,95,8,42,12,3,8,18,68,528,88,172,59,108,596
20,44,2390,7927,4200,78608,22055,16079,17065,329,6614,55840,23448,578384,208551,97579,127985,82808,601832
20,49,353,0,0,0,0,0,0,5,1049,0,0,0,0,0,0,0,0
20,58,892,4478,21748,96103,10023,15885,2127,371,2182,8590,38557,197996,23503,29601,5107,117851,236553
20,59,17,31,187,1158,141,270,29,14,48,95,456,3178,650,514,55,1345,3634
20,60,18,0,0,0,0,0,0,7,49,0,0,0,0,0,0,0,0
21,30,242,454,411,5223,886,1557,1138,116,685,3796,3063,43811,9090,12369,9348,5634,46874
21,36,1,0,0,0,0,0,0,1,4,0,0,0,0,0,0,0,0
21,37,5,6,1,90,21,26,9,3,14,38,8,602,221,135,80,91,610
21,38,5,0,0,0,0,0,0,2,12,0,0,0,0,0,0,0,0
21,41,13,31,37,301,15,130,37,8,31,205,185,1625,93,690,211,338,1810
21,43,7,22,8,169,13,81,5,3,16,169,32,1058,127,464,17,177,1090
21,45,15,46,25,423,132,87,16,12,40,355,147,2971,1193,475,116,448,3118
21,48,104,320,61,2572,1100,243,95,37,252,2091,334,18341,10353,1488,438,2633,18675
21,49,86,87,46,2366,867,325,128,49,233,594,261,17367,8695,2063,879,2412,17628
21,57,219,515,4655,5214,1070,825,180,78,556,2573,13031,27768,8428,2735,429,9869,40799
21,58,39,65,194,1224,161,203,20,36,104,249,692,5455,897,691,51,1418,6147
21,59,90,146,1713,1571,346,341,93,26,249,395,3682,5271,1950,689,428,3284,8953
21,60,43,74,229,869,201,324,7,21,104,201,723,3125,1089,822,11,1098,3848
22,28,2026,9730,11110,67036,16914,8169,17141,148,5384,64305,50897,492012,142175,48589,131631,78146,542909
22,29,233,701,861,6189,1093,1562,1006,110,675,4017,4438,41874,9284,10608,7030,7050,46312
22,36,11,18,7,204,35,53,3,7,28,121,34,1370,290,374,15,211,1404
22,47,229,399,331,6820,1717,929,1414,99,687,2585,2038,48028,16662,5805,7683,7151,50066
22,48,107,194,70,2364,768,327,239,45,314,1538,283,13656,6186,1697,864,2434,13939
22,49,42,77,4,606,333,43,4,19,101,632,29,5209,3080,350,28,610,5238
22,50,757,3184,855,17934,4382,2443,2658,314,2027,18459,4447,121243,37678,15559,16127,18789,125690
22,57,56,68,126,1029,299,100,17,37,165,346,866,7573,2466,686,56,1155,8439
22,58,10,5,46,154,11,29,8,7,25,23,153,474,112,67,23,200,627
22,59,1,0,0,0,0,0,0,1,4,0,0,0,0,0,0,0,0
23,28,3007,18885,25551,92436,22033,15883,12324,528,7526,108695,117659,605554,183018,96354,66377,117987,723213
23,29,67,166,184,1828,304,380,430,31,194,1263,862,15122,3037,3061,3542,2012,15984
23,32,508,30,18,316,48,89,97,30,1500,394,106,3102,464,924,862,334,3208
23,47,19,61,16,455,148,88,0,10,48,384,92,3354,1362,452,0,471,3446
23,48,124,426,163,3806,906,885,165,57,361,2266,455,21570,7509,4595,543,3969,22025
23,49,12,0,0,0,0,0,0,5,28,0,0,0,0,0,0,0,0
23,50,2027,10593,9746,69330,18895,7713,7377,793,5388,52453,37863,406668,136488,44859,34159,79076,444531
23,51,400,690,1376,9602,2185,1246,1441,154,1054,3957,7323,62527,19967,7249,7471,10978,69850
23,52,1925,10356,5218,90186,30887,5668,20052,326,5013,53414,21537,515052,212636,27377,98802,95404,536589
23,53,2,0,0,0,0,0,0,1,4,0,0,0,0,0,0,0,0
23,54,677,718,4861,23512,3166,1181,3017,139,1610,3631,23234,117958,20011,5600,14909,28373,141192
23,56,952,664,2683,30532,3103,967,11336,62,2354,2797,13514,122764,13229,2417,47722,33215,136278
23,57,30,48,42,803,235,81,7,28,86,312,102,4603,1890,379,13,845,4705
23,61,1,0,0,0,0,0,0,1,4,0,0,0,0,0,0,0,0
23,62,10,0,0,0,0,0,0,1,35,0,0,0,0,0,0,0,0
23,69,7,0,0,0,0,0,0,3,20,0,0,0,0,0,0,0,0
24,27,4,0,0,0,0,0,0,3,10,0,0,0,0,0,0,0,0
24,28,4,0,0,0,0,0,0,1,14,0,0,0,0,0,0,0,0
24,47,3194,18358,5817,133895,37949,17781,14811,780,8572,90685,24253,742697,258704,88505,73334,139712,766950
24,48,13,22,17,200,120,15,13,7,28,153,76,1764,1129,93,95,217,1840
24,50,142,202,120,2358,1043,371,37,62,336,1359,548,18060,10308,1840,178,2478,18608
24,51,45,13,0,562,160,77,58,23,133,57,0,3701,1597,387,345,562,3701
24,52,184,308,199,4288,1304,403,666,83,494,2139,1119,32714,12467,2898,4335,4487,33833
24,55,91,47,68,645,206,63,41,46,225,342,331,4221,1894,291,99,713,4552
24,56,129,194,1161,2820,579,370,138,45,298,893,3135,11296,4036,1102,425,3981,14431
24,57,7,2,0,131,100,0,0,7,22,8,0,1338,1043,0,0,131,1338
24,67,18,0,251,45,2,6,9,9,85,0,605,97,3,14,20,296,702
24,68,2,0,0,0,0,0,0,2,8,0,0,0,0,0,0,0,0
24,69,2,0,0,0,0,0,0,1,4,0,0,0,0,0,0,0,0
25,26,20,0,0,0,0,0,0,11,64,0,0,0,0,0,0,0,0
25,46,94,254,120,2464,449,177,855,28,231,1791,803,17474,3461,1220,5878,2584,18277
25,47,442,80,4,421,195,14,11,6,1371,647,4,3538,1915,99,77,425,3542
25,48,285,781,373,7338,2341,1042,761,143,786,4695,2071,50795,21227,6211,4597,7711,52866
25,49,26,93,10,587,337,19,4,15,80,615,16,4762,3238,89,4,597,4778
25,50,76,237,16,1435,775,65,6,28,177,1765,105,12235,7666,384,12,1451,12340
25,51,201,791,219,6241,1728,451,581,85,602,4418,774,40082,15646,2505,3364,6460,40856
25,52,226,1226,187,8896,3288,402,1345,69,670,7781,1257,53573,22302,2218,7735,9083,54830
25,53,11,17,0,129,48,27,7,4,24,94,0,974,481,167,49,129,974
25,54,519,1209,1641,12558,4299,661,675,242,1470,7485,9479,90372,38877,3817,3528,14199,99851
25,55,46,94,206,731,271,64,34,23,112,617,621,5422,2709,519,116,937,6043
25,56,6,0,0,0,0,0,0,5,25,0,0,0,0,0,0,0,0
25,65,19,0,0,0,0,0,0,3,48,0,0,0,0,0,0,0,0
25,67,1,0,0,0,0,0,0,1,4,0,0,0,0,0,0,0,0
26,21,9,17,31,85,6,17,31,5,26,171,242,831,31,160,401,116,1073
26,22,13,19,34,152,17,44,44,9,44,152,211,1031,96,283,309,186,1242
26,46,267,797,552,7752,1627,1196,1570,106,709,4310,3406,52361,14250,6894,9891,8304,55767
26,47,2125,8988,3017,61493,14603,6713,16089,255,6129,50225,14101,354538,98528,34245,94309,64510,368639
26,49,11,35,1,307,207,10,6,4,34,220,1,2593,1953,47,24,308,2594
26,50,87,188,112,2324,794,330,159,53,265,1362,683,17060,7496,2317,891,2436,17743
26,51,981,1849,685,25205,7016,2539,5033,307,2906,12179,3642,174870,64509,15595,27638,25890,178512
26,52,46,345,39,1814,335,149,271,15,114,2118,206,11744,2658,753,1793,1853,11950
26,53,1713,7719,10211,49186,9785,1313,5051,410,4191,35851,58880,296494,81585,6324,24866,59397,355374
26,54,96,208,290,1855,679,91,123,51,275,1024,1565,12306,6040,535,464,2145,13871
26,55,15,35,10,279,134,9,0,11,48,250,44,2489,1486,87,0,289,2533
26,57,9,3,30,56,14,6,6,8,27,6,64,303,158,16,14,86,367
26,60,3,0,0,0,0,0,0,2,6,0,0,0,0,0,0,0,0
26,62,10,0,0,0,0,0,0,7,25,0,0,0,0,0,0,0,0
26,65,4,0,0,0,0,0,0,1,8,0,0,0,0,0,0,0,0
26,66,4,0,0,0,0,0,0,3,12,0,0,0,0,0,0,0,0
27,44,98,0,0,0,0,0,0,27,236,0,0,0,0,0,0,0,0
27,45,418,326,27,2465,432,386,98,37,1218,2079,168,16914,3330,2518,754,2492,17082
27,49,329,1794,695,12620,4096,1174,1209,156,876,8530,2061,71903,32497,5261,3457,13315,73964
27,52,1399,5883,15097,49203,11827,2017,3860,465,4091,24665,61177,266839,83653,8180,17094,64300,328016
27,53,2931,12293,14100,93586,25124,3750,7248,889,7456,57096,55523,538770,193357,14546,29104,107686,594293
27,54,136,286,146,2627,1573,78,20,59,397,1976,458,21835,14692,464,33,2773,22293
27,56,13,0,219,213,53,14,11,8,35,0,491,1030,436,42,14,432,1521
27,57,103,69,3456,1631,260,172,91,38,258,223,9710,7674,1979,455,228,5087,17384
27,58,40,57,1387,2949,92,130,28,10,80,104,2404,3610,236,166,47,4336,6014
27,59,9,13,175,455,118,23,5,4,26,28,527,1158,384,35,7,630,1685
27,60,5,0,0,0,0,0,0,3,11,0,0,0,0,0,0,0,0
27,61,23,10,756,662,117,85,13,10,56,14,1698,1531,361,135,29,1418,3229
27,62,7,0,0,0,0,0,0,6,20,0,0,0,0,0,0,0,0
28,37,30,97,8,590,123,126,54,5,67,958,41,4704,1161,969,355,598,4745
28,38,626,2125,1042,17379,4750,1176,1949,157,1820,14689,6641,131516,46168,8207,13672,18421,138157
28,39,710,2201,396,14017,6275,1043,932,232,2033,16190,2550,124129,65713,8683,6903,14413,126679
28,40,100,163,89,2278,1033,142,138,31,307,1178,626,18898,9288,1271,1156,2367,19524
28,41,40,0,0,0,0,0,0,1,120,0,0,0,0,0,0,0,0
28,45,157,299,402,5553,703,1050,359,68,455,1360,1399,28282,5226,4918,1395,5955,29681
28,46,88,145,131,2110,315,489,96,37,228,911,466,11940,2390,2737,355,2241,12406
28,52,2348,9724,14071,86896,18039,4074,17833,447,6310,37686,73312,420895,100733,13647,81408,100967,494207
28,53,85,85,98,1293,882,46,0,44,258,606,345,11956,8865,348,0,1391,12301
28,54,2,0,0,0,0,0,0,2,10,0,0,0,0,0,0,0,0
28,58,15,0,0,0,0,0,0,7,42,0,0,0,0,0,0,0,0
28,59,15,5,251,95,2,15,5,9,38,5,496,237,4,15,7,346,733
28,65,1,0,0,0,0,0,0,1,6,0,0,0,0,0,0,0,0
29,23,168,387,1003,2008,217,291,651,106,496,4174,7823,18480,2158,2375,6470,3011,26303
29,35,348,1284,2319,9754,1356,1335,1680,80,878,7146,8023,60168,11107,8789,10249,12073,68191
29,37,732,1859,1137,11097,3240,1725,835,154,1880,12931,5647,87340,32307,12871,5732,12234,92987
29,38,505,784,682,9856,3303,1743,359,195,1500,5468,4303,77186,32427,12641,2386,10538,81489
29,39,235,586,193,5383,1920,582,213,87,691,4074,979,41182,18847,4038,1340,5576,42161
29,40,3081,12732,3300,85942,32107,3987,5547,427,9026,86173,19618,667142,296771,28220,41164,89242,686760
29,45,3557,28416,8123,155283,33182,15973,18805,820,9622,150201,31359,919799,241485,87465,89470,163406,951158
29,51,731,388,1021,7560,1990,451,398,187,2360,2077,5392,50914,17427,2807,1969,8581,56306
29,52,83,152,55,1355,701,63,19,52,257,999,215,11929,6729,534,74,1410,12144
29,53,3,0,0,0,0,0,0,2,10,0,0,0,0,0,0,0,0
29,54,2,0,0,0,0,0,0,1,4,0,0,0,0,0,0,0,0
29,58,3,0,0,0,0,0,0,2,8,0,0,0,0,0,0,0,0
29,61,88,113,3246,4308,207,421,138,26,251,238,6803,6289,305,585,274,7554,13092
29,63,3,0,0,0,0,0,0,1,9,0,0,0,0,0,0,0,0
29,64,6,0,0,0,0,0,0,4,18,0,0,0,0,0,0,0,0
30,33,8,0,0,0,0,0,0,5,24,0,0,0,0,0,0,0,0
30,34,17,28,18,294,24,64,51,5,50,248,113,2259,217,464,376,312,2372
30,35,8,0,0,0,0,0,0,2,16,0,0,0,0,0,0,0,0
30,37,2932,12761,8424,81436,28308,8435,7627,653,7737,70339,35827,535678,226559,51671,49386,89860,571505
30,38,89,159,141,1883,609,437,55,46,298,1261,708,14866,6069,3346,347,2024,15574
30,51,1753,3929,12121,47201,11085,2654,3236,587,5054,18350,53130,301322,92422,13120,13821,59322,354452
30,53,1,0,0,0,0,0,0,1,4,0,0,0,0,0,0,0,0
30,58,8,0,0,0,0,0,0,3,21,0,0,0,0,0,0,0,0
30,60,3,0,0,0,0,0,0,3,10,0,0,0,0,0,0,0,0
30,63,26,0,0,0,0,0,0,10,59,0,0,0,0,0,0,0,0
31,19,38,27,64,415,46,60,168,22,118,210,531,3620,463,508,1674,479,4151
31,23,25,13,42,151,8,26,69,16,71,175,474,1584,36,319,656,193,2058
31,32,227,0,0,0,0,0,0,56,605,0,0,0,0,0,0,0,0
31,33,1,0,0,0,0,0,0,1,3,0,0,0,0,0,0,0,0
31,36,648,1897,606,12711,5710,1153,1042,243,1861,13502,3922,109486,59751,8808,7809,13317,113408
31,37,402,1031,510,7598,3052,785,564,168,1220,8259,3622,66199,31960,6785,4321,8108,69821
31,49,4,0,0,0,0,0,0,2,9,0,0,0,0,0,0,0,0
31,50,1004,1639,799,27024,7972,2490,2015,150,2925,8023,3499,134720,43016,10324,9203,27823,138219
31,51,48,168,115,1432,393,40,66,23,151,912,423,9455,3422,173,389,1547,9878
31,52,2,0,0,0,0,0,0,1,4,0,0,0,0,0,0,0,0
31,57,12,0,0,0,0,0,0,1,43,0,0,0,0,0,0,0,0
31,58,28,10,700,156,9,8,43,14,67,36,1450,482,48,14,85,856,1932
31,59,5,0,0,0,0,0,0,3,16,0,0,0,0,0,0,0,0
31,61,5,0,0,0,0,0,0,1,10,0,0,0,0,0,0,0,0
31,63,4,0,0,0,0,0,0,2,7,0,0,0,0,0,0,0,0
31,64,8,0,100,60,11,4,0,5,20,0,328,437,75,19,0,160,765
32,19,3,0,0,0,0,0,0,1,12,0,0,0,0,0,0,0,0
32,47,86,115,13,1920,613,157,59,22,250,612,38,9982,3863,705,234,1933,10020
32,48,123,85,35,1780,448,267,94,15,350,523,210,9788,2890,1284,480,1815,9998
32,53,13,0,0,0,0,0,0,5,25,0,0,0,0,0,0,0,0
32,57,3,0,0,0,0,0,0,2,8,0,0,0,0,0,0,0,0
32,58,25,7,410,106,17,16,6,9,57,8,1094,485,168,33,9,516,1579
32,60,3,0,0,0,0,0,0,1,6,0,0,0,0,0,0,0,0
32,62,10,0,0,0,0,0,0,4,51,0,0,0,0,0,0,0,0
32,63,3,0,0,0,0,0,0,2,6,0,0,0,0,0,0,0,0
32,64,8,0,0,0,0,0,0,5,18,0,0,0,0,0,0,0,0
32,65,2,0,0,0,0,0,0,1,4,0,0,0,0,0,0,0,0
33,15,86,426,548,4296,1461,583,677,28,264,2338,3416,27537,9128,3770,5833,4844,30953
33,18,21,37,44,304,29,25,131,15,67,358,348,2863,260,348,1378,348,3211
33,30,4891,8936,3407,97365,23165,23040,3502,1190,13876,39569,13648,533841,132661,142175,18836,100772,547489
33,31,614,479,631,11162,1318,1601,2222,199,1727,3389,5265,82447,12444,10977,17409,11793,87712
33,32,20,20,21,680,30,13,82,9,60,146,227,5331,327,112,768,701,5558
33,36,119,80,52,997,180,61,370,66,347,496,234,7474,1650,304,2680,1049,7708
33,39,37,111,16,759,210,51,45,21,122,722,70,5811,1898,361,340,775,5881
33,40,43,0,0,0,0,0,0,24,144,0,0,0,0,0,0,0,0
33,41,70,308,63,1650,220,168,65,36,214,2101,260,10838,1529,1204,354,1713,11098
33,44,454,973,654,17421,5149,1144,647,141,1345,4094,1557,77684,27829,4390,3006,18075,79241
33,45,6,0,0,0,0,0,0,2,18,0,0,0,0,0,0,0,0
33,46,1032,2683,1161,45577,10732,4659,965,521,2987,9032,3652,195737,64210,15660,3773,46738,199389
33,47,40,65,3,599,238,42,11,19,135,414,5,4902,2461,236,69,602,4907
33,49,1,0,0,0,0,0,0,1,2,0,0,0,0,0,0,0,0
33,50,5,8,0,73,44,0,0,3,12,53,0,706,500,0,0,73,706
33,60,68,77,1666,3113,219,576,41,17,160,116,3777,3774,320,694,92,4779,7551
33,61,6,0,0,0,0,0,0,3,13,0,0,0,0,0,0,0,0
33,62,3,0,0,0,0,0,0,2,8,0,0,0,0,0,0,0,0
33,65,5,0,0,0,0,0,0,2,10,0,0,0,0,0,0,0,0
34,14,3,0,0,0,0,0,0,2,11,0,0,0,0,0,0,0,0
34,15,114,272,297,2356,669,347,220,27,335,2196,2083,18127,6088,2445,1960,2653,20210
34,17,31,36,34,245,22,13,99,17,90,433,314,2340,255,117,1015,279,2654
34,27,98,31,56,1667,83,75,263,25,240,262,415,13504,871,543,2206,1723,13919
34,29,435,587,809,8167,687,1599,2430,262,1129,2576,5646,49823,4019,9237,18939,8976,55469
34,30,234,402,134,4624,615,613,97,48,846,1597,377,20961,3297,3406,470,4758,21338
34,31,43,17,59,360,54,76,42,16,116,95,538,2847,514,588,345,419,3385
34,35,2,0,0,0,0,0,0,2,4,0,0,0,0,0,0,0,0
34,43,2,0,0,0,0,0,0,2,10,0,0,0,0,0,0,0,0
34,44,8,12,0,298,131,20,5,4,24,104,0,2487,1474,124,30,298,2487
34,45,17,18,10,700,155,45,18,5,52,72,18,3826,1220,275,73,710,3844
34,46,4,0,0,0,0,0,0,2,10,0,0,0,0,0,0,0,0
34,47,5,3,4,129,83,7,6,5,18,21,8,1011,697,32,36,133,1019
34,48,1,0,0,0,0,0,0,1,6,0,0,0,0,0,0,0,0
34,62,3,0,0,0,0,0,0,1,6,0,0,0,0,0,0,0,0
34,63,6,0,0,0,0,0,0,2,12,0,0,0,0,0,0,0,0
34,64,1,0,0,0,0,0,0,1,4,0,0,0,0,0,0,0,0
35,15,230,892,2243,4931,763,398,1669,41,533,5703,14530,32058,5512,2506,11035,7174,46588
35,16,5,3,4,55,9,9,17,3,14,51,42,873,261,93,160,59,915
35,27,2090,620,1191,16647,1667,1792,3456,295,6165,4556,8808,136662,16599,14266,29202,17838,145470
35,28,72,160,113,2250,404,351,671,17,195,1080,645,12483,2081,1682,4289,2363,13128
35,29,266,306,183,5967,542,594,2392,73,702,1493,1205,42194,5062,3694,18794,6150,43399
35,30,105,122,165,2455,308,321,745,32,274,661,1030,16283,2766,1858,5683,2620,17313
35,32,38,76,10,916,273,52,35,14,116,472,61,7400,2908,383,420,926,7461
35,42,4,0,0,0,0,0,0,2,12,0,0,0,0,0,0,0,0
35,44,3,0,0,0,0,0,0,2,10,0,0,0,0,0,0,0,0
35,45,7,0,0,0,0,0,0,2,14,0,0,0,0,0,0,0,0
35,46,4,0,0,0,0,0,0,1,8,0,0,0,0,0,0,0,0
35,48,1,0,0,0,0,0,0,1,5,0,0,0,0,0,0,0,0
35,56,22,3,113,64,25,28,4,8,43,8,445,381,284,55,21,177,826
35,60,18,0,0,0,0,0,0,4,118,0,0,0,0,0,0,0,0
35,62,2,0,0,0,0,0,0,2,7,0,0,0,0,0,0,0,0
36,14,15,0,0,0,0,0,0,9,46,0,0,0,0,0,0,0,0
36,27,81,167,26,1096,156,256,157,25,231,1121,128,8704,1438,2278,1160,1122,8832
36,28,2,0,0,0,0,0,0,1,4,0,0,0,0,0,0,0,0
36,29,200,102,198,3201,266,433,1017,53,492,575,1126,21223,2159,2821,7104,3399,22349
36,44,2,0,0,0,0,0,0,1,5,0,0,0,0,0,0,0,0
36,53,2,0,0,0,0,0,0,1,6,0,0,0,0,0,0,0,0
36,55,6,0,32,21,4,6,0,4,19,0,86,91,20,12,0,53,177
36,60,8,0,0,0,0,0,0,1,24,0,0,0,0,0,0,0,0
36,61,2,0,0,0,0,0,0,1,4,0,0,0,0,0,0,0,0
36,64,4,0,0,0,0,0,0,2,8,0,0,0,0,0,0,0,0
36,65,6,0,0,0,0,0,0,3,16,0,0,0,0,0,0,0,0
37,12,2,0,0,0,0,0,0,2,12,0,0,0,0,0,0,0,0
37,13,2,0,0,0,0,0,0,1,8,0,0,0,0,0,0,0,0
37,26,45,37,86,823,133,159,59,21,129,278,607,6291,1281,1028,347,909,6898
37,27,76,47,66,1295,137,40,18,38,248,358,492,10938,1443,311,224,1361,11430
37,28,351,210,160,4710,533,572,1848,74,871,1435,1038,36357,4397,3992,14401,4870,37395
37,29,2,0,0,0,0,0,0,1,6,0,0,0,0,0,0,0,0
37,30,432,1067,210,9303,3678,235,255,159,1268,8276,1373,76564,36516,1406,1481,9513,77937
37,40,65,46,1589,1956,211,194,133,12,161,87,2924,3067,396,272,213,3545,5991
37,61,11,0,0,0,0,0,0,5,27,0,0,0,0,0,0,0,0
37,63,3,0,0,0,0,0,0,1,6,0,0,0,0,0,0,0,0
38,12,54,49,91,616,64,102,115,29,171,424,539,5060,597,677,1078,707,5599
38,13,1,0,0,0,0,0,0,1,2,0,0,0,0,0,0,0,0
38,15,8,0,0,0,0,0,0,8,29,0,0,0,0,0,0,0,0
38,20,9,8,19,183,17,0,34,5,31,41,87,1208,123,0,262,202,1295
38,21,17,18,67,421,87,4,21,11,58,115,344,3332,906,40,119,488,3676
38,22,12,10,39,282,104,2,45,4,35,78,350,2516,1219,4,372,321,2866
38,25,29,0,30,94,14,13,20,11,88,0,195,963,152,110,182,124,1158
38,26,1934,3821,4816,48671,4578,8033,4983,595,5257,22037,26793,318704,36203,50659,29855,53487,345497
38,27,21,13,20,476,38,110,20,8,57,61,90,3052,288,705,79,496,3142
38,29,425,0,0,0,0,0,0,115,1075,0,0,0,0,0,0,0,0
38,30,1,0,0,0,0,0,0,1,2,0,0,0,0,0,0,0,0
38,40,31,0,0,0,0,0,0,2,66,0,0,0,0,0,0,0,0
38,44,13,0,0,0,0,0,0,2,28,0,0,0,0,0,0,0,0
38,47,23,0,0,0,0,0,0,3,28,0,0,0,0,0,0,0,0
38,59,3,0,0,0,0,0,0,2,10,0,0,0,0,0,0,0,0
38,63,1,0,0,0,0,0,0,1,2,0,0,0,0,0,0,0,0
39,11,15,4,13,107,9,16,45,8,42,36,130,1116,109,206,506,120,1246
39,15,557,377,1540,8425,731,422,3727,159,1712,3037,12693,74060,6773,4480,34719,9965,86753
39,20,31,49,47,650,181,7,68,18,106,441,361,5900,1929,124,471,697,6261
39,21,3095,2711,9309,60810,10462,761,9395,1427,9266,20906,63083,480427,106509,5883,72589,70119,543510
39,25,85,99,66,1016,157,76,156,34,246,752,432,8573,1528,498,1272,1082,9005
39,29,6,0,0,0,0,0,0,3,14,0,0,0,0,0,0,0,0
39,30,1,0,0,0,0,0,0,1,6,0,0,0,0,0,0,0,0
39,40,1,0,0,0,0,0,0,1,2,0,0,0,0,0,0,0,0
39,41,3,0,0,0,0,0,0,2,11,0,0,0,0,0,0,0,0
39,45,1,0,0,0,0,0,0,1,4,0,0,0,0,0,0,0,0
39,46,2,0,0,0,0,0,0,1,4,0,0,0,0,0,0,0,0
39,56,11,0,0,0,0,0,0,4,34,0,0,0,0,0,0,0,0
39,57,1,0,0,0,0,0,0,1,4,0,0,0,0,0,0,0,0
39,58,4,0,0,0,0,0,0,3,12,0,0,0,0,0,0,0,0
39,62,9,0,0,0,0,0,0,2,23,0,0,0,0,0,0,0,0
39,63,4,0,0,0,0,0,0,2,8,0,0,0,0,0,0,0,0
40,9,114,93,270,2280,140,162,1010,16,255,488,1267,18550,1104,906,7013,2550,19817
40,12,106,30,55,313,71,17,129,14,280,193,389,2815,754,257,1124,368,3204
40,14,6,0,0,0,0,0,0,3,15,0,0,0,0,0,0,0,0
40,15,36,39,96,663,80,63,310,21,122,241,765,5314,731,679,2364,759,6079
40,19,76,83,195,1658,334,22,169,35,237,555,1599,14416,3637,132,1405,1853,16015
40,20,74,49,74,1510,315,38,135,29,199,323,572,12734,3212,309,1046,1584,13306
40,21,249,321,613,4816,745,61,432,89,763,1975,3489,36171,7517,593,3469,5429,39660
40,23,848,915,2070,18416,1847,999,3763,245,2443,6727,14838,137084,16367,5850,29383,20486,151922
40,25,3,0,0,0,0,0,0,1,8,0,0,0,0,0,0,0,0
40,31,1,0,0,0,0,0,0,1,50,0,0,0,0,0,0,0,0
40,34,7,0,0,0,0,0,0,1,12,0,0,0,0,0,0,0,0
40,40,1,0,0,0,0,0,0,1,4,0,0,0,0,0,0,0,0
40,42,1,0,0,0,0,0,0,1,3,0,0,0,0,0,0,0,0
40,56,2,0,0,0,0,0,0,2,8,0,0,0,0,0,0,0,0
40,57,4,0,0,0,0,0,0,3,16,0,0,0,0,0,0,0,0
40,63,1,0,0,0,0,0,0,1,4,0,0,0,0,0,0,0,0
41,7,1,0,0,0,0,0,0,1,2,0,0,0,0,0,0,0,0
41,8,4,0,0,0,0,0,0,3,12,0,0,0,0,0,0,0,0
41,9,55,148,130,1059,130,110,335,34,173,1273,787,8735,1139,795,3336,1189,9522
41,11,91,186,175,1658,401,78,603,43,274,1526,1391,15136,4106,641,5807,1833,16527
41,12,15,10,13,58,2,0,11,8,45,84,125,579,56,0,155,71,704
41,14,7,19,12,115,24,6,20,5,28,120,32,1050,157,48,229,127,1082
41,15,2,0,0,0,0,0,0,1,4,0,0,0,0,0,0,0,0
41,17,12,0,0,0,0,0,0,4,34,0,0,0,0,0,0,0,0
41,19,1386,1585,4031,26609,7991,448,2889,418,4180,13266,30512,218019,81999,2878,21829,30640,248531
41,20,124,143,243,1969,443,36,185,36,355,1023,1639,15607,4594,190,1422,2212,17246
41,29,12,22,942,656,154,50,36,3,69,40,1773,1397,299,90,72,1598,3170
41,34,1,0,0,0,0,0,0,1,3,0,0,0,0,0,0,0,0
41,42,7,0,0,0,0,0,0,4,16,0,0,0,0,0,0,0,0
41,54,1,0,0,0,0,0,0,1,4,0,0,0,0,0,0,0,0
41,55,30,18,121,593,77,66,1,13,109,100,190,1151,147,71,1,714,1341
41,56,50,0,0,0,0,0,0,9,133,0,0,0,0,0,0,0,0
41,57,43,142,1477,5567,282,443,32,9,96,195,2329,6256,393,632,37,7044,8585
41,63,5,0,0,0,0,0,0,1,10,0,0,0,0,0,0,0,0
41,64,6,0,0,0,0,0,0,4,22,0,0,0,0,0,0,0,0
42,7,2,0,0,0,0,0,0,2,8,0,0,0,0,0,0,0,0
42,8,285,367,1075,5113,826,1003,742,144,852,3097,6393,36304,7629,6969,5803,6188,42697
42,13,230,508,1018,5229,964,195,1278,132,804,4315,8127,44065,9619,1468,10953,6247,52192
42,14,98,95,253,1639,251,69,792,56,328,878,2034,15802,2764,508,8018,1892,17836
42,16,432,709,1291,9269,1725,246,503,144,1198,5346,5460,64925,15925,1214,3451,10560,70385
42,17,1591,17436,11612,91350,17686,3069,5569,230,4016,93743,38847,439946,116441,15405,27219,102962,478793
42,18,2483,5802,5003,61501,17972,1961,2952,167,7413,42980,25817,497543,174821,14197,20733,66504,523360
42,19,1963,6152,5654,63853,18700,1938,2587,319,5831,45760,31222,527568,185974,14529,16101,69507,558790
42,22,29,13,23,517,54,21,162,12,71,106,155,4079,621,212,1200,540,4234
42,23,60,65,326,1192,212,68,212,18,182,515,2789,8787,1751,368,1436,1518,11576
42,26,71,105,29,1039,360,51,40,29,193,743,172,7707,3383,292,282,1068,7879
42,41,5,0,0,0,0,0,0,3,16,0,0,0,0,0,0,0,0
42,42,205,284,1404,35282,999,1210,149,31,458,361,1936,37903,1416,1697,169,36686,39839
42,43,5,0,0,0,0,0,0,2,10,0,0,0,0,0,0,0,0
42,47,3,0,0,0,0,0,0,1,5,0,0,0,0,0,0,0,0
42,53,1,0,0,0,0,0,0,1,3,0,0,0,0,0,0,0,0
42,54,47,0,0,0,0,0,0,8,109,0,0,0,0,0,0,0,0
42,55,1,0,0,0,0,0,0,1,2,0,0,0,0,0,0,0,0
42,59,1,0,0,0,0,0,0,1,4,0,0,0,0,0,0,0,0
42,63,2,0,0,0,0,0,0,1,4,0,0,0,0,0,0,0,0
42,64,4,0,0,0,0,0,0,2,11,0,0,0,0,0,0,0,0
42,70,2,0,0,0,0,0,0,1,4,0,0,0,0,0,0,0,0
42,74,2,0,0,0,0,0,0,1,4,0,0,0,0,0,0,0,0
43,7,3,0,0,0,0,0,0,2,8,0,0,0,0,0,0,0,0
43,8,5,0,0,0,0,0,0,2,17,0,0,0,0,0,0,0,0
43,11,1,0,0,0,0,0,0,1,3,0,0,0,0,0,0,0,0
43,12,154,106,323,2774,505,138,781,82,481,866,2754,23504,4881,962,7144,3097,26258
43,13,78,149,194,1580,353,69,264,47,277,1223,1511,12942,3386,590,2239,1774,14453
43,14,4773,16504,47046,309428,31186,18930,10900,2038,12517,74264,119098,912124,150436,51942,48108,356474,1031222
43,15,384,848,1807,16043,2562,898,668,177,1043,3423,5681,67549,14520,3002,2991,17850,73230
43,16,142,218,499,3711,618,187,238,64,393,1121,2637,20514,5136,816,1407,4210,23151
43,18,14,10,33,235,42,16,4,10,48,65,191,1729,328,128,36,268,1920
43,19,567,591,2414,10171,2233,118,1327,253,1633,4177,17204,83728,23487,817,11403,12585,100932
43,20,209,315,788,4183,907,119,410,93,621,2320,5479,31871,9011,680,3068,4971,37350
43,22,186,181,226,4298,299,138,671,50,520,1380,1217,30566,3336,1067,5665,4524,31783
43,23,2,0,0,0,0,0,0,2,4,0,0,0,0,0,0,0,0
43,25,31,33,5,314,96,8,53,11,89,240,30,2189,785,74,350,319,2219
43,26,4,0,0,0,0,0,0,1,8,0,0,0,0,0,0,0,0
43,31,2,0,0,0,0,0,0,1,6,0,0,0,0,0,0,0,0
43,32,7,0,0,0,0,0,0,3,15,0,0,0,0,0,0,0,0
43,38,1,0,0,0,0,0,0,1,3,0,0,0,0,0,0,0,0
43,41,4,0,0,0,0,0,0,2,14,0,0,0,0,0,0,0,0
43,42,4,6,22,243,22,41,5,4,14,6,34,455,52,86,5,265,489
43,56,1,0,0,0,0,0,0,1,3,0,0,0,0,0,0,0,0
43,58,4,0,0,0,0,0,0,3,13,0,0,0,0,0,0,0,0
43,68,2,0,0,0,0,0,0,1,6,0,0,0,0,0,0,0,0
43,71,3,0,0,0,0,0,0,1,6,0,0,0,0,0,0,0,0
44,11,372,492,1098,6334,728,268,3045,86,960,4370,8805,53270,7902,2477,24132,7432,62075
44,14,275,268,909,11680,1132,790,179,200,757,985,3010,39788,5290,2745,648,12589,42798
44,15,218,290,663,10195,1327,765,139,147,620,1358,2206,36923,7407,2541,446,10858,39129
44,16,7,0,6,204,23,53,2,4,22,0,16,1045,222,212,6,210,1061
44,17,2,0,0,0,0,0,0,1,8,0,0,0,0,0,0,0,0
44,19,5,0,0,0,0,0,0,4,16,0,0,0,0,0,0,0,0
44,22,22,20,26,439,158,33,56,9,70,124,102,3739,1616,277,417,465,3841
44,24,70,46,36,1127,331,70,51,28,184,223,311,7968,3044,380,360,1163,8279
44,29,14,0,0,0,0,0,0,6,31,0,0,0,0,0,0,0,0
44,31,2,0,0,0,0,0,0,1,4,0,0,0,0,0,0,0,0
44,34,2,0,0,0,0,0,0,1,4,0,0,0,0,0,0,0,0
44,40,36,123,139,1757,334,247,12,12,79,683,281,4467,744,679,48,1896,4748
44,41,19,0,0,0,0,0,0,4,48,0,0,0,0,0,0,0,0
44,56,4,0,0,0,0,0,0,2,8,0,0,0,0,0,0,0,0
44,60,4,0,0,0,0,0,0,2,9,0,0,0,0,0,0,0,0
44,61,25,0,0,0,0,0,0,2,56,0,0,0,0,0,0,0,0
44,65,1,0,0,0,0,0,0,1,3,0,0,0,0,0,0,0,0
44,66,1,0,0,0,0,0,0,1,2,0,0,0,0,0,0,0,0
44,68,54,0,0,0,0,0,0,2,153,0,0,0,0,0,0,0,0
44,70,3,0,0,0,0,0,0,1,7,0,0,0,0,0,0,0,0
44,71,1,0,0,0,0,0,0,1,3,0,0,0,0,0,0,0,0
44,75,3,0,0,0,0,0,0,1,8,0,0,0,0,0,0,0,0
45,4,77,57,83,801,104,167,291,37,197,517,930,7310,834,1408,3165,884,8240
45,10,2,0,0,0,0,0,0,2,8,0,0,0,0,0,0,0,0
45,11,252,144,667,3707,574,68,1538,128,750,1382,5257,32847,6200,519,13219,4374,38104
45,12,244,283,383,5698,956,121,587,80,712,2261,2381,44576,8687,688,4536,6081,46957
45,13,1074,901,2382,23553,3434,562,3170,451,3182,5889,15393,167809,32245,3243,23785,25935,183202
45,14,22,15,164,465,74,68,9,12,53,24,492,1397,454,131,15,629,1889
45,15,11,0,0,0,0,0,0,2,34,0,0,0,0,0,0,0,0
45,16,7,8,8,148,18,13,0,6,25,118,88,1172,215,115,0,156,1260
45,17,3,0,0,0,0,0,0,1,6,0,0,0,0,0,0,0,0
45,18,25,17,32,431,94,30,18,16,68,174,129,2958,893,118,108,463,3087
45,19,4,0,0,0,0,0,0,4,13,0,0,0,0,0,0,0,0
45,20,193,215,283,2926,1119,42,549,81,598,1843,2130,26493,11712,402,4728,3209,28623
45,21,334,829,666,7080,2450,118,1177,97,885,5698,4339,53797,21370,597,8850,7746,58136
45,23,25,3,7,271,61,12,7,7,67,15,21,1650,339,103,70,278,1671
45,24,10,15,0,130,23,9,14,3,24,50,0,586,118,30,66,130,586
45,28,3,0,0,0,0,0,0,1,6,0,0,0,0,0,0,0,0
45,30,46,0,0,0,0,0,0,3,94,0,0,0,0,0,0,0,0
45,31,3,0,0,0,0,0,0,1,6,0,0,0,0,0,0,0,0
45,32,4,0,0,0,0,0,0,2,8,0,0,0,0,0,0,0,0
45,33,3,0,0,0,0,0,0,1,5,0,0,0,0,0,0,0,0
45,34,1,0,0,0,0,0,0,1,3,0,0,0,0,0,0,0,0
45,37,5,0,0,0,0,0,0,2,10,0,0,0,0,0,0,0,0
45,40,6,3,21,184,25,8,0,4,12,3,35,446,67,14,0,205,481
45,42,14,0,0,0,0,0,0,3,33,0,0,0,0,0,0,0,0
45,49,3,0,0,0,0,0,0,1,6,0,0,0,0,0,0,0,0
45,51,3,0,0,0,0,0,0,3,11,0,0,0,0,0,0,0,0
45,60,1,0,0,0,0,0,0,1,4,0,0,0,0,0,0,0,0
45,61,6,0,0,0,0,0,0,3,18,0,0,0,0,0,0,0,0
45,64,6,0,0,0,0,0,0,2,11,0,0,0,0,0,0,0,0
46,3,1,0,0,0,0,0,0,1,2,0,0,0,0,0,0,0,0
46,10,176,186,164,2787,356,53,1309,76,524,1808,1322,25755,3873,561,12161,2951,27077
46,12,1341,2188,5238,24223,4548,732,4124,423,3595,12863,29283,173830,41912,4116,31944,29461,203113
46,15,1,0,0,0,0,0,0,1,6,0,0,0,0,0,0,0,0
46,16,26,20,30,284,128,16,0,13,74,162,143,2250,1217,72,0,314,2393
46,17,3,0,0,0,0,0,0,3,14,0,0,0,0,0,0,0,0
46,19,7,4,18,74,28,3,3,6,24,16,124,605,294,14,30,92,729
46,20,3,0,0,0,0,0,0,2,8,0,0,0,0,0,0,0,0
46,21,280,199,686,5351,1248,276,769,142,828,1528,4813,44940,13096,2355,6012,6037,49753
46,23,43,69,18,836,158,43,71,10,103,435,68,4935,1089,256,405,854,5003
46,30,146,43,1658,3103,225,1493,125,14,301,104,4282,4695,338,1758,433,4761,8977
46,33,3,0,0,0,0,0,0,2,7,0,0,0,0,0,0,0,0
46,34,27,39,425,737,92,147,24,6,64,57,1171,1624,139,331,31,1162,2795
46,39,5,0,0,0,0,0,0,1,10,0,0,0,0,0,0,0,0
46,50,15,3,25,256,50,36,0,7,40,11,65,832,296,67,0,281,897
46,57,3,0,0,0,0,0,0,1,18,0,0,0,0,0,0,0,0
46,61,17,0,0,0,0,0,0,3,32,0,0,0,0,0,0,0,0
46,62,15,0,0,0,0,0,0,6,33,0,0,0,0,0,0,0,0
46,64,4,0,0,0,0,0,0,1,7,0,0,0,0,0,0,0,0
46,65,39,0,0,0,0,0,0,2,95,0,0,0,0,0,0,0,0
46,67,1,0,0,0,0,0,0,1,6,0,0,0,0,0,0,0,0
46,70,1,0,0,0,0,0,0,1,2,0,0,0,0,0,0,0,0
46,71,11,0,0,0,0,0,0,4,22,0,0,0,0,0,0,0,0
46,74,6,0,0,0,0,0,0,2,28,0,0,0,0,0,0,0,0
46,75,2,0,0,0,0,0,0,1,8,0,0,0,0,0,0,0,0
47,8,4,15,0,54,2,10,9,4,16,182,0,542,14,119,81,54,542
47,9,98,59,185,1653,140,30,965,51,292,411,1462,15231,1648,303,9132,1838,16693
47,10,33,13,46,304,59,4,175,11,111,111,318,2629,640,42,1441,350,2947
47,12,150,208,136,2235,804,57,160,43,365,1235,903,17597,7790,358,1264,2371,18500
47,15,15,0,0,0,0,0,0,8,37,0,0,0,0,0,0,0,0
47,17,5,0,0,0,0,0,0,4,24,0,0,0,0,0,0,0,0
47,18,18,0,0,0,0,0,0,8,51,0,0,0,0,0,0,0,0
47,19,2,0,0,0,0,0,0,1,6,0,0,0,0,0,0,0,0
47,20,6,0,0,0,0,0,0,4,20,0,0,0,0,0,0,0,0
47,22,1,0,0,0,0,0,0,1,6,0,0,0,0,0,0,0,0
47,23,350,358,377,8523,2031,421,2534,37,1015,2102,2759,52193,10488,1673,20834,8900,54952
47,33,8,0,0,0,0,0,0,2,17,0,0,0,0,0,0,0,0
47,42,11,2,2,395,28,44,3,5,25,4,2,650,44,59,30,397,652
47,47,2,0,0,0,0,0,0,1,4,0,0,0,0,0,0,0,0
47,55,2500,0,0,0,0,0,0,1,5000,0,0,0,0,0,0,0,0
47,58,2,0,0,0,0,0,0,1,4,0,0,0,0,0,0,0,0
47,62,1,0,0,0,0,0,0,1,2,0,0,0,0,0,0,0,0
47,63,119,0,0,0,0,0,0,15,348,0,0,0,0,0,0,0,0
47,64,71,0,0,0,0,0,0,6,151,0,0,0,0,0,0,0,0
47,68,5,0,0,0,0,0,0,2,14,0,0,0,0,0,0,0,0
47,70,13,0,0,0,0,0,0,2,27,0,0,0,0,0,0,0,0
47,71,3,0,0,0,0,0,0,1,6,0,0,0,0,0,0,0,0
48,1,3,0,0,0,0,0,0,1,6,0,0,0,0,0,0,0,0
48,8,234,164,479,3512,249,165,2064,78,672,1373,3905,31114,2733,1087,18245,3991,35019
48,9,275,259,653,3122,276,122,1859,85,808,2061,7158,28764,2682,1129,17088,3775,35922
48,10,93,104,53,1117,194,22,279,27,254,980,308,10077,2181,105,2873,1170,10385
48,11,458,267,833,6531,771,157,1626,139,1210,2180,5237,53198,7629,908,14268,7364,58435
48,12,9,0,0,0,0,0,0,3,20,0,0,0,0,0,0,0,0
48,13,29,55,11,540,162,21,4,12,83,310,77,3752,1572,145,16,551,3829
48,16,16,61,15,544,166,22,1,8,46,426,43,4075,1645,96,1,559,4118
48,17,9,0,0,0,0,0,0,4,33,0,0,0,0,0,0,0,0
48,19,26,22,25,495,161,26,6,13,69,83,63,3144,1573,108,52,520,3207
48,22,126,142,111,2454,811,66,170,13,377,688,491,11389,3972,173,1016,2565,11880
48,42,16,0,0,0,0,0,0,4,33,0,0,0,0,0,0,0,0
48,47,21,15,73,1967,171,203,19,13,64,27,162,3446,343,344,21,2040,3608
48,63,1,0,0,0,0,0,0,1,4,0,0,0,0,0,0,0,0
48,65,8,0,0,0,0,0,0,2,17,0,0,0,0,0,0,0,0
48,66,43,77,178,785,127,31,19,4,85,90,299,1033,149,34,25,963,1332
48,67,4,0,0,0,0,0,0,1,8,0,0,0,0,0,0,0,0
48,68,7,0,0,0,0,0,0,3,17,0,0,0,0,0,0,0,0
48,69,1,0,0,0,0,0,0,1,4,0,0,0,0,0,0,0,0
48,77,1,0,0,0,0,0,0,1,2,0,0,0,0,0,0,0,0
48,79,17,0,0,0,0,0,0,1,34,0,0,0,0,0,0,0,0
48,90,8,0,0,0,0,0,0,1,16,0,0,0,0,0,0,0,0
49,7,68,56,161,970,74,5,451,25,202,588,1221,8458,872,26,3960,1131,9679
49,8,282,392,648,4437,586,105,1848,133,865,3363,4499,39607,6084,855,17100,5085,44106
49,9,1771,1292,11064,37773,3409,351,10259,401,4721,10582,70943,287437,34710,3147,78947,48837,358380
49,11,5,0,0,0,0,0,0,3,16,0,0,0,0,0,0,0,0
49,12,20,0,0,0,0,0,0,5,44,0,0,0,0,0,0,0,0
49,13,9,0,0,0,0,0,0,2,18,0,0,0,0,0,0,0,0
49,18,6,0,0,0,0,0,0,3,14,0,0,0,0,0,0,0,0
49,20,94,108,156,2326,418,97,159,37,250,595,720,14104,3109,538,978,2482,14824
49,21,1608,3547,3533,50569,10587,1465,4178,327,4206,17775,14812,287787,61685,5642,21045,54102,302599
49,22,2,0,0,0,0,0,0,1,4,0,0,0,0,0,0,0,0
49,42,7,0,0,0,0,0,0,3,14,0,0,0,0,0,0,0,0
49,46,4,0,0,0,0,0,0,2,16,0,0,0,0,0,0,0,0
49,53,5,0,0,0,0,0,0,1,12,0,0,0,0,0,0,0,0
49,57,2,0,0,0,0,0,0,2,7,0,0,0,0,0,0,0,0
49,62,1,0,0,0,0,0,0,1,2,0,0,0,0,0,0,0,0
49,63,1,0,0,0,0,0,0,1,5,0,0,0,0,0,0,0,0
49,64,16,0,0,0,0,0,0,4,35,0,0,0,0,0,0,0,0
49,65,258,391,1942,10183,1079,325,182,29,680,477,3912,13520,1682,464,331,12125,17432
49,66,24,0,0,0,0,0,0,4,49,0,0,0,0,0,0,0,0
49,68,17,0,0,0,0,0,0,4,35,0,0,0,0,0,0,0,0
49,75,5,0,0,0,0,0,0,1,32,0,0,0,0,0,0,0,0
49,89,3,0,0,0,0,0,0,1,6,0,0,0,0,0,0,0,0
49,90,3,0,0,0,0,0,0,1,5,0,0,0,0,0,0,0,0
50,6,1,0,0,0,0,0,0,1,4,0,0,0,0,0,0,0,0
50,7,61,0,0,0,0,0,0,2,184,0,0,0,0,0,0,0,0
50,8,4132,8152,26452,125441,13979,4038,22742,683,10995,41507,124722,718978,96169,17535,158451,151893,843700
50,9,232,242,809,5004,678,45,557,85,652,1713,5049,38388,6788,292,3811,5813,43437
50,10,1,0,0,0,0,0,0,1,6,0,0,0,0,0,0,0,0
50,11,5,0,0,0,0,0,0,1,10,0,0,0,0,0,0,0,0
50,12,2,0,0,0,0,0,0,1,4,0,0,0,0,0,0,0,0
50,13,4,0,0,0,0,0,0,1,8,0,0,0,0,0,0,0,0
50,14,13,0,0,0,0,0,0,2,27,0,0,0,0,0,0,0,0
50,17,3,0,0,0,0,0,0,2,9,0,0,0,0,0,0,0,0
50,18,284,372,1060,8687,2539,289,868,107,768,1949,6040,43878,18985,1002,6196,9747,49918
50,19,6,15,17,138,71,0,9,4,16,100,72,1098,674,0,78,155,1170
50,20,13,0,0,0,0,0,0,8,36,0,0,0,0,0,0,0,0
50,21,534,918,764,12216,3444,408,786,133,1437,5582,4329,72761,22529,1476,4379,12980,77090
50,23,1,0,0,0,0,0,0,1,6,0,0,0,0,0,0,0,0
50,42,3,0,0,0,0,0,0,1,6,0,0,0,0,0,0,0,0
50,45,1,0,0,0,0,0,0,1,2,0,0,0,0,0,0,0,0
50,52,187,305,1541,17674,755,871,101,87,498,521,2351,25828,1323,1488,133,19215,28179
50,53,67,0,0,0,0,0,0,5,139,0,0,0,0,0,0,0,0
50,55,1,0,0,0,0,0,0,1,3,0,0,0,0,0,0,0,0
50,56,4,0,0,0,0,0,0,1,8,0,0,0,0,0,0,0,0
50,62,9,0,0,0,0,0,0,2,28,0,0,0,0,0,0,0,0
50,63,11,0,0,0,0,0,0,2,28,0,0,0,0,0,0,0,0
50,64,2,0,0,0,0,0,0,1,4,0,0,0,0,0,0,0,0
50,72,12,0,0,0,0,0,0,2,24,0,0,0,0,0,0,0,0
50,73,15,0,0,0,0,0,0,1,34,0,0,0,0,0,0,0,0
50,75,2,0,0,0,0,0,0,1,4,0,0,0,0,0,0,0,0
50,77,10,0,0,0,0,0,0,3,50,0,0,0,0,0,0,0,0
50,88,18,0,0,0,0,0,0,1,49,0,0,0,0,0,0,0,0
50,93,2,0,0,0,0,0,0,1,4,0,0,0,0,0,0,0,0
51,5,6,11,24,103,12,10,29,4,18,35,142,801,135,54,195,127,943
51,7,2422,3733,5753,50893,9779,2122,13102,342,6877,28080,42616,389035,85603,15605,97494,56646,431651
51,8,197,0,18,122,41,8,2,8,642,0,137,1119,474,92,14,140,1256
51,10,56,55,155,661,217,11,17,19,142,372,1110,6137,2409,79,202,816,7247
51,11,13,0,23,27,1,0,0,5,32,0,163,78,2,0,0,50,241
51,12,7,0,0,0,0,0,0,3,22,0,0,0,0,0,0,0,0
51,13,13,0,0,0,0,0,0,3,27,0,0,0,0,0,0,0,0
51,15,11,0,0,0,0,0,0,5,30,0,0,0,0,0,0,0,0
51,17,2,0,0,0,0,0,0,1,4,0,0,0,0,0,0,0,0
51,18,1,0,0,0,0,0,0,1,4,0,0,0,0,0,0,0,0
51,19,23,38,8,215,89,0,6,8,53,254,28,1777,766,0,38,223,1805
51,21,5,7,0,97,47,0,12,3,12,69,0,954,579,0,94,97,954
51,42,3,0,0,0,0,0,0,2,6,0,0,0,0,0,0,0,0
51,44,90,228,400,9506,531,351,52,21,188,405,627,14896,1075,627,86,9906,15523
51,45,59,145,77,7086,703,761,35,27,150,251,112,11691,1421,1286,44,7163,11803
51,48,10,29,65,598,63,56,0,4,22,73,111,1270,205,93,0,663,1381
51,50,2,0,0,0,0,0,0,2,5,0,0,0,0,0,0,0,0
51,51,1,0,0,0,0,0,0,1,2,0,0,0,0,0,0,0,0
51,52,5,0,0,0,0,0,0,3,15,0,0,0,0,0,0,0,0
51,53,2,0,0,0,0,0,0,2,6,0,0,0,0,0,0,0,0
51,62,8,0,95,248,8,41,0,3,20,0,171,295,8,52,0,343,466
51,63,1,0,0,0,0,0,0,1,2,0,0,0,0,0,0,0,0
51,72,93,0,0,0,0,0,0,1,186,0,0,0,0,0,0,0,0
51,74,16,0,0,0,0,0,0,2,32,0,0,0,0,0,0,0,0
51,78,6,0,0,0,0,0,0,3,12,0,0,0,0,0,0,0,0
51,81,2,0,0,0,0,0,0,1,4,0,0,0,0,0,0,0,0
51,87,7,0,0,0,0,0,0,1,12,0,0,0,0,0,0,0,0
51,88,1,0,0,0,0,0,0,1,2,0,0,0,0,0,0,0,0
51,89,1,0,0,0,0,0,0,1,2,0,0,0,0,0,0,0,0
51,91,1,0,0,0,0,0,0,1,2,0,0,0,0,0,0,0,0
51,92,6,0,0,0,0,0,0,1,8,0,0,0,0,0,0,0,0
52,6,47,48,103,1142,125,17,166,13,115,411,791,9852,1444,185,1354,1245,10643
52,7,957,1664,1505,16111,3767,437,1667,227,2571,13069,10905,125264,33751,2980,12354,17616,136169
52,9,24,33,101,389,122,60,21,5,52,147,227,2118,1142,222,68,490,2345
52,14,2,0,0,0,0,0,0,1,3,0,0,0,0,0,0,0,0
52,15,4,0,0,0,0,0,0,1,9,0,0,0,0,0,0,0,0
52,16,1,0,0,0,0,0,0,1,4,0,0,0,0,0,0,0,0
52,17,12,5,10,139,45,0,4,8,37,20,49,870,332,0,28,149,919
52,18,207,370,493,5195,1530,167,489,54,591,1743,2176,26472,10081,566,2297,5688,28648
52,19,335,376,539,7166,2612,106,498,155,1005,2834,3429,59354,27613,650,3636,7705,62783
52,21,194,0,0,0,0,0,0,73,567,0,0,0,0,0,0,0,0
52,26,2,0,0,0,0,0,0,1,4,0,0,0,0,0,0,0,0
52,27,2,0,0,0,0,0,0,1,4,0,0,0,0,0,0,0,0
52,29,32,0,0,0,0,0,0,1,64,0,0,0,0,0,0,0,0
52,43,635,3795,5280,131448,7460,7064,972,75,1418,6088,7660,167740,12722,10003,1091,136728,175400
52,44,90,252,115,8947,682,466,23,23,195,423,165,13036,1265,707,28,9062,13201
52,45,106,166,91,7861,724,613,54,36,248,318,152,13303,1492,999,73,7952,13455
52,46,828,496,736,20407,1300,1547,106,71,2333,880,1297,31677,2647,2606,123,21143,32974
52,47,393,1936,1447,50517,9870,4312,296,51,962,3343,1913,86904,19091,7505,454,51964,88817
52,48,118,332,487,12616,1094,1066,61,33,301,580,946,20190,2155,1792,89,13103,21136
52,49,18,34,38,1246,151,135,12,9,48,82,55,2352,346,275,20,1284,2407
52,50,1,0,0,0,0,0,0,1,2,0,0,0,0,0,0,0,0
52,51,1,0,0,0,0,0,0,1,2,0,0,0,0,0,0,0,0
52,52,3,0,0,0,0,0,0,2,9,0,0,0,0,0,0,0,0
52,74,2,0,0,0,0,0,0,1,4,0,0,0,0,0,0,0,0
52,75,1,0,0,0,0,0,0,1,3,0,0,0,0,0,0,0,0
52,76,11,0,0,0,0,0,0,4,24,0,0,0,0,0,0,0,0
52,77,67,0,0,0,0,0,0,16,152,0,0,0,0,0,0,0,0
52,78,27,0,0,0,0,0,0,3,52,0,0,0,0,0,0,0,0
52,81,7,0,0,0,0,0,0,2,15,0,0,0,0,0,0,0,0
52,86,1,0,0,0,0,0,0,1,4,0,0,0,0,0,0,0,0
52,87,17,0,0,0,0,0,0,5,31,0,0,0,0,0,0,0,0
52,88,1,0,0,0,0,0,0,1,3,0,0,0,0,0,0,0,0
53,6,48,52,216,818,118,0,97,22,115,364,1525,6611,1126,0,802,1034,8136
53,11,6,0,0,0,0,0,0,1,12,0,0,0,0,0,0,0,0
53,15,3,0,2,76,6,6,0,3,8,0,10,369,66,24,0,78,379
53,16,101,113,269,1612,679,17,144,61,302,819,2070,14229,7133,123,1182,1881,16299
53,17,6,0,19,66,20,0,12,6,22,0,127,423,102,0,84,85,550
53,18,1,0,0,0,0,0,0,1,2,0,0,0,0,0,0,0,0
53,32,2,0,0,0,0,0,0,1,4,0,0,0,0,0,0,0,0
53,35,3,0,0,0,0,0,0,1,6,0,0,0,0,0,0,0,0
53,41,12,0,0,0,0,0,0,4,29,0,0,0,0,0,0,0,0
53,42,38,121,68,3988,450,425,21,13,97,224,76,6167,803,699,24,4056,6243
53,43,107,416,155,10471,1147,1126,77,32,243,786,228,16722,2055,1834,103,10626,16950
53,45,7,0,0,0,0,0,0,3,18,0,0,0,0,0,0,0,0
53,46,147,471,260,12382,1330,1205,84,55,384,830,539,20192,2553,2025,140,12642,20731
53,47,57,186,74,5780,575,655,23,16,165,336,107,10277,1124,1181,38,5854,10384
53,48,7,12,84,688,59,37,6,5,19,31,172,1318,162,56,7,772,1490
53,51,2,0,0,0,0,0,0,1,2,0,0,0,0,0,0,0,0
53,60,16,0,0,0,0,0,0,2,40,0,0,0,0,0,0,0,0
53,73,3,0,0,0,0,0,0,1,8,0,0,0,0,0,0,0,0
53,74,2,0,0,0,0,0,0,1,4,0,0,0,0,0,0,0,0
53,76,3,0,0,0,0,0,0,1,4,0,0,0,0,0,0,0,0
53,77,2,0,0,0,0,0,0,1,4,0,0,0,0,0,0,0,0
53,78,4,0,0,0,0,0,0,1,12,0,0,0,0,0,0,0,0
53,80,61,0,0,0,0,0,0,2,111,0,0,0,0,0,0,0,0
53,87,329,0,0,0,0,0,0,13,697,0,0,0,0,0,0,0,0
53,88,9,0,0,0,0,0,0,4,16,0,0,0,0,0,0,0,0
53,90,18,0,0,0,0,0,0,1,38,0,0,0,0,0,0,0,0
54,4,2604,4740,9108,47789,9957,3758,9881,751,7370,38446,60412,388505,101130,26738,80119,56897,448917
54,9,1,0,0,0,0,0,0,1,4,0,0,0,0,0,0,0,0
54,10,1,0,0,0,0,0,0,1,2,0,0,0,0,0,0,0,0
54,11,7,0,0,0,0,0,0,2,14,0,0,0,0,0,0,0,0
54,12,10,0,0,0,0,0,0,3,19,0,0,0,0,0,0,0,0
54,15,2,0,0,0,0,0,0,1,4,0,0,0,0,0,0,0,0
54,16,258,207,934,3903,788,60,563,134,767,1429,6165,29578,7189,444,4244,4837,35743
54,17,267,305,673,5630,1524,62,1287,150,966,2081,4129,44425,15054,380,10144,6303,48554
54,18,2,0,0,0,0,0,0,2,8,0,0,0,0,0,0,0,0
54,24,12,0,0,0,0,0,0,2,53,0,0,0,0,0,0,0,0
54,35,2,0,0,0,0,0,0,1,5,0,0,0,0,0,0,0,0
54,39,287,280,458,13524,985,1395,159,41,772,486,699,19635,1709,2241,181,13982,20334
54,40,91,185,104,6927,547,904,35,29,214,327,203,12470,1124,1559,50,7031,12673
54,41,14,0,0,0,0,0,0,3,28,0,0,0,0,0,0,0,0
54,43,18,0,0,0,0,0,0,5,76,0,0,0,0,0,0,0,0
54,44,4,0,0,0,0,0,0,3,12,0,0,0,0,0,0,0,0
54,45,3,0,0,0,0,0,0,2,8,0,0,0,0,0,0,0,0
54,46,5,0,0,0,0,0,0,2,10,0,0,0,0,0,0,0,0
54,47,7,0,0,0,0,0,0,4,20,0,0,0,0,0,0,0,0
54,49,3,0,0,0,0,0,0,2,13,0,0,0,0,0,0,0,0
54,76,6,0,0,0,0,0,0,1,10,0,0,0,0,0,0,0,0
54,77,15,0,0,0,0,0,0,3,26,0,0,0,0,0,0,0,0
54,78,28,0,0,0,0,0,0,3,48,0,0,0,0,0,0,0,0
54,80,11,0,0,0,0,0,0,4,21,0,0,0,0,0,0,0,0
54,84,1,0,0,0,0,0,0,1,2,0,0,0,0,0,0,0,0
54,88,216,0,0,0,0,0,0,30,392,0,0,0,0,0,0,0,0
54,92,4,0,0,0,0,0,0,1,8,0,0,0,0,0,0,0,0
55,3,1056,2045,2848,24160,5421,1516,4783,236,3017,17594,18803,198976,57512,11764,36567,27008,217779
55,4,1502,1543,2211,18941,3461,868,1541,229,4258,12098,14022,123702,32836,5186,11289,21152,137724
55,5,54,42,20,762,248,44,45,7,167,260,148,4745,1888,218,190,782,4893
55,8,4,0,0,0,0,0,0,1,8,0,0,0,0,0,0,0,0
55,18,7,0,0,0,0,0,0,3,20,0,0,0,0,0,0,0,0
55,19,5,0,0,0,0,0,0,2,9,0,0,0,0,0,0,0,0
55,25,12,0,0,0,0,0,0,6,32,0,0,0,0,0,0,0,0
55,38,295,0,0,0,0,0,0,68,699,0,0,0,0,0,0,0,0
55,39,10,0,0,0,0,0,0,4,24,0,0,0,0,0,0,0,0
55,44,43,0,0,0,0,0,0,3,130,0,0,0,0,0,0,0,0
55,45,2,0,0,0,0,0,0,1,8,0,0,0,0,0,0,0,0
55,70,31,0,0,0,0,0,0,15,90,0,0,0,0,0,0,0,0
55,77,56,0,0,0,0,0,0,2,163,0,0,0,0,0,0,0,0
55,79,1,0,0,0,0,0,0,1,4,0,0,0,0,0,0,0,0
55,80,27,0,0,0,0,0,0,2,59,0,0,0,0,0,0,0,0
55,85,9,0,0,0,0,0,0,2,17,0,0,0,0,0,0,0,0
55,86,10,0,0,0,0,0,0,1,10,0,0,0,0,0,0,0,0
55,87,3,0,0,0,0,0,0,2,6,0,0,0,0,0,0,0,0
55,89,14,0,0,0,0,0,0,2,30,0,0,0,0,0,0,0,0
55,90,9,0,0,0,0,0,0,2,29,0,0,0,0,0,0,0,0
55,91,19,18,254,808,77,11,20,6,57,22,790,980,86,15,24,1062,1770
55,92,4,0,0,0,0,0,0,2,9,0,0,0,0,0,0,0,0
56,3,232,422,313,3311,801,243,477,62,583,3792,2510,29507,9512,2698,3864,3624,32017
56,4,1465,1418,6357,22788,2950,449,6395,425,4091,10175,46601,160622,28375,2655,46568,29145,207223
56,5,71,158,74,1053,197,12,114,14,195,1036,410,8829,2362,19,1490,1127,9239
56,6,6,0,0,0,0,0,0,4,14,0,0,0,0,0,0,0,0
56,7,5,0,0,0,0,0,0,2,11,0,0,0,0,0,0,0,0
56,8,10,0,0,0,0,0,0,4,24,0,0,0,0,0,0,0,0
56,10,2,0,0,0,0,0,0,1,4,0,0,0,0,0,0,0,0
56,12,9,0,0,0,0,0,0,3,19,0,0,0,0,0,0,0,0
56,13,1,0,0,0,0,0,0,1,4,0,0,0,0,0,0,0,0
56,24,8,0,0,0,0,0,0,2,24,0,0,0,0,0,0,0,0
56,37,8,0,0,0,0,0,0,1,17,0,0,0,0,0,0,0,0
56,47,1,0,0,0,0,0,0,1,2,0,0,0,0,0,0,0,0
56,70,10,0,0,0,0,0,0,3,22,0,0,0,0,0,0,0,0
56,74,2,0,0,0,0,0,0,1,6,0,0,0,0,0,0,0,0
56,76,118,0,0,0,0,0,0,4,308,0,0,0,0,0,0,0,0
56,78,140,10,88,190,18,6,4,7,280,12,159,352,35,10,6,278,511
56,79,2,0,0,0,0,0,0,2,4,0,0,0,0,0,0,0,0
56,84,2,0,0,0,0,0,0,1,4,0,0,0,0,0,0,0,0
56,86,19,0,0,0,0,0,0,1,43,0,0,0,0,0,0,0,0
56,88,15,0,0,0,0,0,0,5,30,0,0,0,0,0,0,0,0
56,89,5,0,0,0,0,0,0,1,10,0,0,0,0,0,0,0,0
56,91,6,0,0,0,0,0,0,3,19,0,0,0,0,0,0,0,0
56,93,8,0,0,0,0,0,0,3,16,0,0,0,0,0,0,0,0
56,95,4,0,0,0,0,0,0,1,8,0,0,0,0,0,0,0,0
57,3,1,0,0,0,0,0,0,1,2,0,0,0,0,0,0,0,0
57,7,6,0,0,0,0,0,0,2,14,0,0,0,0,0,0,0,0
57,8,6,0,0,0,0,0,0,2,12,0,0,0,0,0,0,0,0
57,11,11,0,0,0,0,0,0,3,22,0,0,0,0,0,0,0,0
57,18,5,0,0,0,0,0,0,1,10,0,0,0,0,0,0,0,0
57,23,4,0,0,0,0,0,0,2,8,0,0,0,0,0,0,0,0
57,31,5,0,0,0,0,0,0,2,10,0,0,0,0,0,0,0,0
57,73,3,0,0,0,0,0,0,2,10,0,0,0,0,0,0,0,0
57,75,3,0,0,0,0,0,0,1,6,0,0,0,0,0,0,0,0
57,77,11,22,101,214,16,5,18,7,30,51,867,811,56,18,36,315,1678
57,78,268,86,752,2070,108,555,85,27,533,209,1157,3429,228,654,114,2822,4586
57,79,7,0,0,0,0,0,0,6,26,0,0,0,0,0,0,0,0
57,80,1,0,0,0,0,0,0,1,3,0,0,0,0,0,0,0,0
57,84,254,0,0,0,0,0,0,7,424,0,0,0,0,0,0,0,0
57,85,55,0,0,0,0,0,0,2,126,0,0,0,0,0,0,0,0
57,88,13,0,0,0,0,0,0,2,27,0,0,0,0,0,0,0,0
57,89,8,0,0,0,0,0,0,1,14,0,0,0,0,0,0,0,0
57,92,1,0,0,0,0,0,0,1,2,0,0,0,0,0,0,0,0
57,95,129,0,0,0,0,0,0,2,247,0,0,0,0,0,0,0,0
58,0,76,126,195,955,114,106,233,38,212,1000,1410,7584,1048,841,1804,1150,8994
58,2,1022,1655,3164,19777,2693,472,1528,406,2854,10860,20713,154700,25795,3439,11655,22941,175413
58,3,4,0,0,0,0,0,0,2,10,0,0,0,0,0,0,0,0
58,4,4,0,0,0,0,0,0,1,7,0,0,0,0,0,0,0,0
58,5,2,0,0,0,0,0,0,2,8,0,0,0,0,0,0,0,0
58,6,4,0,0,0,0,0,0,1,8,0,0,0,0,0,0,0,0
58,10,3,0,0,0,0,0,0,1,7,0,0,0,0,0,0,0,0
58,18,21,0,0,0,0,0,0,3,64,0,0,0,0,0,0,0,0
58,30,3,0,0,0,0,0,0,1,6,0,0,0,0,0,0,0,0
58,37,2,0,0,0,0,0,0,1,4,0,0,0,0,0,0,0,0
58,59,3,0,0,0,0,0,0,1,6,0,0,0,0,0,0,0,0
58,76,4,0,0,0,0,0,0,1,12,0,0,0,0,0,0,0,0
58,77,148,56,1016,1483,134,38,169,21,343,126,1808,3265,343,109,329,2499,5073
58,78,535,312,3520,13901,868,669,506,104,1168,709,7474,32616,2160,1840,933,17421,40090
58,79,59,93,818,2428,192,142,59,22,140,153,2135,4849,371,222,85,3246,6984
58,80,2,0,0,0,0,0,0,2,8,0,0,0,0,0,0,0,0
58,82,59,0,0,0,0,0,0,2,111,0,0,0,0,0,0,0,0
58,84,54,0,0,0,0,0,0,4,117,0,0,0,0,0,0,0,0
58,85,6,0,0,0,0,0,0,3,15,0,0,0,0,0,0,0,0
58,87,10,0,0,0,0,0,0,2,20,0,0,0,0,0,0,0,0
58,89,2,0,0,0,0,0,0,1,4,0,0,0,0,0,0,0,0
59,1,53,93,169,661,58,52,127,35,139,820,1542,5774,540,610,957,830,7316
59,2,5293,11052,35251,149563,17801,3660,13538,1378,13269,57840,134315,830100,130013,16272,75230,184814,964415
59,3,106,77,428,1549,287,31,118,53,290,491,3241,11476,2549,236,814,1977,14717
59,4,1,0,0,0,0,0,0,1,2,0,0,0,0,0,0,0,0
59,5,1,0,0,0,0,0,0,1,6,0,0,0,0,0,0,0,0
59,7,6,0,0,0,0,0,0,4,18,0,0,0,0,0,0,0,0
59,8,1,0,0,0,0,0,0,1,4,0,0,0,0,0,0,0,0
59,19,1,0,0,0,0,0,0,1,4,0,0,0,0,0,0,0,0
59,26,4,0,0,0,0,0,0,1,13,0,0,0,0,0,0,0,0
59,64,2,0,0,0,0,0,0,1,4,0,0,0,0,0,0,0,0
59,73,2,0,0,0,0,0,0,1,3,0,0,0,0,0,0,0,0
59,75,12,0,0,0,0,0,0,2,22,0,0,0,0,0,0,0,0
59,76,150,0,0,0,0,0,0,1,295,0,0,0,0,0,0,0,0
59,77,25,23,422,650,29,35,83,15,60,29,707,1125,38,52,123,1072,1832
59,78,279,1010,5515,23131,1479,1041,734,115,590,1730,10162,48097,2908,2052,1151,28646,58259
59,79,9074,25973,139540,817613,47974,47584,19710,1559,18738,42689,248145,1463664,91219,92931,31725,957153,1711809
59,80,47,9,95,305,24,17,4,9,98,20,150,612,65,27,4,400,762
59,84,5,0,0,0,0,0,0,1,8,0,0,0,0,0,0,0,0
59,85,21,0,0,0,0,0,0,4,42,0,0,0,0,0,0,0,0
59,93,7,0,0,0,0,0,0,1,14,0,0,0,0,0,0,0,0
59,94,1,0,0,0,0,0,0,1,3,0,0,0,0,0,0,0,0
59,95,1,0,0,0,0,0,0,1,3,0,0,0,0,0,0,0,0
60,1,143,50,589,640,159,31,50,40,421,350,5158,5410,1398,304,427,1229,10568
60,2,1198,1255,2919,28640,2746,280,3590,412,3289,8904,18981,210316,26297,2210,26178,31559,229297
60,3,71,116,213,1777,368,85,69,34,192,687,993,9768,3229,350,419,1990,10761
60,4,2,0,0,0,0,0,0,2,4,0,0,0,0,0,0,0,0
60,7,4,0,0,0,0,0,0,1,12,0,0,0,0,0,0,0,0
60,8,1,0,0,0,0,0,0,1,4,0,0,0,0,0,0,0,0
60,23,25,7,119,373,41,76,16,11,61,13,484,748,80,266,20,492,1232
60,24,1,0,0,0,0,0,0,1,4,0,0,0,0,0,0,0,0
60,59,176,98,9627,7729,115,141,928,23,294,249,36577,13121,448,399,2473,17356,49698
60,60,3,0,0,0,0,0,0,1,7,0,0,0,0,0,0,0,0
60,66,1,0,0,0,0,0,0,1,1,0,0,0,0,0,0,0,0
60,67,1,0,0,0,0,0,0,1,2,0,0,0,0,0,0,0,0
60,76,62,0,0,0,0,0,0,6,118,0,0,0,0,0,0,0,0
60,77,1,0,0,0,0,0,0,1,3,0,0,0,0,0,0,0,0
60,78,16,0,46,45,2,0,7,6,51,0,139,263,3,0,10,91,402
60,79,17,6,88,144,12,8,4,8,46,29,289,615,27,38,15,232,904
60,80,12,0,0,0,0,0,0,5,23,0,0,0,0,0,0,0,0
60,84,1,0,0,0,0,0,0,1,2,0,0,0,0,0,0,0,0
60,86,10,0,0,0,0,0,0,1,20,0,0,0,0,0,0,0,0
60,89,4,0,0,0,0,0,0,1,8,0,0,0,0,0,0,0,0
60,96,4,0,0,0,0,0,0,1,9,0,0,0,0,0,0,0,0
60,97,1,0,0,0,0,0,0,1,2,0,0,0,0,0,0,0,0
60,98,1,0,0,0,0,0,0,1,2,0,0,0,0,0,0,0,0
61,0,265,140,882,8013,784,266,147,48,756,927,5483,32231,3650,1392,880,8895,37714
61,1,47,54,35,689,246,6,80,24,140,512,357,7134,3142,35,671,724,7491
61,2,5,0,0,0,0,0,0,3,10,0,0,0,0,0,0,0,0
61,3,38,0,0,0,0,0,0,1,64,0,0,0,0,0,0,0,0
61,4,75,67,110,1121,550,28,68,40,218,917,775,10267,6125,135,598,1231,11042
61,6,3,0,0,0,0,0,0,2,10,0,0,0,0,0,0,0,0
61,26,2,0,0,0,0,0,0,1,6,0,0,0,0,0,0,0,0
61,66,1,0,0,0,0,0,0,1,4,0,0,0,0,0,0,0,0
61,71,6,0,0,0,0,0,0,2,11,0,0,0,0,0,0,0,0
61,75,19,4,3,20,2,0,0,8,42,4,3,31,2,0,0,23,34
61,76,142,118,2146,9690,419,230,287,25,271,139,2842,13248,574,299,486,11836,16090
61,77,4,0,0,0,0,0,0,1,8,0,0,0,0,0,0,0,0
61,78,5,0,0,0,0,0,0,1,10,0,0,0,0,0,0,0,0
61,79,10,0,0,0,0,0,0,3,26,0,0,0,0,0,0,0,0
61,80,30,0,0,0,0,0,0,4,236,0,0,0,0,0,0,0,0
61,87,8,0,0,0,0,0,0,2,16,0,0,0,0,0,0,0,0
61,95,18,0,0,0,0,0,0,1,45,0,0,0,0,0,0,0,0
61,99,1,0,0,0,0,0,0,1,2,0,0,0,0,0,0,0,0
62,0,44,33,98,861,142,27,102,14,119,226,466,5189,1196,96,422,959,5655
62,1,42,4,49,481,44,16,39,13,91,18,426,3027,212,59,350,530,3453
62,2,3783,13211,34472,183421,28793,7555,6625,666,9276,70310,100895,890432,186431,28489,32015,217893,991327
62,3,45,31,63,976,168,25,47,21,122,171,309,5652,1188,69,307,1039,5961
62,4,124,193,329,3420,805,153,196,68,319,1140,1834,18429,6737,651,1289,3749,20263
62,5,7,9,8,452,39,35,8,4,17,13,26,862,86,68,9,460,888
62,6,7,0,0,0,0,0,0,4,20,0,0,0,0,0,0,0,0
62,9,2,0,0,0,0,0,0,1,4,0,0,0,0,0,0,0,0
62,32,14,0,0,0,0,0,0,5,36,0,0,0,0,0,0,0,0
62,65,3,0,0,0,0,0,0,1,6,0,0,0,0,0,0,0,0
62,69,4,0,0,0,0,0,0,1,8,0,0,0,0,0,0,0,0
62,75,53,0,0,0,0,0,0,5,93,0,0,0,0,0,0,0,0
62,76,7,0,0,0,0,0,0,2,16,0,0,0,0,0,0,0,0
62,78,29,0,0,0,0,0,0,2,55,0,0,0,0,0,0,0,0
62,79,138,947,4857,7203,674,680,228,11,280,1717,7807,11757,1423,1298,342,12060,19564
62,80,25,0,0,0,0,0,0,3,38,0,0,0,0,0,0,0,0
62,86,78,0,0,0,0,0,0,9,156,0,0,0,0,0,0,0,0
63,0,55,45,140,740,127,39,24,13,123,212,515,4413,943,224,106,880,4928
63,1,41,39,152,1346,135,151,11,35,116,131,763,5007,728,582,64,1498,5770
63,2,33,18,71,638,51,75,18,25,109,67,435,1717,153,209,71,709,2152
63,3,20,11,67,561,101,27,2,12,58,12,541,1820,688,56,6,628,2361
63,4,34,0,0,0,0,0,0,3,98,0,0,0,0,0,0,0,0
63,5,248,959,2019,16365,2303,1054,388,68,656,1744,5756,31033,4658,1907,814,18384,36789
63,6,7,0,0,0,0,0,0,3,16,0,0,0,0,0,0,0,0
63,8,4,0,0,0,0,0,0,1,12,0,0,0,0,0,0,0,0
63,61,8,0,0,0,0,0,0,1,16,0,0,0,0,0,0,0,0
63,74,12,0,0,0,0,0,0,1,24,0,0,0,0,0,0,0,0
63,75,1,0,0,0,0,0,0,1,3,0,0,0,0,0,0,0,0
63,79,66,0,0,0,0,0,0,2,116,0,0,0,0,0,0,0,0
63,80,2,0,0,0,0,0,0,1,4,0,0,0,0,0,0,0,0
63,81,22,0,0,0,0,0,0,3,43,0,0,0,0,0,0,0,0
63,96,59,0,0,0,0,0,0,3,139,0,0,0,0,0,0,0,0
63,98,11,0,0,0,0,0,0,1,18,0,0,0,0,0,0,0,0
64,0,570,304,921,11302,1390,288,733,241,1610,2326,7041,91428,13996,2364,6010,12223,98469
64,1,1,0,0,0,0,0,0,1,4,0,0,0,0,0,0,0,0
64,2,12,54,30,409,192,13,0,12,60,434,209,3825,2025,65,0,439,4034
64,3,124,436,1048,18318,2297,600,119,31,294,709,1706,28508,5169,958,264,19366,30214
64,4,9,10,13,230,34,19,1,5,22,22,14,440,138,21,1,243,454
64,6,1,0,0,0,0,0,0,1,4,0,0,0,0,0,0,0,0
64,76,9,1,12,48,1,5,4,4,21,1,22,71,4,5,5,60,93
64,83,1,0,0,0,0,0,0,1,2,0,0,0,0,0,0,0,0
64,86,2,0,0,0,0,0,0,2,6,0,0,0,0,0,0,0,0
64,90,1,0,0,0,0,0,0,1,2,0,0,0,0,0,0,0,0
64,91,2,0,0,0,0,0,0,1,4,0,0,0,0,0,0,0,0
64,103,5,0,0,0,0,0,0,3,12,0,0,0,0,0,0,0,0
64,104,1,0,0,0,0,0,0,1,2,0,0,0,0,0,0,0,0
65,0,11,29,34,288,88,38,2,8,35,155,66,1622,683,130,2,322,1688
65,4,6,0,0,0,0,0,0,4,21,0,0,0,0,0,0,0,0
65,5,3,0,0,0,0,0,0,2,10,0,0,0,0,0,0,0,0
65,6,16,14,55,312,75,28,0,5,45,36,69,942,319,85,0,367,1011
65,7,9,0,0,0,0,0,0,4,22,0,0,0,0,0,0,0,0
65,8,20,0,0,0,0,0,0,4,39,0,0,0,0,0,0,0,0
65,10,3,0,0,0,0,0,0,3,17,0,0,0,0,0,0,0,0
65,11,1,0,0,0,0,0,0,1,4,0,0,0,0,0,0,0,0
65,71,1,0,0,0,0,0,0,1,5,0,0,0,0,0,0,0,0
65,79,31,0,0,0,0,0,0,2,66,0,0,0,0,0,0,0,0
65,84,2,0,0,0,0,0,0,1,3,0,0,0,0,0,0,0,0
65,90,5,0,0,0,0,0,0,1,10,0,0,0,0,0,0,0,0
65,104,10,0,0,0,0,0,0,4,24,0,0,0,0,0,0,0,0
65,105,2,0,0,0,0,0,0,2,10,0,0,0,0,0,0,0,0
66,0,7,0,39,93,5,4,0,4,18,0,259,573,21,36,0,132,832
66,1,1,0,0,0,0,0,0,1,6,0,0,0,0,0,0,0,0
66,3,10,0,0,0,0,0,0,1,20,0,0,0,0,0,0,0,0
66,4,3,0,0,0,0,0,0,2,10,0,0,0,0,0,0,0,0
66,5,1,0,0,0,0,0,0,1,4,0,0,0,0,0,0,0,0
66,6,2,0,0,0,0,0,0,1,8,0,0,0,0,0,0,0,0
66,7,4,0,0,0,0,0,0,2,10,0,0,0,0,0,0,0,0
66,10,2,0,0,0,0,0,0,1,8,0,0,0,0,0,0,0,0
66,11,6,7,0,114,16,4,9,4,18,20,0,654,78,18,46,114,654
66,29,2,0,0,0,0,0,0,1,4,0,0,0,0,0,0,0,0
66,67,2,0,0,0,0,0,0,1,4,0,0,0,0,0,0,0,0
66,68,1,0,0,0,0,0,0,1,2,0,0,0,0,0,0,0,0
66,79,14,0,0,0,0,0,0,2,35,0,0,0,0,0,0,0,0
66,85,6,0,0,0,0,0,0,1,14,0,0,0,0,0,0,0,0
66,86,12,0,0,0,0,0,0,1,25,0,0,0,0,0,0,0,0
66,92,2,0,0,0,0,0,0,1,4,0,0,0,0,0,0,0,0
66,95,3,0,0,0,0,0,0,1,6,0,0,0,0,0,0,0,0
66,103,1,0,0,0,0,0,0,1,2,0,0,0,0,0,0,0,0
66,104,285,0,0,0,0,0,0,8,653,0,0,0,0,0,0,0,0
66,105,13,0,121,272,0,0,271,9,38,0,256,569,0,0,566,393,825
66,106,2,0,0,0,0,0,0,2,6,0,0,0,0,0,0,0,0
67,4,3,0,0,0,0,0,0,1,6,0,0,0,0,0,0,0,0
67,5,1,0,0,0,0,0,0,1,6,0,0,0,0,0,0,0,0
67,6,1,0,0,0,0,0,0,1,5,0,0,0,0,0,0,0,0
67,11,1,0,0,0,0,0,0,1,6,0,0,0,0,0,0,0,0
67,65,2,0,0,0,0,0,0,1,6,0,0,0,0,0,0,0,0
67,66,12,0,0,0,0,0,0,4,29,0,0,0,0,0,0,0,0
67,92,7,0,0,0,0,0,0,2,14,0,0,0,0,0,0,0,0
67,93,9,0,0,0,0,0,0,1,16,0,0,0,0,0,0,0,0
67,96,29,0,0,0,0,0,0,1,58,0,0,0,0,0,0,0,0
67,97,402,0,0,0,0,0,0,31,750,0,0,0,0,0,0,0,0
67,98,2,0,0,0,0,0,0,1,6,0,0,0,0,0,0,0,0
67,99,12,0,0,0,0,0,0,1,24,0,0,0,0,0,0,0,0
67,101,3,0,0,0,0,0,0,2,6,0,0,0,0,0,0,0,0
67,102,1,0,0,0,0,0,0,1,2,0,0,0,0,0,0,0,0
67,103,11,0,0,0,0,0,0,2,17,0,0,0,0,0,0,0,0
67,104,2,0,0,0,0,0,0,2,4,0,0,0,0,0,0,0,0
67,105,3,0,0,0,0,0,0,2,6,0,0,0,0,0,0,0,0
67,106,2,0,0,0,0,0,0,2,7,0,0,0,0,0,0,0,0
68,0,1,0,0,0,0,0,0,1,4,0,0,0,0,0,0,0,0
68,1,4,0,0,0,0,0,0,1,8,0,0,0,0,0,0,0,0
68,5,1,0,0,0,0,0,0,1,4,0,0,0,0,0,0,0,0
68,8,11,0,0,0,0,0,0,5,26,0,0,0,0,0,0,0,0
68,65,20,30,290,234,26,41,46,5,42,45,624,518,52,110,111,524,1142
68,66,4,0,0,0,0,0,0,1,8,0,0,0,0,0,0,0,0
68,95,5,0,0,0,0,0,0,2,15,0,0,0,0,0,0,0,0
68,100,18,0,0,0,0,0,0,2,33,0,0,0,0,0,0,0,0
68,101,3,0,0,0,0,0,0,1,6,0,0,0,0,0,0,0,0
68,105,16,0,0,0,0,0,0,2,31,0,0,0,0,0,0,0,0
69,0,1,0,0,0,0,0,0,1,2,0,0,0,0,0,0,0,0
69,2,1,0,0,0,0,0,0,1,6,0,0,0,0,0,0,0,0
69,3,5,0,0,0,0,0,0,1,10,0,0,0,0,0,0,0,0
69,7,27,16,156,251,26,31,4,8,57,39,402,1060,135,138,6,407,1462
69,64,2,0,0,0,0,0,0,1,4,0,0,0,0,0,0,0,0
69,71,2,0,0,0,0,0,0,1,8,0,0,0,0,0,0,0,0
69,93,2,0,0,0,0,0,0,1,8,0,0,0,0,0,0,0,0
69,94,546,0,0,0,0,0,0,18,957,0,0,0,0,0,0,0,0
69,101,193,386,3479,4726,301,232,509,10,447,659,6514,7996,903,397,991,8205,14510
70,2,3,0,0,0,0,0,0,1,6,0,0,0,0,0,0,0,0
70,4,2,0,0,0,0,0,0,1,4,0,0,0,0,0,0,0,0
70,6,1,0,0,0,0,0,0,1,4,0,0,0,0,0,0,0,0
70,7,3,0,0,0,0,0,0,3,12,0,0,0,0,0,0,0,0
70,14,40,0,0,0,0,0,0,7,83,0,0,0,0,0,0,0,0
70,15,30,0,0,0,0,0,0,1,46,0,0,0,0,0,0,0,0
70,67,108,0,0,0,0,0,0,12,215,0,0,0,0,0,0,0,0
70,69,3,0,0,0,0,0,0,1,6,0,0,0,0,0,0,0,0
70,71,1,0,0,0,0,0,0,1,2,0,0,0,0,0,0,0,0
70,75,73,0,0,0,0,0,0,3,159,0,0,0,0,0,0,0,0
70,76,23,0,0,0,0,0,0,1,46,0,0,0,0,0,0,0,0
70,82,74,0,0,0,0,0,0,2,128,0,0,0,0,0,0,0,0
70,91,12,0,0,0,0,0,0,2,39,0,0,0,0,0,0,0,0
71,3,1,0,0,0,0,0,0,1,6,0,0,0,0,0,0,0,0
71,6,1,0,0,0,0,0,0,1,3,0,0,0,0,0,0,0,0
71,77,3,0,0,0,0,0,0,1,5,0,0,0,0,0,0,0,0
71,100,3,0,0,0,0,0,0,1,5,0,0,0,0,0,0,0,0
72,6,4,0,0,0,0,0,0,2,12,0,0,0,0,0,0,0,0
72,68,1,0,0,0,0,0,0,1,2,0,0,0,0,0,0,0,0
72,99,15,0,0,0,0,0,0,2,27,0,0,0,0,0,0,0,0
73,74,6,0,0,0,0,0,0,1,12,0,0,0,0,0,0,0,0
73,76,10,0,0,0,0,0,0,1,22,0,0,0,0,0,0,0,0
73,77,1,0,0,0,0,0,0,1,2,0,0,0,0,0,0,0,0
73,88,52,0,0,0,0,0,0,5,113,0,0,0,0,0,0,0,0
73,99,34,0,0,0,0,0,0,3,65,0,0,0,0,0,0,0,0
74,12,3,0,0,0,0,0,0,3,15,0,0,0,0,0,0,0,0
74,90,2,0,0,0,0,0,0,1,10,0,0,0,0,0,0,0,0
74,95,3,0,0,0,0,0,0,1,6,0,0,0,0,0,0,0,0
74,96,71,0,0,0,0,0,0,5,134,0,0,0,0,0,0,0,0
74,99,12,0,0,0,0,0,0,1,20,0,0,0,0,0,0,0,0
74,100,19,0,0,0,0,0,0,2,40,0,0,0,0,0,0,0,0
75,9,1,0,0,0,0,0,0,1,6,0,0,0,0,0,0,0,0
75,58,35,0,0,0,0,0,0,5,70,0,0,0,0,0,0,0,0
75,63,3,0,0,0,0,0,0,1,6,0,0,0,0,0,0,0,0
75,70,5,0,0,0,0,0,0,1,10,0,0,0,0,0,0,0,0
75,72,2,0,0,0,0,0,0,1,4,0,0,0,0,0,0,0,0
75,73,17,0,0,0,0,0,0,1,33,0,0,0,0,0,0,0,0
75,85,1,0,0,0,0,0,0,1,3,0,0,0,0,0,0,0,0
75,100,1,0,0,0,0,0,0,1,4,0,0,0,0,0,0,0,0
76,0,9,0,0,84,24,0,0,5,24,0,0,776,239,0,0,84,776
76,12,6,0,0,0,0,0,0,2,12,0,0,0,0,0,0,0,0
76,70,17,0,0,0,0,0,0,1,36,0,0,0,0,0,0,0,0
76,77,16,0,0,0,0,0,0,5,33,0,0,0,0,0,0,0,0
76,80,2,0,0,0,0,0,0,1,4,0,0,0,0,0,0,0,0
76,92,2,0,0,0,0,0,0,1,4,0,0,0,0,0,0,0,0
77,3,1,0,0,0,0,0,0,1,4,0,0,0,0,0,0,0,0
77,9,11,0,0,0,0,0,0,4,28,0,0,0,0,0,0,0,0
77,65,19,113,65,700,151,64,49,5,53,223,116,1255,314,97,111,765,1371
77,70,7,0,0,0,0,0,0,1,18,0,0,0,0,0,0,0,0
77,91,1,0,0,0,0,0,0,1,2,0,0,0,0,0,0,0,0
78,0,1,0,0,0,0,0,0,1,6,0,0,0,0,0,0,0,0
78,64,4,0,0,0,0,0,0,2,12,0,0,0,0,0,0,0,0
78,69,3,0,0,0,0,0,0,1,6,0,0,0,0,0,0,0,0
78,94,2,0,0,0,0,0,0,1,4,0,0,0,0,0,0,0,0
78,96,2,0,0,0,0,0,0,1,4,0,0,0,0,0,0,0,0
78,99,29,0,0,0,0,0,0,1,61,0,0,0,0,0,0,0,0
79,1,2,0,0,0,0,0,0,2,8,0,0,0,0,0,0,0,0
79,3,3,0,0,0,0,0,0,1,10,0,0,0,0,0,0,0,0
79,64,22,0,0,0,0,0,0,5,53,0,0,0,0,0,0,0,0
79,69,4,0,0,0,0,0,0,1,8,0,0,0,0,0,0,0,0
79,81,4,0,0,0,0,0,0,1,8,0,0,0,0,0,0,0,0
79,84,15,0,0,0,0,0,0,1,23,0,0,0,0,0,0,0,0
79,91,4,0,0,0,0,0,0,1,14,0,0,0,0,0,0,0,0
79,92,8,0,0,0,0,0,0,1,16,0,0,0,0,0,0,0,0
79,93,105,0,0,0,0,0,0,6,201,0,0,0,0,0,0,0,0
80,1,3,0,0,0,0,0,0,1,8,0,0,0,0,0,0,0,0
80,2,2,0,0,0,0,0,0,2,7,0,0,0,0,0,0,0,0
80,7,1,0,0,0,0,0,0,1,6,0,0,0,0,0,0,0,0
80,68,61,0,0,0,0,0,0,5,127,0,0,0,0,0,0,0,0
80,74,20,0,0,0,0,0,0,1,40,0,0,0,0,0,0,0,0
80,78,2,0,0,0,0,0,0,1,4,0,0,0,0,0,0,0,0
80,83,5,0,0,0,0,0,0,1,15,0,0,0,0,0,0,0,0
80,92,2,0,0,0,0,0,0,1,4,0,0,0,0,0,0,0,0
80,98,7,0,0,0,0,0,0,1,15,0,0,0,0,0,0,0,0
81,0,22,15,29,359,86,0,8,7,52,171,48,3220,860,0,9,388,3268
81,5,3,0,0,0,0,0,0,3,17,0,0,0,0,0,0,0,0
81,62,1,0,0,0,0,0,0,1,2,0,0,0,0,0,0,0,0
81,70,4,0,0,0,0,0,0,1,9,0,0,0,0,0,0,0,0
81,83,3,0,0,0,0,0,0,2,11,0,0,0,0,0,0,0,0
81,84,154,100,1797,1347,203,137,121,12,471,172,3244,3351,505,311,230,3144,6595
82,2,74,69,3821,6930,843,117,128,12,132,124,7068,7785,961,288,268,10751,14853
82,3,9,0,0,0,0,0,0,2,16,0,0,0,0,0,0,0,0
82,4,6,0,0,0,0,0,0,2,13,0,0,0,0,0,0,0,0
82,5,11,0,0,0,0,0,0,3,26,0,0,0,0,0,0,0,0
82,60,5,0,0,0,0,0,0,1,15,0,0,0,0,0,0,0,0
82,62,9,0,0,0,0,0,0,2,21,0,0,0,0,0,0,0,0
82,83,16,0,0,0,0,0,0,2,32,0,0,0,0,0,0,0,0
82,85,12,0,0,0,0,0,0,3,29,0,0,0,0,0,0,0,0
82,96,1,0,0,0,0,0,0,1,2,0,0,0,0,0,0,0,0
83,1,8,0,0,0,0,0,0,2,15,0,0,0,0,0,0,0,0
83,2,6,0,0,0,0,0,0,1,12,0,0,0,0,0,0,0,0
83,3,3,0,0,0,0,0,0,1,8,0,0,0,0,0,0,0,0
83,4,3,0,0,0,0,0,0,1,6,0,0,0,0,0,0,0,0
83,62,1,0,0,0,0,0,0,1,5,0,0,0,0,0,0,0,0
83,84,12,0,0,0,0,0,0,2,23,0,0,0,0,0,0,0,0
83,85,2,0,0,0,0,0,0,1,4,0,0,0,0,0,0,0,0
84,0,17,17,12,162,81,0,0,7,39,98,48,1472,887,0,0,174,1520
84,66,2,0,0,0,0,0,0,1,3,0,0,0,0,0,0,0,0
84,72,45,0,0,0,0,0,0,2,58,0,0,0,0,0,0,0,0
84,88,5,0,0,0,0,0,0,1,8,0,0,0,0,0,0,0,0
84,90,4,0,0,0,0,0,0,1,6,0,0,0,0,0,0,0,0
85,0,12,0,0,0,0,0,0,2,28,0,0,0,0,0,0,0,0
85,61,12,0,0,0,0,0,0,1,27,0,0,0,0,0,0,0,0
85,87,2,0,0,0,0,0,0,1,4,0,0,0,0,0,0,0,0
85,88,3,0,0,0,0,0,0,1,8,0,0,0,0,0,0,0,0
86,0,10,0,0,0,0,0,0,3,24,0,0,0,0,0,0,0,0
86,1,1,0,0,0,0,0,0,1,6,0,0,0,0,0,0,0,0
86,63,7,0,0,0,0,0,0,2,18,0,0,0,0,0,0,0,0
86,90,95,0,0,0,0,0,0,2,192,0,0,0,0,0,0,0,0
86,92,1,0,0,0,0,0,0,1,3,0,0,0,0,0,0,0,0
87,0,2,0,0,0,0,0,0,1,6,0,0,0,0,0,0,0,0
87,81,8,0,0,0,0,0,0,2,52,0,0,0,0,0,0,0,0
87,82,8,0,0,0,0,0,0,1,15,0,0,0,0,0,0,0,0
87,84,2,0,0,0,0,0,0,2,4,0,0,0,0,0,0,0,0
87,94,6,0,0,0,0,0,0,1,14,0,0,0,0,0,0,0,0
89,0,4,0,0,0,0,0,0,1,9,0,0,0,0,0,0,0,0
89,76,3,0,0,0,0,0,0,1,7,0,0,0,0,0,0,0,0
89,87,6,0,0,0,0,0,0,1,13,0,0,0,0,0,0,0,0
90,77,25,0,0,0,0,0,0,1,43,0,0,0,0,0,0,0,0
90,86,5,0,0,0,0,0,0,1,10,0,0,0,0,0,0,0,0
91,66,13,0,0,0,0,0,0,4,28,0,0,0,0,0,0,0,0
91,67,17,0,0,0,0,0,0,3,41,0,0,0,0,0,0,0,0
92,61,9,0,0,0,0,0,0,1,15,0,0,0,0,0,0,0,0
92,64,8,0,0,0,0,0,0,1,16,0,0,0,0,0,0,0,0
92,73,228,200,8817,2544,241,126,464,14,421,396,39253,7321,661,281,1633,11361,46574
92,74,2,0,0,0,0,0,0,1,4,0,0,0,0,0,0,0,0
92,87,25,0,0,0,0,0,0,3,51,0,0,0,0,0,0,0,0
93,67,12,0,0,0,0,0,0,1,40,0,0,0,0,0,0,0,0
93,71,9,0,0,0,0,0,0,1,22,0,0,0,0,0,0,0,0
93,78,1,0,0,0,0,0,0,1,3,0,0,0,0,0,0,0,0
93,83,24,0,0,0,0,0,0,3,44,0,0,0,0,0,0,0,0
94,88,9,0,0,0,0,0,0,1,12,0,0,0,0,0,0,0,0
95,81,21,0,0,0,0,0,0,2,39,0,0,0,0,0,0,0,0
95,82,25,33,932,244,41,7,24,6,46,48,2326,485,122,9,28,1176,2811
96,85,18,0,0,0,0,0,0,1,36,0,0,0,0,0,0,0,0
97,61,68,84,1529,1636,279,207,67,5,171,114,3036,3143,458,358,194,3165,6179
97,62,5,0,0,0,0,0,0,1,10,0,0,0,0,0,0,0,0
98,61,17,0,0,0,0,0,0,1,37,0,0,0,0,0,0,0,0
99,72,4,0,0,0,0,0,0,4,20,0,0,0,0,0,0,0,0
100,75,6,0,0,0,0,0,0,1,12,0,0,0,0,0,0,0,0
100,86,2,0,0,0,0,0,0,1,4,0,0,0,0,0,0,0,0
101,61,16,0,0,0,0,0,0,1,23,0,0,0,0,0,0,0,0
101,81,18,0,0,0,0,0,0,1,39,0,0,0,0,0,0,0,0
103,58,5,0,0,0,0,0,0,1,13,0,0,0,0,0,0,0,0
103,65,21,0,0,0,0,0,0,1,49,0,0,0,0,0,0,0,0
104,65,76,75,3226,1208,156,109,178,6,160,169,6503,3859,559,163,295,4434,10362
104,67,1,0,0,0,0,0,0,1,6,0,0,0,0,0,0,0,0
104,69,86,0,0,0,0,0,0,4,202,0,0,0,0,0,0,0,0
104,73,13,0,0,0,0,0,0,1,56,0,0,0,0,0,0,0,0
104,79,27,92,425,481,8,136,46,6,49,188,1594,1581,27,324,144,906,3175
105,58,1,0,0,0,0,0,0,1,2,0,0,0,0,0,0,0,0
105,61,9,0,0,0,0,0,0,4,18,0,0,0,0,0,0,0,0
105,65,3,0,0,0,0,0,0,1,5,0,0,0,0,0,0,0,0
106,59,11,0,0,0,0,0,0,1,25,0,0,0,0,0,0,0,0
106,61,2,0,0,0,0,0,0,1,8,0,0,0,0,0,0,0,0
106,82,6,0,0,0,0,0,0,1,34,0,0,0,0,0,0,0,0
107,68,5,0,0,0,0,0,0,1,9,0,0,0,0,0,0,0,0
108,59,15,0,0,0,0,0,0,1,23,0,0,0,0,0,0,0,0
108,63,10,0,0,0,0,0,0,3,26,0,0,0,0,0,0,0,0
108,69,13,0,0,0,0,0,0,2,29,0,0,0,0,0,0,0,0
108,72,1,0,0,0,0,0,0,1,6,0,0,0,0,0,0,0,0
108,75,6,0,0,0,0,0,0,1,12,0,0,0,0,0,0,0,0
109,69,35,0,0,0,0,0,0,2,65,0,0,0,0,0,0,0,0
109,72,2,0,0,0,0,0,0,1,5,0,0,0,0,0,0,0,0
109,73,98,0,0,0,0,0,0,3,305,0,0,0,0,0,0,0,0
111,72,7,0,0,0,0,0,0,1,17,0,0,0,0,0,0,0,0
112,60,24,0,0,0,0,0,0,1,49,0,0,0,0,0,0,0,0
113,60,14,0,0,0,0,0,0,4,36,0,0,0,0,0,0,0,0
113,65,6,0,0,0,0,0,0,1,15,0,0,0,0,0,0,0,0
113,71,1,0,0,0,0,0,0,1,4,0,0,0,0,0,0,0,0
113,77,3,0,0,0,0,0,0,1,8,0,0,0,0,0,0,0,0
114,59,267,480,7508,8887,1260,650,447,41,631,709,14886,16106,2188,837,753,16395,30992
114,61,6,0,0,0,0,0,0,1,11,0,0,0,0,0,0,0,0
114,71,65,86,2628,1246,104,84,157,6,109,99,4993,2833,271,169,216,3874,7826
114,72,1,0,0,0,0,0,0,1,2,0,0,0,0,0,0,0,0
115,72,4,0,0,0,0,0,0,1,9,0,0,0,0,0,0,0,0
115,82,11,48,403,291,27,89,22,3,17,76,593,791,38,391,24,694,1384
116,74,11,0,0,0,0,0,0,1,24,0,0,0,0,0,0,0,0
116,82,25,0,0,0,0,0,0,2,45,0,0,0,0,0,0,0,0
118,61,17,0,0,0,0,0,0,2,50,0,0,0,0,0,0,0,0
120,60,6,0,0,0,0,0,0,2,10,0,0,0,0,0,0,0,0
120,65,6,0,0,0,0,0,0,1,13,0,0,0,0,0,0,0,0
120,80,3,0,0,0,0,0,0,1,5,0,0,0,0,0,0,0,0
122,79,45,0,0,0,0,0,0,4,93,0,0,0,0,0,0,0,0
122,80,9,0,0,0,0,0,0,4,28,0,0,0,0,0,0,0,0
123,66,2,0,0,0,0,0,0,1,4,0,0,0,0,0,0,0,0
123,67,18,0,0,0,0,0,0,1,35,0,0,0,0,0,0,0,0
123,73,5,0,0,0,0,0,0,1,13,0,0,0,0,0,0,0,0
123,78,3,0,0,0,0,0,0,1,6,0,0,0,0,0,0,0,0
123,79,1,0,0,0,0,0,0,1,5,0,0,0,0,0,0,0,0
123,82,6,0,0,0,0,0,0,1,12,0,0,0,0,0,0,0,0
124,60,33,6,330,285,46,59,22,4,69,8,639,689,84,335,22,615,1328
124,66,2,0,0,0,0,0,0,1,4,0,0,0,0,0,0,0,0
124,67,89,255,4770,3025,324,166,223,11,179,479,10621,5345,850,330,284,7795,15966
124,76,123,0,0,0,0,0,0,5,242,0,0,0,0,0,0,0,0
125,77,2,0,0,0,0,0,0,1,4,0,0,0,0,0,0,0,0
125,78,12,0,0,0,0,0,0,3,27,0,0,0,0,0,0,0,0
127,75,16,0,0,0,0,0,0,3,26,0,0,0,0,0,0,0,0
127,77,13,0,0,0,0,0,0,4,29,0,0,0,0,0,0,0,0
127,83,66,127,2564,1613,120,152,421,6,163,172,3963,2341,271,174,456,4177,6304
127,84,9,0,91,47,4,4,2,5,20,0,299,136,13,4,2,138,435
