x,y,ACCOMMODATION UNITS (ROOMS APARTMENTS CAMPING SITES) - TOTAL,A_AUSTRIAN TOURISTS,A_DOMESTIC TOURISTS - TOTAL,A_FOREIGN TOURISTS - TOTAL,A_GERMAN TOURISTS,A_ITALIAN TOURISTS,A_SLOVENIAN TOURISTS,ESTABLISHMENTS - TOTAL,NUMBER OF PERMANENT BEDS,N_AUSTRIAN TOURISTS,N_DOMESTIC TOURISTS - TOTAL,N_FOREIGN TOURISTS - TOTAL,N_GERMAN TOURISTS,N_ITALIAN TOURISTS,N_SLOVENIAN TOURISTS,TOTAL ARRIVALS,TOTAL NIGHTS
0,71,11829,94378,43440,530484,123479,70643,43490,2042,31176,508517,124937,3209403,1066734,339465,160670,573924,3334340
0,73,1,0,0,0,0,0,0,1,4,0,0,0,0,0,0,0,0
0,76,24,0,0,0,0,0,0,11,72,0,0,0,0,0,0,0,0
0,77,102,147,24,1375,760,59,18,69,337,932,82,11719,7162,352,104,1399,11801
0,78,5,27,0,145,78,4,0,5,18,176,0,997,593,14,0,145,997
0,79,130,338,198,3804,1325,589,250,60,386,1886,474,23316,11946,2046,683,4002,23790
0,80,55,7,62,337,214,27,33,24,169,43,195,2795,2031,169,123,399,2990
0,81,53,80,22,727,426,30,17,29,170,518,113,6300,4121,190,71,749,6413
0,82,64,99,23,1406,828,139,27,37,212,686,114,13184,8604,974,147,1429,13298
0,83,2,0,0,0,0,0,0,1,4,0,0,0,0,0,0,0,0
0,84,69,0,0,0,0,0,0,24,158,0,0,0,0,0,0,0,0
0,88,24,80,8,518,175,0,10,9,64,514,23,4330,1784,0,27,526,4353
0,89,5,0,0,0,0,0,0,1,10,0,0,0,0,0,0,0,0
0,90,17,24,9,149,34,10,8,10,50,129,24,1125,382,88,54,158,1149
0,91,43,53,20,774,511,40,20,19,109,393,68,6788,5120,113,52,794,6856
1,70,773,0,0,0,0,0,0,2,2316,0,0,0,0,0,0,0,0
1,71,62,19,21,325,68,49,13,9,177,71,40,1313,417,187,37,346,1353
1,76,7,0,0,0,0,0,0,3,14,0,0,0,0,0,0,0,0
1,77,32,0,0,0,0,0,0,13,80,0,0,0,0,0,0,0,0
1,78,33,122,38,1017,435,94,32,20,117,840,103,8041,4223,420,108,1055,8144
1,79,68,152,61,1521,747,193,36,34,196,974,224,12643,7497,932,214,1582,12867
1,80,12,0,0,0,0,0,0,4,34,0,0,0,0,0,0,0,0
1,81,4,0,0,0,0,0,0,3,14,0,0,0,0,0,0,0,0
1,82,13,0,0,0,0,0,0,7,26,0,0,0,0,0,0,0,0
1,83,28,63,23,428,244,30,26,11,73,429,81,3163,2210,118,50,451,3244
1,84,215,0,0,0,0,0,0,103,561,0,0,0,0,0,0,0,0
1,85,8,0,0,0,0,0,0,1,14,0,0,0,0,0,0,0,0
1,87,6,0,0,0,0,0,0,3,15,0,0,0,0,0,0,0,0
1,88,37,168,28,853,207,113,15,13,86,587,82,4261,1848,232,17,881,4343
1,90,7,0,0,0,0,0,0,2,34,0,0,0,0,0,0,0,0
1,91,58,166,66,986,370,65,53,20,142,837,219,6079,3148,191,108,1052,6298
1,92,18,0,0,100,78,0,0,6,36,0,0,935,737,0,0,100,935
2,69,11,0,0,0,0,0,0,3,28,0,0,0,0,0,0,0,0
2,70,46,0,0,0,0,0,0,6,134,0,0,0,0,0,0,0,0
2,71,12,36,0,216,127,0,0,5,26,254,0,1766,1123,0,0,216,1766
2,73,237,706,314,6385,1876,1117,140,97,611,4280,1256,39864,16046,5107,479,6699,41120
2,75,19,0,0,0,0,0,0,6,43,0,0,0,0,0,0,0,0
2,76,33,0,0,0,0,0,0,15,80,0,0,0,0,0,0,0,0
2,77,16,0,0,0,0,0,0,7,36,0,0,0,0,0,0,0,0
2,78,10,0,0,0,0,0,0,8,35,0,0,0,0,0,0,0,0
2,79,20,35,28,278,57,70,26,9,51,171,41,1334,527,157,101,306,1375
2,80,21,0,0,0,0,0,0,5,76,0,0,0,0,0,0,0,0
2,81,17,17,16,495,239,33,15,7,41,103,21,3799,2427,116,42,511,3820
2,82,218,425,224,3075,973,172,145,70,472,2456,611,21063,8803,732,341,3299,21674
2,83,33,0,0,0,0,0,0,14,74,0,0,0,0,0,0,0,0
2,84,8,0,0,0,0,0,0,3,20,0,0,0,0,0,0,0,0
2,85,40,0,0,0,0,0,0,16,102,0,0,0,0,0,0,0,0
2,86,25,68,14,513,163,0,1,9,58,410,50,4108,1416,0,7,527,4158
2,88,90,356,311,2060,338,295,228,28,238,1145,1344,8598,2142,713,656,2371,9942
2,89,5,0,0,0,0,0,0,2,12,0,0,0,0,0,0,0,0
2,90,5,27,23,190,31,36,15,4,10,83,33,763,279,73,29,213,796
3,69,4,0,0,0,0,0,0,1,8,0,0,0,0,0,0,0,0
3,70,5,0,0,0,0,0,0,2,14,0,0,0,0,0,0,0,0
3,73,37,71,49,811,302,165,17,18,101,444,246,5711,2804,867,53,860,5957
3,74,12,0,0,0,0,0,0,4,24,0,0,0,0,0,0,0,0
3,75,10,9,12,175,109,3,7,5,24,61,84,1655,1089,12,79,187,1739
3,76,29,0,0,0,0,0,0,14,77,0,0,0,0,0,0,0,0
3,77,61,116,48,787,295,36,28,22,143,626,73,6067,2907,361,89,835,6140
3,78,14,0,0,0,0,0,0,6,36,0,0,0,0,0,0,0,0
3,79,11,18,9,288,191,4,0,7,39,187,35,2904,1909,28,0,297,2939
3,80,9,0,0,0,0,0,0,2,18,0,0,0,0,0,0,0,0
3,81,17,0,0,0,0,0,0,5,36,0,0,0,0,0,0,0,0
3,82,2,0,0,0,0,0,0,1,4,0,0,0,0,0,0,0,0
3,83,17,0,0,0,0,0,0,6,41,0,0,0,0,0,0,0,0
3,84,23,0,0,0,0,0,0,10,59,0,0,0,0,0,0,0,0
3,85,31,0,0,0,0,0,0,10,68,0,0,0,0,0,0,0,0
3,86,33,0,0,0,0,0,0,16,79,0,0,0,0,0,0,0,0
3,87,16,0,0,0,0,0,0,4,34,0,0,0,0,0,0,0,0
3,89,9,0,0,0,0,0,0,3,19,0,0,0,0,0,0,0,0
3,90,6,0,0,0,0,0,0,2,12,0,0,0,0,0,0,0,0
4,67,135,338,99,3286,1433,295,269,61,388,2380,540,26556,14412,1834,1466,3385,27096
4,73,112,91,34,1158,598,108,19,41,267,528,196,9066,5436,580,32,1192,9262
4,74,36,0,0,0,0,0,0,16,85,0,0,0,0,0,0,0,0
4,75,6,0,0,0,0,0,0,3,12,0,0,0,0,0,0,0,0
4,76,36,54,0,556,322,7,0,15,91,438,0,5132,3041,85,0,556,5132
4,77,31,0,0,0,0,0,0,10,67,0,0,0,0,0,0,0,0
4,78,210,355,53,2031,927,48,12,72,468,2310,224,16698,8371,275,50,2084,16922
4,79,41,56,8,353,225,5,0,21,106,441,43,3540,2371,39,0,361,3583
4,80,36,0,0,0,0,0,0,13,81,0,0,0,0,0,0,0,0
4,81,22,0,0,0,0,0,0,8,50,0,0,0,0,0,0,0,0
4,82,50,105,8,750,460,27,19,20,122,848,41,6896,4424,178,75,758,6937
4,83,35,66,6,381,204,15,2,12,74,525,12,2649,1356,97,26,387,2661
4,84,12,0,0,0,0,0,0,5,28,0,0,0,0,0,0,0,0
4,86,27,0,0,0,0,0,0,12,69,0,0,0,0,0,0,0,0
4,88,1,0,0,0,0,0,0,1,6,0,0,0,0,0,0,0,0
4,89,20,72,9,258,130,0,2,9,45,482,65,2023,1151,0,8,267,2088
5,65,5,0,0,0,0,0,0,2,16,0,0,0,0,0,0,0,0
5,66,3,0,0,0,0,0,0,3,7,0,0,0,0,0,0,0,0
5,67,7,0,0,0,0,0,0,4,24,0,0,0,0,0,0,0,0
5,69,16,62,30,470,108,168,28,9,36,356,93,2711,987,710,115,500,2804
5,70,802,5626,1804,44435,12181,7406,11525,87,2249,33734,5716,281967,104357,37267,69025,46239,287683
5,72,26,53,74,830,283,175,21,10,57,330,153,4835,2372,460,31,904,4988
5,73,34,60,188,757,235,61,37,18,75,346,417,4456,1950,237,65,945,4873
5,74,26,44,7,254,156,14,0,9,53,295,47,2383,1634,68,0,261,2430
5,75,2,0,0,0,0,0,0,1,4,0,0,0,0,0,0,0,0
5,76,5,0,0,0,0,0,0,3,15,0,0,0,0,0,0,0,0
5,77,50,100,3,620,304,29,0,21,119,787,8,5344,2876,196,0,623,5352
5,78,22,24,3,321,210,5,3,9,56,163,9,2824,1969,54,21,324,2833
5,79,40,55,10,670,422,1,7,13,83,493,55,6689,4481,21,29,680,6744
5,80,13,24,4,249,148,0,4,6,36,211,28,2391,1414,0,28,253,2419
5,81,9,0,0,0,0,0,0,3,18,0,0,0,0,0,0,0,0
5,82,4,0,0,0,0,0,0,2,12,0,0,0,0,0,0,0,0
5,83,14,0,0,0,0,0,0,6,39,0,0,0,0,0,0,0,0
5,84,10,21,8,273,179,7,0,7,34,155,46,2624,1890,49,0,281,2670
5,85,27,28,24,401,145,11,5,12,68,171,83,2886,1388,39,13,425,2969
5,86,49,59,167,1116,317,118,81,19,106,321,324,6820,2684,202,137,1283,7144
5,87,15,0,0,0,0,0,0,6,30,0,0,0,0,0,0,0,0
5,88,7,0,0,0,0,0,0,2,14,0,0,0,0,0,0,0,0
5,89,2,0,0,0,0,0,0,1,4,0,0,0,0,0,0,0,0
5,90,2,0,0,0,0,0,0,1,4,0,0,0,0,0,0,0,0
6,63,1382,3484,3018,46281,10467,4513,12319,362,3893,20448,17306,299708,86777,23669,76872,49299,317014
6,64,77,136,31,1914,926,136,105,45,226,982,207,16374,9457,1039,672,1945,16581
6,65,541,702,1555,15767,3087,695,5760,182,1610,4362,6487,100088,29478,3109,37912,17322,106575
6,67,3,0,0,0,0,0,0,2,10,0,0,0,0,0,0,0,0
6,68,4,0,0,0,0,0,0,2,14,0,0,0,0,0,0,0,0
6,72,15,0,0,0,0,0,0,5,37,0,0,0,0,0,0,0,0
6,73,3,0,0,0,0,0,0,3,12,0,0,0,0,0,0,0,0
6,74,1,0,0,0,0,0,0,1,5,0,0,0,0,0,0,0,0
6,75,20,0,0,0,0,0,0,5,42,0,0,0,0,0,0,0,0
6,76,33,94,26,839,491,6,6,12,78,714,134,7385,4778,28,64,865,7519
6,77,31,42,13,453,185,4,2,12,68,336,52,3922,1744,12,4,466,3974
6,78,34,20,6,592,322,11,7,13,112,178,12,5346,3027,33,49,598,5358
6,79,37,99,0,659,440,0,0,12,92,896,0,6406,4592,0,0,659,6406
6,80,6,8,3,109,44,0,0,3,20,112,6,1018,349,0,0,112,1024
6,81,14,62,45,473,212,35,1,8,56,462,85,3890,2323,124,2,518,3975
6,84,24,40,6,335,169,0,0,9,54,295,62,3063,1613,0,0,341,3125
6,85,12,12,8,116,66,0,0,4,24,119,24,1105,623,0,0,124,1129
6,86,484,394,291,4130,1117,341,213,51,1325,852,566,9494,2877,506,408,4421,10060
6,87,293,0,0,0,0,0,0,11,474,0,0,0,0,0,0,0,0
6,88,17,13,0,87,51,0,0,6,36,103,0,883,531,0,0,87,883
6,89,28,95,71,539,138,14,58,9,64,242,119,2646,1141,18,87,610,2765
7,60,3,0,0,0,0,0,0,2,6,0,0,0,0,0,0,0,0
7,61,59,287,143,1897,489,241,50,32,149,2026,604,13520,4167,1710,330,2040,14124
7,62,68,143,56,1595,489,121,121,31,174,927,337,11893,4453,766,843,1651,12230
7,63,2415,4325,4249,80462,27241,9957,6988,346,7206,30827,25161,650077,245223,68827,30967,84711,675238
7,67,2,0,0,0,0,0,0,2,10,0,0,0,0,0,0,0,0
7,68,74,336,59,1908,1154,43,18,27,189,2393,180,17233,11599,336,31,1967,17413
7,72,53,104,5,918,657,24,2,21,119,741,32,8652,6825,170,8,923,8684
7,73,28,0,0,0,0,0,0,10,64,0,0,0,0,0,0,0,0
7,74,58,62,52,1354,643,99,47,29,134,469,179,10736,6643,505,315,1406,10915
7,75,22,55,14,316,170,0,0,6,45,461,98,2740,1475,0,0,330,2838
7,77,44,50,7,669,278,6,0,16,94,532,11,6601,2838,21,0,676,6612
7,78,19,27,9,338,157,12,0,8,44,206,76,3163,1755,56,0,347,3239
7,79,16,57,46,407,207,16,0,4,35,385,117,3551,2079,48,0,453,3668
7,80,16,12,51,224,115,20,5,8,41,61,130,1791,1297,81,12,275,1921
7,81,4,0,0,0,0,0,0,1,8,0,0,0,0,0,0,0,0
7,82,6,3,16,137,50,8,0,6,29,21,72,1209,532,56,0,153,1281
7,83,14,17,9,247,161,1,0,8,47,195,59,2641,1688,11,0,256,2700
7,84,16,6,0,225,137,0,0,5,31,42,0,2408,1438,0,0,225,2408
7,85,3,0,0,0,0,0,0,1,6,0,0,0,0,0,0,0,0
7,86,8,0,0,0,0,0,0,2,16,0,0,0,0,0,0,0,0
7,87,6,0,0,0,0,0,0,2,11,0,0,0,0,0,0,0,0
7,88,9,0,0,0,0,0,0,3,18,0,0,0,0,0,0,0,0
8,58,1084,1443,628,16963,4475,1567,923,211,3133,8073,1984,110372,37453,8642,5460,17591,112356
8,59,92,165,98,2495,517,371,112,54,248,905,452,14626,3978,2220,417,2593,15078
8,60,7925,24959,36828,327493,61934,38654,21403,2135,21564,119086,94201,1672114,415198,178124,92896,364321,1766315
8,61,33,82,44,1069,206,136,59,20,84,590,142,6157,1522,693,174,1113,6299
8,62,116,127,143,3458,758,536,97,58,311,786,570,20603,6724,2835,324,3601,21173
8,63,191,374,229,4791,1847,565,149,104,551,2699,815,37213,17864,3664,670,5020,38028
8,65,298,656,371,7578,2749,522,1198,162,876,4574,2185,61667,26883,3785,7787,7949,63852
8,69,57,136,4,798,573,0,1,16,113,1081,12,7906,6129,0,3,802,7918
8,71,13,26,10,243,136,0,0,5,28,210,44,2310,1346,0,0,253,2354
8,72,49,68,67,902,470,12,28,20,107,458,155,7740,4576,63,95,969,7895
8,73,10,0,0,0,0,0,0,5,22,0,0,0,0,0,0,0,0
8,74,37,22,4,589,387,6,3,14,89,171,16,5809,4035,42,14,593,5825
8,75,48,68,29,720,334,43,28,16,110,520,97,6081,3384,250,127,749,6178
8,76,9,5,18,153,77,8,0,7,28,23,43,1002,707,23,0,171,1045
8,77,18,7,16,305,175,4,0,6,36,98,91,2995,1745,28,0,321,3086
8,78,91,184,57,1667,1016,17,29,38,209,1485,389,16609,10986,86,125,1724,16998
8,79,5,0,0,0,0,0,0,2,9,0,0,0,0,0,0,0,0
8,80,12,26,1,340,230,11,0,6,43,275,14,3305,2311,61,0,341,3319
8,81,4,0,0,0,0,0,0,2,10,0,0,0,0,0,0,0,0
8,82,32,48,149,759,280,43,32,10,70,127,277,3471,1680,98,46,908,3748
8,85,7,0,0,0,0,0,0,3,16,0,0,0,0,0,0,0,0
8,86,6,0,0,0,0,0,0,2,11,0,0,0,0,0,0,0,0
8,87,11,0,0,0,0,0,0,5,22,0,0,0,0,0,0,0,0
8,89,2,0,0,0,0,0,0,1,4,0,0,0,0,0,0,0,0
8,90,8,0,0,0,0,0,0,4,20,0,0,0,0,0,0,0,0
9,57,60,147,4,1377,678,142,54,24,189,1045,18,12140,7038,1064,394,1381,12158
9,58,1582,5491,2930,54493,16399,4598,5480,367,4238,33268,10869,386192,143906,27048,38978,57423,397061
9,59,107,115,72,2255,789,260,58,69,309,827,336,17083,7382,1558,270,2327,17419
9,60,54,90,91,1671,436,278,46,32,149,503,769,10085,3945,1340,144,1762,10854
9,61,4,4,0,106,24,14,0,4,11,28,0,684,180,54,0,106,684
9,62,3,0,0,0,0,0,0,1,10,0,0,0,0,0,0,0,0
9,64,8,10,4,192,92,8,2,5,22,70,9,1727,838,40,4,196,1736
9,67,13,0,0,0,0,0,0,4,26,0,0,0,0,0,0,0,0
9,68,57,104,20,550,261,3,5,17,113,592,101,4574,2567,15,15,570,4675
9,69,200,259,23,2480,1618,22,49,59,429,2019,216,24074,16952,147,267,2503,24290
9,70,37,74,10,671,357,6,20,13,77,513,19,5956,3606,20,73,681,5975
9,71,27,0,0,0,0,0,0,11,61,0,0,0,0,0,0,0,0
9,72,44,43,47,583,258,13,10,19,93,364,141,4994,2425,41,24,630,5135
9,73,19,0,0,0,0,0,0,5,38,0,0,0,0,0,0,0,0
9,74,29,16,0,242,208,0,0,10,66,161,0,2835,2454,0,0,242,2835
9,75,19,13,0,135,83,0,0,7,57,126,0,1296,889,0,0,135,1296
9,76,29,0,0,0,0,0,0,11,65,0,0,0,0,0,0,0,0
9,77,5,0,0,0,0,0,0,3,16,0,0,0,0,0,0,0,0
9,78,6,0,0,0,0,0,0,3,18,0,0,0,0,0,0,0,0
9,79,14,13,0,201,136,0,0,7,38,91,0,2016,1378,0,0,201,2016
9,80,10,0,0,0,0,0,0,2,24,0,0,0,0,0,0,0,0
9,81,27,17,50,311,123,14,6,11,66,95,133,2363,1270,66,21,361,2496
9,82,5,0,0,0,0,0,0,3,14,0,0,0,0,0,0,0,0
9,87,6,0,0,0,0,0,0,2,14,0,0,0,0,0,0,0,0
9,89,6,0,0,0,0,0,0,2,12,0,0,0,0,0,0,0,0
10,57,64,214,17,1549,570,191,124,25,160,1335,37,11731,5625,1042,849,1566,11768
10,58,506,1404,133,12420,4019,1059,2884,108,1450,9304,586,83815,32622,6293,18077,12553,84401
10,59,7,6,3,100,9,38,2,5,19,72,15,570,92,185,6,103,585
10,60,45,103,28,1250,480,143,15,32,148,726,143,9217,4496,808,28,1278,9360
10,61,3,11,6,119,58,8,0,3,12,42,12,905,552,56,0,125,917
10,62,10,0,0,0,0,0,0,3,22,0,0,0,0,0,0,0,0
10,63,107,250,66,2313,1363,98,4,52,285,1985,252,20544,13548,668,24,2379,20796
10,66,3,0,0,0,0,0,0,1,12,0,0,0,0,0,0,0,0
10,67,9,0,0,0,0,0,0,1,22,0,0,0,0,0,0,0,0
10,68,19,15,7,160,123,0,0,6,38,105,49,1593,1265,0,0,167,1642
10,69,81,135,0,1323,826,39,25,26,172,1119,0,12674,8328,267,140,1323,12674
10,70,41,49,0,420,234,33,2,16,100,399,0,3713,2344,209,14,420,3713
10,71,25,0,0,0,0,0,0,8,55,0,0,0,0,0,0,0,0
10,72,42,43,32,746,451,26,0,18,90,361,120,7607,5087,230,0,778,7727
10,73,7,0,0,0,0,0,0,3,18,0,0,0,0,0,0,0,0
10,74,54,99,19,704,411,0,2,16,125,779,125,6641,4183,11,16,723,6766
10,75,4,0,0,0,0,0,0,2,8,0,0,0,0,0,0,0,0
10,76,20,16,36,308,162,29,14,11,46,134,183,2693,1588,83,89,344,2876
10,77,7,10,7,118,72,0,3,3,14,64,16,1225,869,0,15,125,1241
10,78,15,66,14,468,280,11,0,8,52,509,48,4344,2736,77,0,482,4392
10,79,6,0,0,0,0,0,0,2,12,0,0,0,0,0,0,0,0
10,80,41,86,175,836,277,89,4,12,103,448,319,5883,2382,252,4,1011,6202
10,81,1,0,0,0,0,0,0,1,4,0,0,0,0,0,0,0,0
10,83,3,0,0,0,0,0,0,2,6,0,0,0,0,0,0,0,0
10,87,6,0,0,0,0,0,0,2,16,0,0,0,0,0,0,0,0
10,88,7,0,0,0,0,0,0,2,14,0,0,0,0,0,0,0,0
10,89,24,0,0,0,0,0,0,8,50,0,0,0,0,0,0,0,0
10,90,5,0,0,0,0,0,0,4,10,0,0,0,0,0,0,0,0
10,92,4,0,0,0,0,0,0,1,8,0,0,0,0,0,0,0,0
10,93,1,0,0,0,0,0,0,1,4,0,0,0,0,0,0,0,0
11,56,62,266,6,794,101,146,56,35,188,1462,32,4198,764,602,170,800,4230
11,57,2755,13146,1216,90132,16044,18136,22992,404,7924,75736,6326,531153,118434,92864,126626,91348,537479
11,58,159,613,71,4357,1410,447,164,80,456,4087,958,32946,13195,2857,859,4428,33904
11,59,21,38,3,402,178,63,19,14,48,308,27,3195,1827,330,82,405,3222
11,60,56,114,19,1250,565,84,23,31,141,941,84,10261,5506,462,171,1269,10345
11,62,7,0,0,156,72,11,0,4,19,0,0,1371,745,66,0,156,1371
11,63,13,60,3,457,227,24,4,7,42,377,30,4145,2559,178,13,460,4175
11,64,3,0,0,0,0,0,0,3,10,0,0,0,0,0,0,0,0
11,66,12,18,0,177,75,0,0,5,31,116,0,1638,838,0,0,177,1638
11,67,31,62,29,649,304,49,5,13,65,394,77,5270,3258,201,34,678,5347
11,68,21,12,17,397,228,20,10,10,48,58,89,3909,2554,150,87,414,3998
11,69,15,14,0,191,127,0,0,6,32,86,0,2048,1477,0,0,191,2048
11,71,3,0,0,0,0,0,0,2,6,0,0,0,0,0,0,0,0
11,73,11,32,26,296,135,20,8,4,22,259,38,1965,1156,79,14,322,2003
11,74,10,16,15,190,73,14,2,5,24,128,44,1640,823,48,4,205,1684
11,75,11,0,0,0,0,0,0,4,22,0,0,0,0,0,0,0,0
11,76,35,13,2,619,443,11,0,13,110,101,10,6116,4486,82,0,621,6126
11,77,3,0,0,0,0,0,0,2,15,0,0,0,0,0,0,0,0
11,78,5,0,0,0,0,0,0,2,10,0,0,0,0,0,0,0,0
11,79,10,13,7,163,83,0,4,5,27,74,18,1257,861,0,8,170,1275
11,80,3,0,0,0,0,0,0,2,10,0,0,0,0,0,0,0,0
11,81,41,78,2236,1543,171,401,111,12,87,210,4370,5044,447,800,165,3779,9414
11,83,4,0,0,0,0,0,0,1,8,0,0,0,0,0,0,0,0
11,85,4,0,0,0,0,0,0,3,9,0,0,0,0,0,0,0,0
11,86,3,0,0,0,0,0,0,1,5,0,0,0,0,0,0,0,0
11,88,1,0,0,0,0,0,0,1,2,0,0,0,0,0,0,0,0
11,89,3,0,0,0,0,0,0,2,8,0,0,0,0,0,0,0,0
11,90,109,669,1755,5836,654,589,336,21,222,1667,3526,16320,2438,1067,449,7591,19846
11,91,9,36,8,358,184,0,2,4,19,351,16,2877,1553,0,2,366,2893
12,57,2454,19809,3829,90645,20190,10021,9984,251,6331,106845,13851,566186,157099,53806,50398,94474,580037
12,58,3455,13095,2160,85695,31874,11142,5331,727,9812,90013,10445,652739,296647,72328,28385,87855,663184
12,59,20,32,9,331,164,25,7,10,48,228,31,3093,1615,174,49,340,3124
12,60,198,616,396,5192,2574,608,140,82,479,3917,769,40500,24740,3190,538,5588,41269
12,62,36,122,10,700,285,57,1,19,88,875,40,5664,2861,390,3,710,5704
12,63,73,120,18,1476,762,129,18,34,178,863,146,12660,7739,712,46,1494,12806
12,64,12,0,0,0,0,0,0,7,37,0,0,0,0,0,0,0,0
12,65,104,124,24,2131,1374,135,28,47,252,868,124,20077,14456,874,73,2155,20201
12,66,2,0,0,0,0,0,0,1,6,0,0,0,0,0,0,0,0
12,67,12,0,0,0,0,0,0,5,24,0,0,0,0,0,0,0,0
12,68,34,143,43,725,429,20,0,11,78,908,271,6314,4292,119,0,768,6585
12,69,37,69,0,450,284,4,0,18,99,490,0,4467,3111,48,0,450,4467
12,70,9,53,0,228,93,7,0,5,24,353,0,1976,951,56,0,228,1976
12,71,48,173,235,1160,656,15,70,17,106,1089,334,10501,6789,90,190,1395,10835
12,72,7,0,0,0,0,0,0,4,16,0,0,0,0,0,0,0,0
12,73,57,165,19,934,359,57,51,16,115,1040,142,7311,3082,286,145,953,7453
12,74,33,0,0,104,75,11,0,12,76,0,0,989,830,54,0,104,989
12,75,3,0,0,0,0,0,0,1,7,0,0,0,0,0,0,0,0
12,76,2,0,0,0,0,0,0,1,7,0,0,0,0,0,0,0,0
12,77,6,0,0,0,0,0,0,3,14,0,0,0,0,0,0,0,0
12,81,7,7,132,167,43,29,2,4,17,40,588,1042,318,243,2,299,1630
12,82,12,0,0,0,0,0,0,4,28,0,0,0,0,0,0,0,0
12,86,1,0,0,0,0,0,0,1,4,0,0,0,0,0,0,0,0
12,88,2,0,0,0,0,0,0,1,4,0,0,0,0,0,0,0,0
12,89,7,0,0,0,0,0,0,3,15,0,0,0,0,0,0,0,0
12,90,13,0,0,0,0,0,0,5,25,0,0,0,0,0,0,0,0
12,91,14,0,0,0,0,0,0,6,32,0,0,0,0,0,0,0,0
13,57,1,0,0,0,0,0,0,1,2,0,0,0,0,0,0,0,0
13,58,603,1294,323,13978,6487,1455,557,295,1652,8785,1715,114980,62168,9950,2907,14301,116695
13,59,7,0,0,0,0,0,0,1,16,0,0,0,0,0,0,0,0
13,61,3,0,0,0,0,0,0,2,12,0,0,0,0,0,0,0,0
13,62,58,187,20,1110,670,52,9,19,134,1400,134,10789,7456,274,52,1130,10923
13,63,27,47,6,474,252,37,4,13,59,388,22,3806,2184,244,20,480,3828
13,65,11,0,0,0,0,0,0,4,22,0,0,0,0,0,0,0,0
13,66,4,0,0,0,0,0,0,2,7,0,0,0,0,0,0,0,0
13,68,84,183,95,1521,698,121,27,33,205,1087,217,10752,6117,608,91,1616,10969
13,69,1,0,0,0,0,0,0,1,4,0,0,0,0,0,0,0,0
13,71,48,41,20,929,667,32,0,23,115,329,62,9321,7164,170,0,949,9383
13,72,13,0,0,0,0,0,0,3,31,0,0,0,0,0,0,0,0
13,73,19,0,0,0,0,0,0,7,46,0,0,0,0,0,0,0,0
13,74,6,0,0,0,0,0,0,2,12,0,0,0,0,0,0,0,0
13,75,5,0,0,0,0,0,0,2,10,0,0,0,0,0,0,0,0
13,77,2,0,0,0,0,0,0,2,10,0,0,0,0,0,0,0,0
13,78,3,0,0,0,0,0,0,1,6,0,0,0,0,0,0,0,0
13,79,3,0,0,0,0,0,0,1,6,0,0,0,0,0,0,0,0
13,80,4,0,0,0,0,0,0,3,10,0,0,0,0,0,0,0,0
13,81,3,0,0,0,0,0,0,1,6,0,0,0,0,0,0,0,0
13,83,8,0,0,0,0,0,0,3,24,0,0,0,0,0,0,0,0
13,84,5,0,0,0,0,0,0,2,12,0,0,0,0,0,0,0,0
13,86,5,0,0,0,0,0,0,4,16,0,0,0,0,0,0,0,0
13,87,4,0,0,0,0,0,0,2,8,0,0,0,0,0,0,0,0
13,88,24,0,0,75,38,0,0,12,45,0,0,602,364,0,0,75,602
13,90,2,0,0,0,0,0,0,1,4,0,0,0,0,0,0,0,0
14,63,94,187,63,1875,1079,65,36,37,218,1156,409,16568,10784,419,137,1938,16977
14,64,131,257,101,2661,1396,161,41,53,329,2001,684,23390,14074,987,198,2762,24074
14,65,23,50,15,443,311,12,6,13,52,342,81,4901,3802,99,84,458,4982
14,66,5,0,0,0,0,0,0,3,11,0,0,0,0,0,0,0,0
14,68,78,135,41,1354,831,47,12,30,165,1046,57,12518,8185,239,45,1395,12575
14,69,22,100,7,527,375,8,1,13,52,891,38,5209,3824,56,7,534,5247
14,71,20,17,0,163,85,9,3,10,39,133,0,1548,948,34,21,163,1548
14,72,34,42,1,615,418,23,9,13,72,311,13,5752,4333,122,58,616,5765
14,73,4,0,0,0,0,0,0,2,8,0,0,0,0,0,0,0,0
14,75,15,10,5,192,95,9,18,6,38,70,63,1584,1005,23,38,197,1647
14,77,6,0,0,0,0,0,0,4,21,0,0,0,0,0,0,0,0
14,78,13,76,5,465,301,4,0,7,41,342,16,4030,2957,24,0,470,4046
14,79,24,4,65,305,182,6,4,11,54,28,254,2565,1812,38,10,370,2819
14,80,20,24,78,450,112,78,20,9,46,104,178,2226,889,257,32,528,2404
14,84,5,0,0,0,0,0,0,2,12,0,0,0,0,0,0,0,0
14,85,1,0,0,0,0,0,0,1,4,0,0,0,0,0,0,0,0
14,88,1,0,0,0,0,0,0,1,2,0,0,0,0,0,0,0,0
14,89,3,0,0,0,0,0,0,1,6,0,0,0,0,0,0,0,0
14,90,9,0,0,0,0,0,0,7,24,0,0,0,0,0,0,0,0
14,91,4,0,0,0,0,0,0,2,11,0,0,0,0,0,0,0,0
14,93,1,0,0,0,0,0,0,1,2,0,0,0,0,0,0,0,0
15,65,99,104,29,1353,780,49,59,42,233,624,190,11932,7714,429,512,1382,12122
15,66,527,569,3357,10026,1764,976,2455,96,1538,2964,18966,65359,16161,5711,14782,13383,84325
15,69,71,151,1,1399,945,16,8,33,168,1059,7,13616,10060,112,53,1400,13623
15,71,31,141,36,938,397,24,31,11,69,690,86,6059,3574,97,61,974,6145
15,72,24,21,8,453,303,5,0,10,54,253,53,4644,3307,10,0,461,4697
15,73,14,0,0,0,0,0,0,8,45,0,0,0,0,0,0,0,0
15,74,23,35,7,307,193,5,0,13,65,337,49,3112,2015,35,0,314,3161
15,75,3,0,0,0,0,0,0,1,6,0,0,0,0,0,0,0,0
15,76,4,0,0,0,0,0,0,2,7,0,0,0,0,0,0,0,0
15,78,23,65,0,358,206,3,4,11,58,261,0,3111,2153,9,28,358,3111
15,79,13,17,0,196,124,0,0,6,32,203,0,1767,1136,0,0,196,1767
15,80,4,0,0,0,0,0,0,1,9,0,0,0,0,0,0,0,0
15,81,5,0,0,0,0,0,0,2,12,0,0,0,0,0,0,0,0
15,82,1,0,0,0,0,0,0,1,4,0,0,0,0,0,0,0,0
15,85,7,0,0,0,0,0,0,3,19,0,0,0,0,0,0,0,0
15,87,12,73,104,812,160,84,22,9,28,193,178,1969,620,130,46,916,2147
15,88,8,0,0,0,0,0,0,3,16,0,0,0,0,0,0,0,0
15,90,35,0,0,0,0,0,0,20,77,0,0,0,0,0,0,0,0
15,92,3,0,0,0,0,0,0,1,7,0,0,0,0,0,0,0,0
16,64,2,0,0,0,0,0,0,1,6,0,0,0,0,0,0,0,0
16,66,9,45,0,271,157,38,6,3,23,325,0,2376,1590,143,40,271,2376
16,67,176,375,17,3804,2326,272,32,76,403,2725,106,35009,23880,1718,212,3821,35115
16,69,52,208,40,1237,628,32,5,28,140,1444,154,10317,6152,220,23,1277,10471
16,70,36,47,0,843,633,12,0,19,110,406,0,8539,6818,94,0,843,8539
16,72,2,0,0,0,0,0,0,1,4,0,0,0,0,0,0,0,0
16,73,59,60,11,696,466,20,7,25,146,435,65,7241,5100,189,80,707,7306
16,74,31,100,15,720,383,47,26,20,93,681,67,6406,3996,237,112,735,6473
16,75,37,59,27,814,417,91,21,20,98,276,91,5972,3985,418,21,841,6063
16,76,46,55,2,794,526,14,9,18,102,467,14,7812,5632,113,57,796,7826
16,77,64,181,42,1365,760,26,59,25,166,1152,102,11877,7398,245,174,1407,11979
16,78,8,0,0,0,0,0,0,4,25,0,0,0,0,0,0,0,0
16,79,13,0,0,0,0,0,0,6,37,0,0,0,0,0,0,0,0
16,80,12,116,19,655,222,29,40,4,27,523,49,3980,2054,64,70,674,4029
16,81,2,0,0,0,0,0,0,2,12,0,0,0,0,0,0,0,0
16,85,7,0,0,0,0,0,0,2,14,0,0,0,0,0,0,0,0
16,86,1,0,0,0,0,0,0,1,4,0,0,0,0,0,0,0,0
16,87,1,0,0,0,0,0,0,1,2,0,0,0,0,0,0,0,0
16,88,7,49,56,506,27,187,41,6,20,217,153,1574,137,361,86,562,1727
16,89,6,0,0,0,0,0,0,2,10,0,0,0,0,0,0,0,0
16,90,3,0,0,0,0,0,0,2,8,0,0,0,0,0,0,0,0
16,92,1,0,0,0,0,0,0,1,3,0,0,0,0,0,0,0,0
17,67,6,32,0,242,66,53,4,3,26,218,0,1940,711,430,24,242,1940
17,69,4,0,0,0,0,0,0,2,8,0,0,0,0,0,0,0,0
17,70,10,29,0,120,71,0,1,4,24,176,0,1020,735,0,7,120,1020
17,71,43,41,58,650,430,40,6,20,100,248,209,6202,4649,262,36,708,6411
17,72,93,88,31,1654,1057,69,23,47,253,611,214,16721,11640,589,98,1685,16935
17,73,94,191,91,1972,1187,103,26,48,247,1169,290,17665,12274,609,116,2063,17955
17,74,3,0,0,0,0,0,0,3,12,0,0,0,0,0,0,0,0
17,75,3,0,0,0,0,0,0,2,7,0,0,0,0,0,0,0,0
17,76,21,30,0,421,267,7,0,11,68,205,0,3898,2816,33,0,421,3898
17,77,4,0,0,0,0,0,0,2,9,0,0,0,0,0,0,0,0
17,78,4,0,0,0,0,0,0,3,12,0,0,0,0,0,0,0,0
17,79,5,0,0,0,0,0,0,3,16,0,0,0,0,0,0,0,0
17,80,5,0,0,0,0,0,0,3,17,0,0,0,0,0,0,0,0
17,81,8,0,0,0,0,0,0,4,16,0,0,0,0,0,0,0,0
17,84,6,0,0,0,0,0,0,3,14,0,0,0,0,0,0,0,0
17,87,2,0,0,0,0,0,0,1,11,0,0,0,0,0,0,0,0
17,88,1,0,0,0,0,0,0,1,6,0,0,0,0,0,0,0,0
17,91,8,0,0,0,0,0,0,2,16,0,0,0,0,0,0,0,0
18,66,207,0,0,0,0,0,0,17,584,0,0,0,0,0,0,0,0
18,67,38,0,0,0,0,0,0,18,98,0,0,0,0,0,0,0,0
18,69,17,0,0,0,0,0,0,7,39,0,0,0,0,0,0,0,0
18,70,11,8,8,133,90,12,4,6,27,77,36,1206,780,144,40,141,1242
18,71,12,13,2,222,113,11,7,8,27,83,8,1802,1081,32,31,224,1810
18,72,118,231,84,2938,1409,288,83,54,285,1549,284,23724,14305,1496,363,3022,24008
18,73,101,116,89,1949,802,251,71,61,292,707,436,15031,7708,1378,285,2038,15467
18,74,136,358,717,4601,1505,925,128,75,339,1442,2200,23809,12648,2439,263,5318,26009
18,75,99,301,123,2341,1403,157,8,55,326,2164,687,21528,14550,856,30,2464,22215
18,76,73,90,41,1191,730,47,28,32,208,645,255,11582,8025,290,129,1232,11837
18,77,28,0,0,0,0,0,0,12,68,0,0,0,0,0,0,0,0
18,78,31,26,0,182,134,0,0,16,70,244,0,1841,1384,0,0,182,1841
18,79,7,0,0,0,0,0,0,4,23,0,0,0,0,0,0,0,0
18,80,6,6,17,85,64,0,0,3,14,56,303,858,713,0,0,102,1161
18,83,4,0,0,0,0,0,0,1,8,0,0,0,0,0,0,0,0
18,84,4,0,0,0,0,0,0,1,8,0,0,0,0,0,0,0,0
18,85,7,0,0,0,0,0,0,3,18,0,0,0,0,0,0,0,0
18,87,12,0,0,0,0,0,0,4,27,0,0,0,0,0,0,0,0
19,66,14,58,33,444,145,57,13,10,40,309,188,3203,1238,486,90,477,3391
19,67,25,68,4,542,295,23,0,10,60,527,8,4998,2904,171,0,546,5006
19,69,18,53,19,582,259,67,7,7,61,324,80,4203,2263,354,24,601,4283
19,70,22,118,2,583,419,2,0,12,70,961,14,5489,4215,12,0,585,5503
19,71,5,0,0,0,0,0,0,2,15,0,0,0,0,0,0,0,0
19,72,46,130,2,1102,658,28,6,25,115,898,2,9845,6777,187,30,1104,9847
19,73,49,114,67,1772,673,227,45,27,153,574,311,11824,6209,846,125,1839,12135
19,74,35,73,8,617,279,71,22,17,95,430,20,4137,2409,305,57,625,4157
19,76,10,0,0,0,0,0,0,5,36,0,0,0,0,0,0,0,0
19,78,47,74,53,896,387,46,13,19,118,580,174,8007,3973,271,68,949,8181
19,80,16,6,0,92,35,2,0,8,36,76,0,901,383,14,0,92,901
19,81,5,0,0,0,0,0,0,1,12,0,0,0,0,0,0,0,0
19,82,9,19,0,205,128,22,0,4,19,157,0,2000,1460,127,0,205,2000
19,84,3,0,0,0,0,0,0,1,6,0,0,0,0,0,0,0,0
19,86,9,0,0,0,0,0,0,3,18,0,0,0,0,0,0,0,0
19,87,1,0,0,0,0,0,0,1,2,0,0,0,0,0,0,0,0
19,93,3,0,0,0,0,0,0,1,6,0,0,0,0,0,0,0,0
20,67,6,0,0,0,0,0,0,2,12,0,0,0,0,0,0,0,0
20,68,149,336,44,2907,1333,202,81,83,377,2270,271,23572,13276,1168,393,2951,23843
20,69,140,628,85,3717,1624,217,109,40,325,3807,306,27373,14880,1025,633,3802,27679
20,70,400,0,0,0,0,0,0,37,1185,0,0,0,0,0,0,0,0
20,71,37,0,0,0,0,0,0,20,111,0,0,0,0,0,0,0,0
20,72,2682,27451,6894,139361,34822,12109,13346,92,6263,139183,19707,850600,261920,54546,49298,146255,870307
20,73,919,7136,1065,39457,12071,3267,1793,335,2267,36645,3549,261037,105009,17695,7947,40522,264586
20,74,68,228,17,1580,985,77,7,24,157,1595,66,12953,8890,263,33,1597,13019
20,76,20,0,0,0,0,0,0,9,58,0,0,0,0,0,0,0,0
20,77,42,47,127,648,161,142,4,17,114,204,559,3426,1144,702,9,775,3985
20,78,32,54,4,445,209,26,10,12,69,292,45,4217,2357,124,63,449,4262
20,81,6,0,0,0,0,0,0,2,12,0,0,0,0,0,0,0,0
20,82,4,0,0,0,0,0,0,1,8,0,0,0,0,0,0,0,0
21,74,34,98,4,654,401,8,7,18,85,751,16,5883,3814,56,49,658,5899
21,76,17,141,152,969,273,238,36,5,39,319,289,2295,650,406,48,1121,2584
21,78,2,0,0,0,0,0,0,1,4,0,0,0,0,0,0,0,0
21,85,9,0,0,0,0,0,0,1,18,0,0,0,0,0,0,0,0
22,75,32,13,2,528,339,29,6,15,89,77,14,4574,3442,93,42,530,4588
22,76,7,0,0,0,0,0,0,4,18,0,0,0,0,0,0,0,0
22,77,24,66,6,577,286,29,0,10,60,437,55,4423,2737,95,0,583,4478
22,78,7,0,0,0,0,0,0,2,19,0,0,0,0,0,0,0,0
22,79,40,29,10,611,226,76,11,18,110,128,11,4194,2145,312,45,621,4205
22,80,25,48,11,614,330,59,10,16,62,298,22,5052,3291,351,40,625,5074
22,81,16,27,3,277,176,17,4,9,40,211,15,2273,1578,95,28,280,2288
22,82,8,15,0,95,58,3,0,3,19,140,0,812,496,12,0,95,812
22,95,7,0,0,0,0,0,0,4,15,0,0,0,0,0,0,0,0
22,96,3,0,0,0,0,0,0,3,8,0,0,0,0,0,0,0,0
23,78,96,327,30,2814,685,389,90,38,236,1591,88,16843,5437,1600,368,2844,16931
23,80,2,0,0,0,0,0,0,1,6,0,0,0,0,0,0,0,0
23,81,451,6518,1262,23940,3893,3284,1900,93,962,28127,3651,103704,25088,12365,7012,25202,107355
23,82,520,3214,465,20915,5183,2758,2393,155,1399,15166,2115,103935,29984,12816,10771,21380,106050
23,83,15,0,0,0,0,0,0,4,33,0,0,0,0,0,0,0,0
23,84,53,0,0,0,0,0,0,24,143,0,0,0,0,0,0,0,0
23,85,52,110,117,973,350,86,21,35,162,634,905,6325,3214,526,45,1090,7230
23,86,32,60,30,566,161,38,11,19,97,277,57,3036,1218,96,23,596,3093
23,87,3,0,0,0,0,0,0,1,8,0,0,0,0,0,0,0,0
23,91,6,16,6,189,57,27,0,5,19,59,16,930,444,87,0,195,946
23,92,21,101,58,444,158,25,14,7,48,303,148,3274,1431,64,63,502,3422
24,83,399,1192,618,15977,3585,1339,2730,36,1162,4935,2467,63489,16797,4910,11251,16595,65956
24,84,155,621,489,3582,823,320,119,66,364,3658,2280,23507,6502,2117,648,4071,25787
24,85,1212,9860,13023,72612,12847,7340,5491,290,2906,39291,32477,278562,73937,25523,14241,85635,311039
24,86,840,4786,1468,33310,7906,2948,1330,227,2151,19984,5093,145728,43404,9737,4637,34778,150821
24,87,22,40,8,790,267,50,28,14,70,214,33,5528,2433,264,158,798,5561
24,88,1,0,0,0,0,0,0,1,6,0,0,0,0,0,0,0,0
24,89,8,5,9,119,36,14,0,6,22,19,43,1021,362,108,0,128,1064
24,91,2,0,0,0,0,0,0,2,6,0,0,0,0,0,0,0,0
24,92,1,0,0,0,0,0,0,1,2,0,0,0,0,0,0,0,0
24,94,3,0,0,0,0,0,0,1,6,0,0,0,0,0,0,0,0
24,95,20,0,0,0,0,0,0,7,52,0,0,0,0,0,0,0,0
25,48,70,0,0,0,0,0,0,34,190,0,0,0,0,0,0,0,0
25,75,3,0,0,0,0,0,0,2,8,0,0,0,0,0,0,0,0
25,76,15,54,23,387,124,35,26,11,42,355,181,3186,1185,285,247,410,3367
25,86,354,0,0,0,0,0,0,26,674,0,0,0,0,0,0,0,0
25,87,1365,25820,13131,107586,15152,10955,6788,215,2796,98469,32437,366999,71385,29253,15425,120717,399436
25,88,2004,28241,38650,176613,18276,19977,12010,437,4269,95454,84088,537448,88694,48579,25572,215263,621536
25,89,54,95,137,1494,490,288,46,35,151,388,298,8552,4367,993,105,1631,8850
25,90,15,39,73,432,55,120,21,9,30,141,151,1381,268,314,27,505,1532
25,91,14,0,0,0,0,0,0,4,37,0,0,0,0,0,0,0,0
25,92,2,0,0,0,0,0,0,1,4,0,0,0,0,0,0,0,0
26,74,1,0,0,0,0,0,0,1,6,0,0,0,0,0,0,0,0
26,76,1,0,0,0,0,0,0,1,4,0,0,0,0,0,0,0,0
26,88,58,85,860,1752,247,291,135,27,155,318,2890,8196,1753,861,454,2612,11086
26,89,196,455,936,8417,1557,2521,148,125,567,1729,2813,35928,11617,6208,486,9353,38741
26,95,2,0,0,0,0,0,0,1,4,0,0,0,0,0,0,0,0
27,41,42,281,162,763,80,77,165,27,126,2548,874,6124,810,536,1104,925,6998
27,62,4,0,0,0,0,0,0,4,13,0,0,0,0,0,0,0,0
27,64,1,0,0,0,0,0,0,1,2,0,0,0,0,0,0,0,0
27,75,9,0,0,0,0,0,0,2,22,0,0,0,0,0,0,0,0
27,87,1,0,0,0,0,0,0,1,4,0,0,0,0,0,0,0,0
27,88,92,205,246,3166,776,550,37,63,248,938,846,16297,6150,1683,112,3412,17143
27,89,16,11,92,526,35,68,7,9,39,21,188,1231,209,116,15,618,1419
27,90,20,37,10,406,172,13,12,8,48,247,19,3144,1735,108,16,416,3163
27,91,4,0,0,0,0,0,0,2,9,0,0,0,0,0,0,0,0
27,93,1,0,0,0,0,0,0,1,2,0,0,0,0,0,0,0,0
28,41,16,212,63,433,47,37,55,9,51,1897,416,3711,394,331,424,496,4127
28,58,38,118,41,908,115,460,84,19,103,902,249,7277,1010,3586,649,949,7526
28,59,652,0,0,0,0,0,0,58,1928,0,0,0,0,0,0,0,0
28,62,1,0,0,0,0,0,0,1,4,0,0,0,0,0,0,0,0
28,63,189,1445,126,5606,1498,1158,352,51,516,9295,519,36715,11094,7727,2372,5732,37234
28,75,72,0,0,0,0,0,0,9,203,0,0,0,0,0,0,0,0
28,87,191,113,304,2593,242,705,131,42,512,435,923,10079,1252,2382,378,2897,11002
28,88,73,163,449,3207,465,627,38,63,207,550,1754,13239,2786,1845,109,3656,14993
28,89,14,16,50,679,180,80,20,10,38,37,107,2928,1492,252,40,729,3035
28,90,26,56,214,643,237,90,20,15,76,355,506,4259,2480,302,24,857,4765
28,91,12,7,237,232,58,100,14,4,27,37,505,1538,301,988,52,469,2043
29,57,11,9,6,177,28,58,10,7,32,47,28,1201,302,421,52,183,1229
29,58,174,375,172,3539,381,612,1757,80,470,3187,1288,28241,3581,4431,14010,3711,29529
29,59,1,0,0,0,0,0,0,1,4,0,0,0,0,0,0,0,0
29,67,10,8,1,101,15,7,43,10,21,50,10,1048,161,34,495,102,1058
29,87,119,76,359,1553,155,301,30,20,252,246,1648,4102,626,564,79,1912,5750
29,88,20,14,43,455,135,62,18,16,54,44,279,2398,1113,278,39,498,2677
29,89,1,0,0,0,0,0,0,1,2,0,0,0,0,0,0,0,0
29,90,1,0,0,0,0,0,0,1,3,0,0,0,0,0,0,0,0
29,91,2,0,0,0,0,0,0,1,4,0,0,0,0,0,0,0,0
30,46,4,44,0,169,41,9,27,3,15,314,0,1582,516,56,265,169,1582
30,49,8,14,2,168,22,44,19,7,32,78,4,1291,204,330,184,170,1295
30,50,18,21,17,373,97,70,120,10,54,216,90,3129,994,434,948,390,3219
30,51,1,0,0,0,0,0,0,1,2,0,0,0,0,0,0,0,0
30,52,503,1273,373,14101,5351,1397,2836,18,1500,8781,2310,97571,39721,9887,23293,14474,99881
30,54,1,0,0,0,0,0,0,1,3,0,0,0,0,0,0,0,0
30,55,2,0,0,0,0,0,0,1,11,0,0,0,0,0,0,0,0
30,57,31,160,19,657,146,168,37,19,91,1346,114,5216,1322,1340,261,676,5330
30,66,2379,7904,4181,78371,22031,15962,17060,322,6588,55746,23356,577107,208395,96920,127970,82552,600463
30,67,11,23,19,237,24,117,5,7,26,94,92,1277,156,659,15,256,1369
30,87,789,3955,18148,83655,9190,13902,1865,325,1943,7604,32238,175546,21232,26180,4746,101803,207784
30,88,26,63,407,1887,186,560,39,20,64,219,1175,5181,787,1296,75,2294,6356
30,89,5,6,11,73,52,0,0,4,19,14,77,530,371,0,0,84,607
30,90,4,0,0,0,0,0,0,1,8,0,0,0,0,0,0,0,0
31,44,5,0,0,0,0,0,0,2,13,0,0,0,0,0,0,0,0
31,45,207,393,357,4429,772,1231,1029,93,587,3350,2808,38300,8226,10352,8438,4786,41108
31,46,35,61,54,794,114,326,109,23,98,446,255,5511,864,2017,910,848,5766
31,47,3,0,0,0,0,0,0,2,8,0,0,0,0,0,0,0,0
31,49,45,93,82,1157,156,106,498,23,142,788,556,9805,1535,739,4218,1239,10361
31,50,1168,1854,1234,38974,6654,3462,22277,100,3665,12673,6516,299013,56819,24740,176726,40208,305529
31,54,1,0,0,0,0,0,0,1,4,0,0,0,0,0,0,0,0
31,55,12,65,4,404,36,173,21,8,36,379,32,2859,236,1229,257,408,2891
31,56,5,6,1,90,21,26,9,3,14,38,8,602,221,135,80,91,610
31,57,5,0,0,0,0,0,0,2,12,0,0,0,0,0,0,0,0
31,60,4,9,19,168,14,69,12,3,10,21,52,503,68,248,34,187,555
31,62,23,49,62,521,38,228,54,14,53,309,310,2782,221,1283,312,583,3092
31,64,10,28,21,264,21,123,17,6,24,187,100,1586,215,636,76,285,1686
31,67,15,46,25,423,132,87,16,12,40,355,147,2971,1193,475,116,448,3118
31,73,68,83,42,1843,575,255,91,35,176,544,186,12624,5667,1531,656,1885,12810
31,74,344,0,0,0,0,0,0,3,1031,0,0,0,0,0,0,0,0
31,86,4,9,37,112,9,21,5,4,11,27,92,280,29,78,7,149,372
31,87,112,525,3459,12344,857,1788,265,58,259,1019,5953,23186,2499,2997,380,15803,29139
31,88,1,0,0,0,0,0,0,1,2,0,0,0,0,0,0,0,0
31,89,7,0,0,0,0,0,0,3,16,0,0,0,0,0,0,0,0
31,90,22,19,42,240,49,68,2,11,51,59,134,944,326,197,4,282,1078
31,91,9,0,0,0,0,0,0,4,27,0,0,0,0,0,0,0,0
32,55,1,0,0,0,0,0,0,1,4,0,0,0,0,0,0,0,0
32,73,131,324,65,3095,1392,313,132,53,327,2141,409,23084,13381,2020,661,3160,23493
32,86,215,506,4618,5102,1061,804,175,74,545,2546,12939,27488,8399,2657,422,9720,40427
32,87,11,25,104,526,40,108,7,11,30,78,262,2186,161,333,12,630,2448
32,88,23,42,91,370,122,53,7,12,77,114,260,1828,714,177,271,461,2088
32,89,64,104,1622,1201,224,288,86,13,173,281,3422,3443,1236,512,157,2823,6865
32,90,26,55,187,629,152,256,5,12,67,142,589,2181,763,625,7,816,2770
33,43,45,132,192,568,116,101,66,6,101,599,1262,3310,883,465,493,760,4572
33,44,44,45,84,831,113,145,410,12,130,262,569,6469,1198,1159,3281,915,7038
33,55,11,18,7,204,35,53,3,7,28,121,34,1370,290,374,15,211,1404
33,71,229,399,331,6820,1717,929,1414,99,687,2585,2038,48028,16662,5805,7683,7151,50066
33,72,92,163,68,2206,693,321,237,38,278,1282,269,12368,5552,1637,856,2274,12637
33,73,13,45,1,400,209,43,2,7,33,362,8,3264,1911,350,14,401,3272
33,74,16,0,0,0,0,0,0,7,40,0,0,0,0,0,0,0,0
33,75,358,868,485,9027,2133,1210,1739,175,1061,5755,2704,66486,19191,8566,11282,9512,69190
33,76,299,2316,370,8907,2249,1233,919,80,694,12704,1743,54757,18487,6993,4845,9277,56500
33,85,28,20,20,330,70,30,3,16,90,92,161,2934,627,320,17,350,3095
33,86,20,39,73,597,195,56,7,13,54,219,623,4023,1562,276,14,670,4646
33,87,3,0,0,0,0,0,0,1,10,0,0,0,0,0,0,0,0
33,88,1,0,0,0,0,0,0,1,4,0,0,0,0,0,0,0,0
34,43,4233,22514,26063,136178,34001,19899,26653,621,10970,140141,109534,964476,288165,125601,185220,162241,1074010
34,44,41,137,96,1132,291,227,155,19,115,949,427,8541,2813,1549,1033,1228,8968
34,49,477,0,0,0,0,0,0,14,1421,0,0,0,0,0,0,0,0
34,72,33,90,47,826,262,152,27,18,96,637,126,5432,2372,742,75,873,5558
34,73,7,0,0,0,0,0,0,3,14,0,0,0,0,0,0,0,0
34,74,22,32,3,206,124,0,2,9,50,270,21,1945,1169,0,14,209,1966
34,75,185,0,0,0,0,0,0,97,486,0,0,0,0,0,0,0,0
34,76,1905,10581,10100,68993,18669,7558,7642,694,4991,52337,39687,403610,134558,43795,35401,79093,443297
34,78,24,0,0,0,0,0,0,15,66,0,0,0,0,0,0,0,0
34,85,1,0,0,0,0,0,0,1,2,0,0,0,0,0,0,0,0
34,86,24,24,69,575,123,71,9,24,67,108,166,2791,812,362,29,644,2957
34,87,7,5,46,154,11,29,8,6,15,23,153,474,112,67,23,200,627
35,42,970,6654,11271,28780,5823,5622,3617,159,2463,36329,62064,171766,44455,29838,18553,40051,233830
35,48,21,30,18,316,48,89,97,12,58,394,106,3102,464,924,862,334,3208
35,49,10,0,0,0,0,0,0,4,21,0,0,0,0,0,0,0,0
35,71,19,61,16,455,148,88,0,10,48,384,92,3354,1362,452,0,471,3446
35,72,102,367,118,3138,719,739,140,44,293,1885,343,17426,5771,3913,476,3256,17769
35,75,80,0,0,0,0,0,0,40,223,0,0,0,0,0,0,0,0
35,76,194,350,469,4861,1374,815,331,98,532,2303,2581,33757,12947,4978,1609,5330,36338
35,77,163,352,553,5078,1037,586,845,77,482,1770,2918,31828,8950,3335,4620,5631,34746
35,78,1901,10356,5218,90186,30887,5668,20052,311,4947,53414,21537,515052,212636,27377,98802,95404,536589
35,80,2,0,0,0,0,0,0,1,4,0,0,0,0,0,0,0,0
35,81,433,383,2648,17815,2127,752,1219,63,947,1606,10311,82958,11419,2814,5669,20463,93269
35,82,244,335,2213,5697,1039,429,1798,76,663,2025,12923,35000,8592,2786,9240,7910,47923
35,84,952,664,2683,30532,3103,967,11336,62,2354,2797,13514,122764,13229,2417,47722,33215,136278
35,86,13,33,6,330,146,24,5,11,38,239,18,2428,1355,107,9,336,2446
35,92,1,0,0,0,0,0,0,1,4,0,0,0,0,0,0,0,0
35,93,10,0,0,0,0,0,0,1,35,0,0,0,0,0,0,0,0
35,103,6,0,0,0,0,0,0,2,17,0,0,0,0,0,0,0,0
35,104,1,0,0,0,0,0,0,1,3,0,0,0,0,0,0,0,0
36,40,1,0,0,0,0,0,0,1,4,0,0,0,0,0,0,0,0
36,42,4,0,0,0,0,0,0,1,14,0,0,0,0,0,0,0,0
36,70,1184,4780,1651,48592,13944,5924,10253,215,3397,27318,9038,283606,98940,30182,54658,50243,292644
36,71,228,677,399,7474,1457,1688,341,118,649,3119,1753,40747,10455,9118,1516,7873,42500
36,75,61,27,45,643,270,116,7,29,155,198,250,5462,2833,830,47,688,5712
36,76,53,128,72,1313,516,238,30,19,121,876,279,9024,4817,943,131,1385,9303
36,77,13,0,0,0,0,0,0,7,38,0,0,0,0,0,0,0,0
36,78,6,0,0,0,0,0,0,2,14,0,0,0,0,0,0,0,0
36,83,28,29,58,323,119,26,14,13,68,246,305,2754,1151,180,56,381,3059
36,84,84,109,1088,1916,299,292,111,24,201,447,2931,6126,1838,726,317,3004,9057
36,85,21,51,55,472,118,44,24,12,48,230,146,2110,724,183,98,527,2256
36,86,4,2,0,131,100,0,0,4,12,8,0,1338,1043,0,0,131,1338
36,101,5,0,0,0,0,0,0,2,16,0,0,0,0,0,0,0,0
36,103,4,0,0,0,0,0,0,3,12,0,0,0,0,0,0,0,0
37,39,20,0,0,0,0,0,0,11,64,0,0,0,0,0,0,0,0
37,40,1,0,0,0,0,0,0,1,2,0,0,0,0,0,0,0,0
37,41,2,0,0,0,0,0,0,1,4,0,0,0,0,0,0,0,0
37,70,806,4858,803,21208,7628,1464,1366,7,2100,19310,2199,100301,43398,4927,3846,22011,102500
37,71,1404,8043,2964,56621,14920,8705,2851,441,3755,40938,11263,318043,105911,44278,13314,59585,329306
37,72,24,38,41,520,225,94,32,13,57,202,184,3870,2049,524,164,561,4054
37,75,84,218,16,1429,817,74,6,30,187,1584,105,12249,8244,379,12,1445,12354
37,76,37,52,32,733,254,99,12,23,95,267,94,4864,2425,502,28,765,4958
37,77,134,571,178,4969,1096,349,600,49,425,2893,644,29346,9178,1785,3539,5147,29990
37,78,178,308,199,4288,1304,403,666,81,480,2139,1119,32714,12467,2898,4335,4487,33833
37,79,11,17,0,129,48,27,7,4,24,94,0,974,481,167,49,129,974
37,81,19,32,50,430,127,11,36,11,53,293,550,3697,1346,81,276,480,4247
37,82,156,473,467,3480,1270,217,203,76,429,3171,2341,25778,11476,1553,956,3947,28119
37,83,68,18,10,322,87,37,27,36,171,96,26,1467,743,111,43,332,1493
37,84,6,0,0,0,0,0,0,5,25,0,0,0,0,0,0,0,0
37,85,27,34,18,432,162,34,3,12,59,216,58,3060,1474,193,10,450,3118
37,98,19,0,0,0,0,0,0,3,48,0,0,0,0,0,0,0,0
37,101,14,0,251,45,2,6,9,8,73,0,605,97,3,14,20,296,702
38,70,94,254,120,2464,449,177,855,28,231,1791,803,17474,3461,1220,5878,2584,18277
38,71,14,80,4,421,195,14,11,5,42,647,4,3538,1915,99,77,425,3542
38,72,271,765,349,7018,2236,963,742,135,746,4646,1963,48689,20307,5780,4528,7367,50652
38,73,3,0,0,0,0,0,0,2,11,0,0,0,0,0,0,0,0
38,74,26,93,10,587,337,19,4,15,80,615,16,4762,3238,89,4,597,4778
38,76,58,206,9,1102,508,74,8,25,142,1502,46,9613,5288,555,60,1111,9659
38,77,24,41,3,407,245,14,19,16,85,279,9,3520,2432,122,82,410,3529
38,78,226,1226,187,8896,3288,402,1345,69,670,7781,1257,53573,22302,2218,7735,9083,54830
38,81,235,538,798,6091,2052,313,285,113,694,2952,4454,43983,18905,1865,1478,6889,48437
38,82,132,249,507,3008,966,176,185,55,351,1589,2716,19934,8258,777,934,3515,22650
38,83,18,11,25,280,155,8,0,7,41,97,39,2402,1601,60,0,305,2441
39,32,5,17,31,85,6,17,31,3,14,171,242,831,31,160,401,116,1073
39,33,3,0,0,0,0,0,0,2,14,0,0,0,0,0,0,0,0
39,70,2274,8519,3074,64129,14617,7357,17309,327,6511,49912,15725,385042,104838,38507,103067,67203,400767
39,71,118,1266,495,5116,1613,552,350,34,327,4623,1782,21857,7940,2632,1133,5611,23639
39,75,85,188,112,2324,794,330,159,51,255,1362,683,17060,7496,2317,891,2436,17743
39,76,11,20,0,197,79,20,14,6,30,141,0,1595,737,88,110,197,1595
39,77,341,665,371,9438,2575,1258,873,167,1024,4400,1901,68005,24515,8451,4785,9809,69906
39,80,763,1243,3234,21981,5035,673,3121,208,2055,7363,14909,141258,42125,3594,16332,25215,156167
39,81,53,66,202,985,388,50,22,28,151,385,1221,7469,3697,342,99,1187,8690
39,82,10,28,3,187,107,9,0,7,30,224,12,1799,1177,87,0,190,1811
39,83,5,7,7,92,27,0,0,4,18,26,32,690,309,0,0,99,722
39,86,4,3,30,56,14,6,6,4,12,6,64,303,158,16,14,86,367
39,90,3,0,0,0,0,0,0,2,6,0,0,0,0,0,0,0,0
39,98,4,0,0,0,0,0,0,1,8,0,0,0,0,0,0,0,0
39,100,3,0,0,0,0,0,0,2,8,0,0,0,0,0,0,0,0
40,32,4,0,0,0,0,0,0,2,12,0,0,0,0,0,0,0,0
40,33,10,19,34,152,17,44,44,7,30,152,211,1031,96,283,309,186,1242
40,73,227,940,258,7404,2900,652,244,112,615,5002,959,49619,24734,3286,1229,7662,50578
40,74,113,889,438,5523,1403,532,971,48,295,3748,1103,24877,9716,2022,2252,5961,25980
40,75,1,0,0,0,0,0,0,1,4,0,0,0,0,0,0,0,0
40,77,630,1164,314,15570,4362,1261,4146,135,1858,7638,1741,105270,39257,7056,22743,15884,107011
40,78,46,345,39,1814,335,149,271,15,114,2118,206,11744,2658,753,1793,1853,11950
40,79,1810,11759,10089,63953,17438,2940,6301,530,4465,50546,39280,345530,124954,10355,24584,74042,384810
40,80,1592,7483,10145,46078,7824,1049,2900,311,3674,33522,55618,261048,64718,4578,12704,56223,316666
40,81,52,83,125,518,215,31,19,18,138,621,400,3537,1859,182,31,643,3937
40,82,38,161,98,961,332,41,101,17,99,771,378,5586,2680,193,365,1059,5964
40,86,7,0,0,0,0,0,0,6,20,0,0,0,0,0,0,0,0
40,87,4,0,0,0,0,0,0,3,9,0,0,0,0,0,0,0,0
40,92,23,10,756,662,117,85,13,10,56,14,1698,1531,361,135,29,1418,3229
40,93,17,0,0,0,0,0,0,13,45,0,0,0,0,0,0,0,0
40,99,1,0,0,0,0,0,0,1,4,0,0,0,0,0,0,0,0
41,67,516,326,27,2465,432,386,98,64,1454,2079,168,16914,3330,2518,754,2492,17082
41,78,209,1228,4629,9414,1020,556,977,32,746,4249,17137,43403,5446,1838,4426,14043,60540
41,79,1625,3996,11248,49634,14881,1854,2854,663,4673,20580,48182,302822,116057,8621,13002,60882,351004
41,80,44,186,63,915,538,8,6,20,125,1352,454,8042,5295,64,16,978,8496
41,81,85,184,11,2018,1317,47,1,46,276,1223,24,17549,12496,282,2,2029,17573
41,82,4,0,0,0,0,0,0,1,8,0,0,0,0,0,0,0,0
41,85,20,0,219,213,53,14,11,11,54,0,491,1030,436,42,14,432,1521
41,86,94,69,3456,1631,260,172,91,33,234,223,9710,7674,1979,455,228,5087,17384
41,87,36,57,1387,2949,92,130,28,7,71,104,2404,3610,236,166,47,4336,6014
41,89,9,13,175,455,118,23,5,4,26,28,527,1158,384,35,7,630,1685
41,90,5,0,0,0,0,0,0,3,11,0,0,0,0,0,0,0,0
42,57,10,69,2,304,70,9,54,3,28,469,10,2330,658,80,443,306,2340
42,58,568,1891,1026,14754,3664,1073,1902,121,1536,12935,6414,110144,34230,7760,13302,15780,116558
42,59,153,654,93,3279,1073,157,351,46,427,4601,726,27867,11179,1023,2485,3372,28593
42,68,1,0,0,0,0,0,0,1,4,0,0,0,0,0,0,0,0
42,69,88,145,131,2110,315,489,96,37,228,911,466,11940,2390,2737,355,2241,12406
42,78,2337,9662,14066,86516,17884,4058,17827,438,6265,37215,73271,417738,99221,13541,81382,100582,491009
42,79,42,53,57,478,343,10,0,13,113,421,100,4341,3211,100,0,535,4441
42,80,38,25,36,644,396,30,0,26,126,136,230,5924,4162,216,0,680,6154
42,81,2,0,0,0,0,0,0,2,10,0,0,0,0,0,0,0,0
42,87,11,0,0,0,0,0,0,5,34,0,0,0,0,0,0,0,0
42,88,6,0,0,0,0,0,0,3,13,0,0,0,0,0,0,0,0
42,89,13,5,251,95,2,15,5,8,33,5,496,237,4,15,7,346,733
42,98,1,0,0,0,0,0,0,1,6,0,0,0,0,0,0,0,0
43,34,8,0,0,0,0,0,0,4,22,0,0,0,0,0,0,0,0
43,35,136,352,820,1742,193,262,531,86,404,3834,6412,16091,1910,2167,5316,2562,22503
43,56,368,588,399,4068,775,593,499,31,874,4603,2569,31530,7315,4494,3540,4467,34099
43,57,168,288,142,3744,1380,395,134,73,565,2102,852,31004,13709,3391,1003,3886,31856
43,58,585,1636,360,12391,5779,1004,527,216,1787,12181,2249,106801,60307,7601,3785,12751,109050
43,59,195,520,122,4463,1920,444,191,66,560,3708,630,36365,19619,3455,1351,4585,36995
43,60,784,1827,828,21152,8622,1075,961,265,2459,11664,5087,164372,77967,8167,6544,21980,169459
43,61,48,18,16,219,72,14,13,5,150,178,135,1946,686,76,143,235,2081
43,67,401,2669,415,14047,2610,1096,835,156,1033,15299,2099,89869,20668,5634,4487,14462,91968
43,68,665,2538,1093,23667,4505,3437,1443,270,1847,14214,4950,145356,36089,18912,7022,24760,150306
43,78,19,39,29,244,137,2,0,9,65,295,45,2307,1461,20,0,273,2352
43,79,35,133,16,910,455,38,21,27,130,919,68,7848,4483,292,96,926,7916
44,35,24,35,183,266,24,29,120,16,70,340,1411,2389,248,208,1154,449,3800
44,52,343,1284,2319,9754,1356,1335,1680,79,868,7146,8023,60168,11107,8789,10249,12073,68191
44,53,5,0,0,0,0,0,0,1,10,0,0,0,0,0,0,0,0
44,56,394,1368,746,7619,2588,1258,390,128,1073,9286,3119,60514,26153,9346,2547,8365,63633
44,57,364,575,506,6795,2043,1367,278,131,1030,3920,3222,51909,20225,9563,1842,7301,55131
44,58,33,63,62,905,319,95,16,15,111,505,370,7593,3228,696,90,967,7963
44,60,2389,11050,2545,66849,24446,3040,4711,189,6844,75509,15022,519722,227406,21248,35633,69394,534744
44,68,2647,23508,7017,123122,26770,12490,16886,461,7193,122048,25709,712856,189954,67837,79356,130139,738565
44,77,731,388,1021,7560,1990,451,398,187,2360,2077,5392,50914,17427,2807,1969,8581,56306
44,78,47,49,20,752,407,45,4,31,132,305,158,6622,3789,360,4,772,6780
44,79,1,0,0,0,0,0,0,1,4,0,0,0,0,0,0,0,0
44,81,2,0,0,0,0,0,0,1,4,0,0,0,0,0,0,0,0
44,87,3,0,0,0,0,0,0,2,8,0,0,0,0,0,0,0,0
44,91,55,81,2516,3693,148,317,72,12,145,119,5316,5117,225,464,103,6209,10433
44,92,33,32,730,615,59,104,66,14,106,119,1487,1172,80,121,171,1345,2659
44,95,3,0,0,0,0,0,0,1,9,0,0,0,0,0,0,0,0
44,96,6,0,0,0,0,0,0,4,18,0,0,0,0,0,0,0,0
45,50,8,0,0,0,0,0,0,5,24,0,0,0,0,0,0,0,0
45,51,17,28,18,294,24,64,51,5,50,248,113,2259,217,464,376,312,2372
45,52,8,0,0,0,0,0,0,2,16,0,0,0,0,0,0,0,0
45,56,2497,11550,7881,72421,24741,7609,6801,488,6458,62620,32368,461181,189183,45527,43341,80302,493549
45,57,89,159,141,1883,609,437,55,46,298,1261,708,14866,6069,3346,347,2024,15574
45,76,450,1211,7335,14198,1571,398,1360,89,1255,5205,30457,90209,13147,2052,5751,21533,120666
45,77,946,2111,4253,23930,6392,1434,1245,403,2809,9865,20728,158997,56275,8092,5413,28183,179725
45,88,8,0,0,0,0,0,0,3,21,0,0,0,0,0,0,0,0
45,91,2,0,0,0,0,0,0,2,7,0,0,0,0,0,0,0,0
45,95,4,0,0,0,0,0,0,2,7,0,0,0,0,0,0,0,0
46,29,12,7,25,149,22,10,58,8,37,43,253,1241,212,56,553,174,1494
46,49,1,0,0,0,0,0,0,1,3,0,0,0,0,0,0,0,0
46,55,675,1816,728,13220,5503,1259,1053,257,1958,13543,4767,113667,57882,10133,7693,13948,118434
46,56,262,732,329,5511,2173,506,509,112,816,4678,2139,45499,22311,3936,3863,5840,47638
46,76,395,775,648,10505,3515,862,697,111,1115,4192,2368,61571,26422,3149,3046,11153,63939
46,77,5,0,0,0,0,0,0,3,12,0,0,0,0,0,0,0,0
46,80,1,0,0,0,0,0,0,1,4,0,0,0,0,0,0,0,0
46,87,2,0,0,0,0,0,0,2,6,0,0,0,0,0,0,0,0
46,88,3,0,0,0,0,0,0,2,12,0,0,0,0,0,0,0,0
46,90,1,0,0,0,0,0,0,1,3,0,0,0,0,0,0,0,0
46,94,3,0,0,0,0,0,0,2,6,0,0,0,0,0,0,0,0
46,95,19,0,0,0,0,0,0,6,46,0,0,0,0,0,0,0,0
47,29,26,20,39,266,24,50,110,14,81,167,278,2379,251,452,1121,305,2657
47,35,25,13,42,151,8,26,69,16,71,175,474,1584,36,319,656,193,2058
47,48,34,0,0,0,0,0,0,4,104,0,0,0,0,0,0,0,0
47,49,193,0,0,0,0,0,0,52,501,0,0,0,0,0,0,0,0
47,54,150,301,190,2942,1295,285,243,62,450,2287,1385,25961,13549,2167,1980,3132,27346
47,55,398,1290,412,7651,3358,714,627,145,1136,8972,2712,65055,35345,5501,4639,8063,67767
47,74,4,0,0,0,0,0,0,2,9,0,0,0,0,0,0,0,0
47,75,889,1491,668,24601,7417,2315,1822,105,2605,7049,2829,117646,37805,9247,8171,25269,120475
47,76,115,148,131,2423,555,175,193,45,320,974,670,17074,5211,1077,1032,2554,17744
47,77,5,0,0,0,0,0,0,4,14,0,0,0,0,0,0,0,0
47,78,2,0,0,0,0,0,0,1,4,0,0,0,0,0,0,0,0
47,86,12,0,0,0,0,0,0,1,43,0,0,0,0,0,0,0,0
47,87,20,2,392,130,5,8,40,8,45,12,766,392,20,14,77,522,1158
47,88,6,8,308,26,4,0,3,4,16,24,684,90,28,0,8,334,774
47,89,2,0,0,0,0,0,0,1,4,0,0,0,0,0,0,0,0
47,92,5,0,0,0,0,0,0,1,10,0,0,0,0,0,0,0,0
47,95,4,0,0,0,0,0,0,2,7,0,0,0,0,0,0,0,0
47,96,8,0,100,60,11,4,0,5,20,0,328,437,75,19,0,160,765
48,28,3,0,0,0,0,0,0,1,12,0,0,0,0,0,0,0,0
48,72,121,85,35,1780,448,267,94,14,342,523,210,9788,2890,1284,480,1815,9998
48,80,13,0,0,0,0,0,0,5,25,0,0,0,0,0,0,0,0
48,86,3,0,0,0,0,0,0,2,8,0,0,0,0,0,0,0,0
48,87,10,0,54,11,3,2,0,5,30,0,244,69,21,12,0,65,313
48,90,3,0,0,0,0,0,0,1,6,0,0,0,0,0,0,0,0
48,94,13,0,0,0,0,0,0,6,57,0,0,0,0,0,0,0,0
48,96,6,0,0,0,0,0,0,3,11,0,0,0,0,0,0,0,0
48,97,3,0,0,0,0,0,0,2,6,0,0,0,0,0,0,0,0
49,23,2,0,0,0,0,0,0,1,6,0,0,0,0,0,0,0,0
49,27,18,37,44,304,29,25,131,13,57,358,348,2863,260,348,1378,348,3211
49,59,32,111,16,759,210,51,45,19,110,722,70,5811,1898,361,340,775,5881
49,60,43,0,0,0,0,0,0,24,144,0,0,0,0,0,0,0,0
49,69,998,2589,1124,43864,10394,4487,918,501,2894,8765,3506,189137,62224,15114,3580,44988,192643
49,70,40,71,3,705,303,44,22,21,124,442,5,5772,3111,242,122,708,5777
49,71,89,115,13,1920,613,157,59,23,266,612,38,9982,3863,705,234,1933,10020
49,72,2,0,0,0,0,0,0,1,8,0,0,0,0,0,0,0,0
49,76,5,8,0,73,44,0,0,3,12,53,0,706,500,0,0,73,706
49,87,15,7,356,95,14,14,6,4,27,8,850,416,147,21,9,451,1266
49,90,1,0,0,0,0,0,0,1,3,0,0,0,0,0,0,0,0
49,92,5,0,0,0,0,0,0,2,9,0,0,0,0,0,0,0,0
49,96,1,0,0,0,0,0,0,1,5,0,0,0,0,0,0,0,0
49,98,5,0,0,0,0,0,0,2,10,0,0,0,0,0,0,0,0
50,22,84,426,548,4296,1461,583,677,27,258,2338,3416,27537,9128,3770,5833,4844,30953
50,27,3,0,0,0,0,0,0,2,10,0,0,0,0,0,0,0,0
50,45,2170,1287,488,9270,1583,1568,544,159,6276,4652,1439,42204,8246,8367,2087,9758,43643
50,46,2861,7799,3104,91049,21932,21937,3510,1073,8019,35918,13693,513803,127657,136891,21107,94153,527496
50,47,474,329,446,8208,968,1136,1670,157,1308,2388,3781,60281,9202,7894,13051,8654,64062
50,48,20,20,21,680,30,13,82,9,60,146,227,5331,327,112,768,701,5558
50,54,55,0,0,0,0,0,0,22,159,0,0,0,0,0,0,0,0
50,55,64,80,52,997,180,61,370,44,188,496,234,7474,1650,304,2680,1049,7708
50,58,2,0,0,0,0,0,0,1,6,0,0,0,0,0,0,0,0
50,59,3,0,0,0,0,0,0,1,6,0,0,0,0,0,0,0,0
50,62,70,308,63,1650,220,168,65,36,214,2101,260,10838,1529,1204,354,1713,11098
50,66,454,973,654,17421,5149,1144,647,141,1345,4094,1557,77684,27829,4390,3006,18075,79241
50,68,6,0,0,0,0,0,0,2,18,0,0,0,0,0,0,0,0
50,69,30,88,37,1607,273,170,36,16,82,239,146,5730,1336,540,140,1644,5876
50,71,1,0,0,0,0,0,0,1,6,0,0,0,0,0,0,0,0
50,74,1,0,0,0,0,0,0,1,2,0,0,0,0,0,0,0,0
50,90,63,77,1666,3113,219,576,41,15,147,116,3777,3774,320,694,92,4779,7551
50,91,5,0,0,0,0,0,0,2,14,0,0,0,0,0,0,0,0
50,93,3,0,0,0,0,0,0,2,8,0,0,0,0,0,0,0,0
51,22,94,272,297,2356,669,347,220,22,288,2196,2083,18127,6088,2445,1960,2653,20210
51,26,31,36,34,245,22,13,99,17,90,433,314,2340,255,117,1015,279,2654
51,44,435,587,809,8167,687,1599,2430,262,1129,2576,5646,49823,4019,9237,18939,8976,55469
51,45,137,402,134,4624,615,613,97,24,576,1597,377,20961,3297,3406,470,4758,21338
51,46,43,17,59,360,54,76,42,16,116,95,538,2847,514,588,345,419,3385
51,53,2,0,0,0,0,0,0,2,4,0,0,0,0,0,0,0,0
51,66,8,12,0,298,131,20,5,4,24,104,0,2487,1474,124,30,298,2487
51,67,15,18,10,700,155,45,18,4,48,72,18,3826,1220,275,73,710,3844
51,68,2,0,0,0,0,0,0,1,4,0,0,0,0,0,0,0,0
51,70,4,0,0,0,0,0,0,2,10,0,0,0,0,0,0,0,0
51,71,5,3,4,129,83,7,6,5,18,21,8,1011,697,32,36,133,1019
51,73,1,0,0,0,0,0,0,1,6,0,0,0,0,0,0,0,0
51,96,1,0,0,0,0,0,0,1,4,0,0,0,0,0,0,0,0
52,22,44,42,110,375,52,88,51,18,112,288,501,2549,396,652,353,485,3050
52,41,878,560,1204,17438,1637,1625,3508,280,2468,4240,8972,143437,16475,12852,29715,18642,152409
52,45,97,0,0,0,0,0,0,24,270,0,0,0,0,0,0,0,0
52,65,2,0,0,0,0,0,0,2,10,0,0,0,0,0,0,0,0
52,68,5,0,0,0,0,0,0,1,10,0,0,0,0,0,0,0,0
52,91,18,0,0,0,0,0,0,4,118,0,0,0,0,0,0,0,0
52,93,3,0,0,0,0,0,0,1,6,0,0,0,0,0,0,0,0
52,95,6,0,0,0,0,0,0,2,12,0,0,0,0,0,0,0,0
53,22,198,839,2102,4395,700,300,1545,24,441,5319,13779,28108,4977,1822,9955,6497,41887
53,23,11,11,31,161,11,10,73,6,38,96,250,1401,139,32,727,192,1651
53,24,5,3,4,55,9,9,17,3,14,51,42,873,261,93,160,59,915
53,40,1265,0,0,0,0,0,0,27,3798,0,0,0,0,0,0,0,0
53,41,45,91,43,876,113,242,211,13,139,578,251,6729,995,1957,1693,919,6980
53,42,10,5,7,165,26,49,2,5,29,54,29,1182,208,350,8,172,1211
53,43,62,155,106,2085,378,302,669,12,166,1026,616,11301,1873,1332,4281,2191,11917
53,44,266,306,183,5967,542,594,2392,73,702,1493,1205,42194,5062,3694,18794,6150,43399
53,45,105,122,165,2455,308,321,745,32,274,661,1030,16283,2766,1858,5683,2620,17313
53,48,38,76,10,916,273,52,35,14,116,472,61,7400,2908,383,420,926,7461
53,63,4,0,0,0,0,0,0,2,12,0,0,0,0,0,0,0,0
53,67,3,0,0,0,0,0,0,2,10,0,0,0,0,0,0,0,0
53,68,2,0,0,0,0,0,0,1,4,0,0,0,0,0,0,0,0
53,69,4,0,0,0,0,0,0,1,8,0,0,0,0,0,0,0,0
53,72,1,0,0,0,0,0,0,1,5,0,0,0,0,0,0,0,0
53,84,22,3,113,64,25,28,4,8,43,8,445,381,284,55,21,177,826
53,93,2,0,0,0,0,0,0,2,7,0,0,0,0,0,0,0,0
54,21,15,0,0,0,0,0,0,9,46,0,0,0,0,0,0,0,0
54,40,35,0,0,0,0,0,0,11,100,0,0,0,0,0,0,0,0
54,41,46,167,26,1096,156,256,157,14,131,1121,128,8704,1438,2278,1160,1122,8832
54,42,2,0,0,0,0,0,0,1,4,0,0,0,0,0,0,0,0
54,44,200,102,198,3201,266,433,1017,53,492,575,1126,21223,2159,2821,7104,3399,22349
54,66,2,0,0,0,0,0,0,1,5,0,0,0,0,0,0,0,0
54,80,2,0,0,0,0,0,0,1,6,0,0,0,0,0,0,0,0
54,83,6,0,32,21,4,6,0,4,19,0,86,91,20,12,0,53,177
54,91,8,0,0,0,0,0,0,1,24,0,0,0,0,0,0,0,0
54,92,2,0,0,0,0,0,0,1,4,0,0,0,0,0,0,0,0
54,97,6,0,0,0,0,0,0,3,16,0,0,0,0,0,0,0,0
55,43,16,0,0,0,0,0,0,4,40,0,0,0,0,0,0,0,0
55,91,9,0,0,0,0,0,0,4,23,0,0,0,0,0,0,0,0
55,92,2,0,0,0,0,0,0,1,4,0,0,0,0,0,0,0,0
55,96,2,0,0,0,0,0,0,1,4,0,0,0,0,0,0,0,0
55,97,2,0,0,0,0,0,0,1,4,0,0,0,0,0,0,0,0
56,19,4,0,0,0,0,0,0,3,20,0,0,0,0,0,0,0,0
56,40,60,37,86,823,133,159,59,27,173,278,607,6291,1281,1028,347,909,6898
56,41,61,47,66,1295,137,40,18,32,204,358,492,10938,1443,311,224,1361,11430
56,43,337,210,160,4710,533,572,1848,71,837,1435,1038,36357,4397,3992,14401,4870,37395
56,46,432,1067,210,9303,3678,235,255,159,1268,8276,1373,76564,36516,1406,1481,9513,77937
56,60,65,46,1589,1956,211,194,133,12,161,87,2924,3067,396,272,213,3545,5991
56,94,3,0,0,0,0,0,0,1,6,0,0,0,0,0,0,0,0
57,18,26,49,91,616,64,102,115,16,89,424,539,5060,597,677,1078,707,5599
57,19,27,0,0,0,0,0,0,12,72,0,0,0,0,0,0,0,0
57,22,1,0,0,0,0,0,0,1,2,0,0,0,0,0,0,0,0
57,37,28,0,30,94,14,13,20,10,84,0,195,963,152,110,182,124,1158
57,38,1,0,0,0,0,0,0,1,4,0,0,0,0,0,0,0,0
57,39,297,275,693,6229,566,707,402,96,772,1745,4323,42454,4857,4735,2727,6922,46777
57,40,1587,3515,3955,41386,3914,7044,4510,475,4335,19934,21442,268201,30465,43976,26564,45341,289643
57,60,1,0,0,0,0,0,0,1,3,0,0,0,0,0,0,0,0
57,61,30,0,0,0,0,0,0,1,63,0,0,0,0,0,0,0,0
57,66,13,0,0,0,0,0,0,2,28,0,0,0,0,0,0,0,0
57,89,3,0,0,0,0,0,0,2,10,0,0,0,0,0,0,0,0
57,94,1,0,0,0,0,0,0,1,2,0,0,0,0,0,0,0,0
58,18,2,0,0,0,0,0,0,2,12,0,0,0,0,0,0,0,0
58,23,7,0,0,0,0,0,0,7,27,0,0,0,0,0,0,0,0
58,31,33,35,56,653,139,8,78,18,113,290,356,5453,1512,120,564,709,5809
58,32,27,63,119,696,136,14,25,19,92,526,682,5812,1462,110,151,815,6494
58,33,12,10,39,282,104,2,45,4,35,78,350,2516,1219,4,372,321,2866
58,37,61,99,66,1016,157,76,156,21,170,752,432,8573,1528,498,1272,1082,9005
58,39,13,15,58,323,43,81,13,10,40,201,299,2199,431,541,53,381,2498
58,40,58,29,130,1209,93,311,78,22,167,218,819,8902,738,2112,590,1339,9721
58,44,427,0,0,0,0,0,0,116,1081,0,0,0,0,0,0,0,0
58,45,2,0,0,0,0,0,0,2,8,0,0,0,0,0,0,0,0
58,67,1,0,0,0,0,0,0,1,4,0,0,0,0,0,0,0,0
58,70,23,0,0,0,0,0,0,3,28,0,0,0,0,0,0,0,0
58,84,11,0,0,0,0,0,0,4,34,0,0,0,0,0,0,0,0
58,87,1,0,0,0,0,0,0,1,4,0,0,0,0,0,0,0,0
58,94,9,0,0,0,0,0,0,2,23,0,0,0,0,0,0,0,0
59,17,15,4,13,107,9,16,45,8,42,36,130,1116,109,206,506,120,1246
59,22,3,0,0,0,0,0,0,2,10,0,0,0,0,0,0,0,0
59,23,554,377,1540,8425,731,422,3727,157,1702,3037,12693,74060,6773,4480,34719,9965,86753
59,31,114,172,347,2753,348,30,695,37,338,1103,1815,19987,2969,156,4632,3100,21802
59,32,2978,2516,8920,57962,10124,720,8720,1387,8918,19584,61022,459615,103524,5661,68094,66882,520637
59,37,24,0,0,0,0,0,0,13,76,0,0,0,0,0,0,0,0
59,44,4,0,0,0,0,0,0,2,8,0,0,0,0,0,0,0,0
59,61,3,0,0,0,0,0,0,2,9,0,0,0,0,0,0,0,0
59,62,1,0,0,0,0,0,0,1,4,0,0,0,0,0,0,0,0
59,70,2,0,0,0,0,0,0,1,4,0,0,0,0,0,0,0,0
59,86,1,0,0,0,0,0,0,1,4,0,0,0,0,0,0,0,0
59,88,3,0,0,0,0,0,0,2,8,0,0,0,0,0,0,0,0
59,94,4,0,0,0,0,0,0,2,8,0,0,0,0,0,0,0,0
60,14,1,0,0,0,0,0,0,1,4,0,0,0,0,0,0,0,0
60,22,12,1,28,127,10,0,60,8,37,1,222,958,120,0,451,155,1180
60,23,21,35,42,444,62,63,206,10,72,198,415,3541,543,679,1490,486,3956
60,29,15,25,33,330,34,0,24,6,35,149,271,2617,379,0,193,363,2888
60,30,17,0,27,277,55,0,39,4,41,0,174,2543,597,0,343,304,2717
60,31,72,97,175,1559,225,7,107,26,217,514,1052,11379,2248,39,808,1734,12431
60,32,125,70,335,2173,370,53,219,43,395,509,1691,16687,3582,537,1843,2508,18378
60,34,836,915,2070,18416,1847,999,3763,240,2405,6727,14838,137084,16367,5850,29383,20486,151922
60,35,12,0,0,0,0,0,0,5,38,0,0,0,0,0,0,0,0
60,37,3,0,0,0,0,0,0,1,8,0,0,0,0,0,0,0,0
60,46,1,0,0,0,0,0,0,1,50,0,0,0,0,0,0,0,0
60,61,1,0,0,0,0,0,0,1,4,0,0,0,0,0,0,0,0
60,85,3,0,0,0,0,0,0,2,11,0,0,0,0,0,0,0,0
61,13,12,9,29,175,12,24,62,8,39,104,217,1494,95,188,629,204,1711
61,14,113,93,270,2280,140,162,1010,15,251,488,1267,18550,1104,906,7013,2550,19817
61,18,121,40,68,371,73,17,140,22,325,277,514,3394,810,257,1279,439,3908
61,22,15,3,26,92,8,0,44,9,46,42,128,815,68,0,423,118,943
61,28,8,35,0,159,39,0,4,3,20,245,0,991,264,0,8,159,991
61,29,222,221,385,4023,1326,48,388,77,680,2204,2778,38133,15711,329,3216,4408,40911
61,30,106,152,153,2472,592,63,202,46,303,1080,1122,20731,5969,434,1550,2625,21853
61,31,52,154,103,1084,150,1,106,20,151,952,746,8105,1687,17,818,1187,8851
61,51,8,0,0,0,0,0,0,2,15,0,0,0,0,0,0,0,0
61,63,1,0,0,0,0,0,0,1,3,0,0,0,0,0,0,0,0
61,82,3,0,0,0,0,0,0,3,12,0,0,0,0,0,0,0,0
61,83,5,18,121,593,77,66,1,5,22,100,190,1151,147,71,1,714,1341
61,84,40,0,0,0,0,0,0,5,106,0,0,0,0,0,0,0,0
61,85,12,0,0,0,0,0,0,4,31,0,0,0,0,0,0,0,0
61,86,33,142,1477,5567,282,443,32,7,74,195,2329,6256,393,632,37,7044,8585
61,95,1,0,0,0,0,0,0,1,4,0,0,0,0,0,0,0,0
61,96,1,0,0,0,0,0,0,1,5,0,0,0,0,0,0,0,0
62,10,1,0,0,0,0,0,0,1,2,0,0,0,0,0,0,0,0
62,13,43,139,101,884,118,86,273,27,138,1169,570,7241,1044,607,2707,985,7811
62,14,4,0,0,0,0,0,0,2,8,0,0,0,0,0,0,0,0
62,17,91,186,175,1658,401,78,603,43,274,1526,1391,15136,4106,641,5807,1833,16527
62,21,3,19,12,115,24,6,20,3,14,120,32,1050,157,48,229,127,1082
62,26,12,0,0,0,0,0,0,4,34,0,0,0,0,0,0,0,0
62,28,1114,1279,3373,21981,6416,402,2514,312,3371,10197,26048,176588,64373,2540,18805,25354,202636
62,29,103,108,435,1774,510,20,128,55,311,1026,3014,14106,4909,141,1012,2209,17120
62,30,75,40,137,730,111,11,79,15,210,266,915,5067,1240,65,575,867,5982
62,44,12,22,942,656,154,50,36,3,69,40,1773,1397,299,90,72,1598,3170
62,63,4,0,0,0,0,0,0,2,10,0,0,0,0,0,0,0,0
62,64,3,0,0,0,0,0,0,2,6,0,0,0,0,0,0,0,0
62,83,23,0,0,0,0,0,0,6,79,0,0,0,0,0,0,0,0
62,84,8,0,0,0,0,0,0,3,23,0,0,0,0,0,0,0,0
62,85,3,0,0,0,0,0,0,2,8,0,0,0,0,0,0,0,0
62,95,5,0,0,0,0,0,0,1,10,0,0,0,0,0,0,0,0
62,96,4,0,0,0,0,0,0,2,11,0,0,0,0,0,0,0,0
62,97,1,0,0,0,0,0,0,1,6,0,0,0,0,0,0,0,0
63,12,72,72,159,1233,190,214,213,35,233,743,1005,9982,1881,1774,1812,1392,10987
63,13,1,0,0,0,0,0,0,1,4,0,0,0,0,0,0,0,0
63,20,4,0,0,0,0,0,0,3,16,0,0,0,0,0,0,0,0
63,21,98,95,253,1639,251,69,792,56,328,878,2034,15802,2764,508,8018,1892,17836
63,25,1871,17873,12765,97252,18802,3248,5927,314,4796,97154,43452,478843,125876,16218,29619,110017,522295
63,26,23,0,18,529,28,4,0,7,66,0,118,3598,296,30,0,547,3716
63,27,16,18,39,458,154,0,23,8,56,153,207,3253,1363,0,219,497,3460
63,28,2496,5838,5017,61752,18142,1975,2954,169,7427,43231,25935,499995,176585,14303,20666,66769,525930
63,29,1857,5942,5386,61293,17896,1882,2370,284,5539,44274,29470,507997,178749,14212,14659,66679,537467
63,33,12,4,15,157,0,18,101,8,28,56,101,1329,0,203,738,172,1430
63,34,2,0,0,0,0,0,0,1,4,0,0,0,0,0,0,0,0
63,35,60,65,326,1192,212,68,212,18,182,515,2789,8787,1751,368,1436,1518,11576
63,39,45,105,29,1039,360,51,40,23,127,743,172,7707,3383,292,282,1068,7879
63,40,10,0,0,0,0,0,0,2,22,0,0,0,0,0,0,0,0
63,63,19,16,97,586,83,66,6,11,49,39,149,1009,176,123,6,683,1158
63,64,120,146,754,17924,645,556,65,8,275,153,1014,18960,810,681,81,18678,19974
63,65,2,0,0,0,0,0,0,1,4,0,0,0,0,0,0,0,0
63,79,1,0,0,0,0,0,0,1,3,0,0,0,0,0,0,0,0
63,83,1,0,0,0,0,0,0,1,2,0,0,0,0,0,0,0,0
63,89,1,0,0,0,0,0,0,1,4,0,0,0,0,0,0,0,0
63,111,2,0,0,0,0,0,0,1,4,0,0,0,0,0,0,0,0
64,11,4,0,0,0,0,0,0,3,12,0,0,0,0,0,0,0,0
64,12,212,295,916,3880,636,789,529,108,615,2354,5388,26322,5748,5195,3991,4796,31710
64,19,7,7,19,181,36,6,43,6,35,75,121,1447,371,33,351,200,1568
64,20,260,589,1127,5836,1099,231,1386,152,910,4906,8952,49530,11079,1777,11894,6963,58482
64,24,172,415,438,4473,855,145,236,75,469,2505,2213,28286,7956,568,1320,4911,30499
64,25,63,43,89,1193,203,45,76,25,176,321,587,8721,1969,289,573,1282,9308
64,29,633,744,2517,11971,2699,160,1515,270,1827,5238,17741,97170,27477,1028,12665,14488,114911
64,30,126,205,346,2493,478,48,288,49,382,1507,2544,19896,4972,296,2264,2839,22440
64,33,157,148,221,4316,277,135,613,31,416,1066,1206,30156,3035,1034,5073,4537,31362
64,38,22,33,5,314,96,8,53,7,57,240,30,2189,785,74,350,319,2219
64,39,20,0,0,0,0,0,0,5,52,0,0,0,0,0,0,0,0
64,48,7,0,0,0,0,0,0,3,15,0,0,0,0,0,0,0,0
64,62,5,0,0,0,0,0,0,3,16,0,0,0,0,0,0,0,0
64,63,14,21,83,856,72,123,28,11,41,24,129,1368,135,218,32,939,1497
64,64,59,107,492,16159,221,506,55,6,113,151,678,17021,347,761,55,16651,17699
64,71,3,0,0,0,0,0,0,1,5,0,0,0,0,0,0,0,0
64,81,44,0,0,0,0,0,0,5,99,0,0,0,0,0,0,0,0
64,82,3,0,0,0,0,0,0,3,10,0,0,0,0,0,0,0,0
64,87,3,0,0,0,0,0,0,2,9,0,0,0,0,0,0,0,0
64,95,2,0,0,0,0,0,0,1,4,0,0,0,0,0,0,0,0
64,96,4,0,0,0,0,0,0,2,11,0,0,0,0,0,0,0,0
64,105,2,0,0,0,0,0,0,1,4,0,0,0,0,0,0,0,0
65,11,1,0,0,0,0,0,0,1,4,0,0,0,0,0,0,0,0
65,12,5,0,0,0,0,0,0,2,17,0,0,0,0,0,0,0,0
65,17,1,0,0,0,0,0,0,1,3,0,0,0,0,0,0,0,0
65,18,38,2,53,376,54,14,212,17,109,6,483,3501,641,94,1896,429,3984
65,19,134,134,299,2898,557,146,622,74,430,1039,2567,23513,5048,1034,5636,3197,26080
65,20,19,31,37,292,76,5,60,9,62,378,269,2520,747,82,559,329,2789
65,22,4843,16649,47239,312664,31631,19126,10962,2070,12691,74846,119688,925503,152779,52649,48365,359903,1045191
65,23,314,703,1614,12807,2117,702,606,145,869,2841,5091,54170,12177,2295,2734,14421,59261
65,24,36,32,92,883,141,60,71,17,100,230,574,5937,1405,330,565,975,6511
65,27,1,0,0,0,0,0,0,1,6,0,0,0,0,0,0,0,0
65,28,13,10,33,235,42,16,4,9,42,65,191,1729,328,128,36,268,1920
65,29,11,3,112,51,14,0,4,8,28,21,890,424,108,0,28,163,1314
65,30,83,110,442,1690,429,71,122,44,239,813,2935,11975,4039,384,804,2132,14910
65,33,15,42,13,342,76,6,119,6,42,364,65,3160,922,42,1054,355,3225
65,34,31,0,0,0,0,0,0,18,105,0,0,0,0,0,0,0,0
65,38,9,0,0,0,0,0,0,4,32,0,0,0,0,0,0,0,0
65,47,2,0,0,0,0,0,0,1,6,0,0,0,0,0,0,0,0
65,57,1,0,0,0,0,0,0,1,3,0,0,0,0,0,0,0,0
65,61,1,0,0,0,0,0,0,1,4,0,0,0,0,0,0,0,0
65,62,3,0,0,0,0,0,0,1,10,0,0,0,0,0,0,0,0
65,84,1,0,0,0,0,0,0,1,3,0,0,0,0,0,0,0,0
65,87,1,0,0,0,0,0,0,1,4,0,0,0,0,0,0,0,0
65,102,2,0,0,0,0,0,0,1,6,0,0,0,0,0,0,0,0
65,107,3,0,0,0,0,0,0,1,6,0,0,0,0,0,0,0,0
66,17,370,492,1098,6334,728,268,3045,85,956,4370,8805,53270,7902,2477,24132,7432,62075
66,21,79,63,328,3118,367,196,67,49,205,250,1078,11676,1580,741,278,3446,12754
66,22,273,307,729,11406,1140,798,132,197,744,1316,2658,39571,6045,2891,448,12135,42229
66,23,112,150,392,5575,779,440,77,75,335,637,1198,20004,4287,1245,266,5967,21202
66,24,7,0,6,204,23,53,2,4,22,0,16,1045,222,212,6,210,1061
66,26,2,0,0,0,0,0,0,1,8,0,0,0,0,0,0,0,0
66,36,70,46,36,1127,331,70,51,28,184,223,311,7968,3044,380,360,1163,8279
66,43,3,0,0,0,0,0,0,2,7,0,0,0,0,0,0,0,0
66,44,2,0,0,0,0,0,0,2,6,0,0,0,0,0,0,0,0
66,51,2,0,0,0,0,0,0,1,4,0,0,0,0,0,0,0,0
66,61,22,0,10,138,25,51,0,5,49,0,17,380,82,116,0,148,397
66,62,2,0,0,0,0,0,0,2,7,0,0,0,0,0,0,0,0
66,84,4,0,0,0,0,0,0,2,8,0,0,0,0,0,0,0,0
66,91,1,0,0,0,0,0,0,1,4,0,0,0,0,0,0,0,0
66,92,24,0,0,0,0,0,0,1,52,0,0,0,0,0,0,0,0
66,99,1,0,0,0,0,0,0,1,2,0,0,0,0,0,0,0,0
66,102,54,0,0,0,0,0,0,2,153,0,0,0,0,0,0,0,0
66,106,3,0,0,0,0,0,0,1,7,0,0,0,0,0,0,0,0
66,107,1,0,0,0,0,0,0,1,3,0,0,0,0,0,0,0,0
66,113,3,0,0,0,0,0,0,1,8,0,0,0,0,0,0,0,0
67,16,4,0,0,0,0,0,0,3,12,0,0,0,0,0,0,0,0
67,21,20,26,199,1155,131,114,17,11,50,35,532,2825,644,185,23,1354,3357
67,22,24,27,88,1086,116,75,34,22,76,129,242,4032,595,355,94,1174,4274
67,25,3,0,0,0,0,0,0,1,6,0,0,0,0,0,0,0,0
67,28,22,17,32,431,94,30,18,17,65,174,129,2958,893,118,108,463,3087
67,30,2,0,0,0,0,0,0,1,8,0,0,0,0,0,0,0,0
67,32,20,2,16,458,194,9,70,9,72,2,49,3959,2075,15,731,474,4008
67,33,22,20,26,439,158,33,56,9,70,124,102,3739,1616,277,417,465,3841
67,36,10,15,0,130,23,9,14,3,24,50,0,586,118,30,66,130,586
67,43,12,0,0,0,0,0,0,3,24,0,0,0,0,0,0,0,0
67,46,4,0,0,0,0,0,0,2,8,0,0,0,0,0,0,0,0
67,47,3,0,0,0,0,0,0,1,6,0,0,0,0,0,0,0,0
67,52,1,0,0,0,0,0,0,1,3,0,0,0,0,0,0,0,0
67,60,30,123,129,1619,309,196,12,8,67,683,264,4087,662,563,48,1748,4351
67,61,1,0,0,0,0,0,0,1,4,0,0,0,0,0,0,0,0
67,63,14,0,0,0,0,0,0,3,33,0,0,0,0,0,0,0,0
67,90,5,0,0,0,0,0,0,3,13,0,0,0,0,0,0,0,0
67,96,6,0,0,0,0,0,0,2,11,0,0,0,0,0,0,0,0
67,98,1,0,0,0,0,0,0,1,3,0,0,0,0,0,0,0,0
68,7,77,57,83,801,104,167,291,37,197,517,930,7310,834,1408,3165,884,8240
68,15,1,0,0,0,0,0,0,1,2,0,0,0,0,0,0,0,0
68,16,251,144,667,3707,574,68,1538,127,748,1382,5257,32847,6200,519,13219,4374,38104
68,19,1163,1077,2296,25414,3821,618,3196,447,3387,7443,14852,183415,35255,3539,23722,27710,198267
68,20,155,107,469,3837,569,65,561,84,507,707,2922,28970,5677,392,4599,4306,31892
68,21,5,0,0,0,0,0,0,3,14,0,0,0,0,0,0,0,0
68,22,3,0,0,0,0,0,0,3,10,0,0,0,0,0,0,0,0
68,23,10,0,0,0,0,0,0,1,30,0,0,0,0,0,0,0,0
68,25,7,8,8,148,18,13,0,6,25,118,88,1172,215,115,0,156,1260
68,27,9,0,0,0,0,0,0,4,21,0,0,0,0,0,0,0,0
68,28,1,0,0,0,0,0,0,1,2,0,0,0,0,0,0,0,0
68,29,2,0,0,0,0,0,0,2,9,0,0,0,0,0,0,0,0
68,30,191,215,283,2926,1119,42,549,80,590,1843,2130,26493,11712,402,4728,3209,28623
68,32,314,827,650,6622,2256,109,1107,88,813,5696,4290,49838,19295,582,8119,7272,54128
68,35,25,3,7,271,61,12,7,7,67,15,21,1650,339,103,70,278,1671
68,45,44,0,0,0,0,0,0,2,90,0,0,0,0,0,0,0,0
68,48,4,0,0,0,0,0,0,2,8,0,0,0,0,0,0,0,0
68,50,3,0,0,0,0,0,0,1,5,0,0,0,0,0,0,0,0
68,56,5,0,0,0,0,0,0,2,10,0,0,0,0,0,0,0,0
68,60,3,0,0,0,0,0,0,1,6,0,0,0,0,0,0,0,0
68,61,3,3,21,184,25,8,0,3,6,3,35,446,67,14,0,205,481
68,74,3,0,0,0,0,0,0,1,6,0,0,0,0,0,0,0,0
68,76,1,0,0,0,0,0,0,1,4,0,0,0,0,0,0,0,0
68,77,2,0,0,0,0,0,0,2,7,0,0,0,0,0,0,0,0
68,92,6,0,0,0,0,0,0,3,18,0,0,0,0,0,0,0,0
69,15,27,0,0,0,0,0,0,5,82,0,0,0,0,0,0,0,0
69,16,52,39,114,719,111,12,266,27,138,339,961,6847,1380,145,2626,833,7808
69,18,950,1556,2937,17302,3180,367,3304,311,2554,10054,21363,129487,30188,2500,25869,20239,150850
69,19,183,497,1833,4079,915,268,264,51,453,1717,4674,20576,6948,988,1219,5912,25250
69,24,24,20,30,284,128,16,0,11,66,162,143,2250,1217,72,0,314,2393
69,25,2,0,0,0,0,0,0,2,8,0,0,0,0,0,0,0,0
69,26,3,0,0,0,0,0,0,3,14,0,0,0,0,0,0,0,0
69,29,7,4,18,74,28,3,3,6,24,16,124,605,294,14,30,92,729
69,31,23,17,193,367,31,15,92,10,67,109,1220,2878,328,170,674,560,4098
69,34,15,18,10,456,96,17,36,4,30,72,28,2086,557,41,192,466,2114
69,35,28,51,8,380,62,26,35,6,73,363,40,2849,532,215,213,388,2889
69,50,3,0,0,0,0,0,0,2,7,0,0,0,0,0,0,0,0
69,59,5,0,0,0,0,0,0,1,10,0,0,0,0,0,0,0,0
69,75,5,0,0,0,0,0,0,1,10,0,0,0,0,0,0,0,0
69,86,3,0,0,0,0,0,0,1,18,0,0,0,0,0,0,0,0
69,92,17,0,0,0,0,0,0,3,32,0,0,0,0,0,0,0,0
69,93,4,0,0,0,0,0,0,2,9,0,0,0,0,0,0,0,0
69,94,8,0,0,0,0,0,0,3,18,0,0,0,0,0,0,0,0
69,97,19,0,0,0,0,0,0,1,55,0,0,0,0,0,0,0,0
69,98,20,0,0,0,0,0,0,1,40,0,0,0,0,0,0,0,0
69,101,1,0,0,0,0,0,0,1,6,0,0,0,0,0,0,0,0
69,106,1,0,0,0,0,0,0,1,4,0,0,0,0,0,0,0,0
69,107,8,0,0,0,0,0,0,2,14,0,0,0,0,0,0,0,0
69,111,6,0,0,0,0,0,0,2,28,0,0,0,0,0,0,0,0
69,113,2,0,0,0,0,0,0,1,8,0,0,0,0,0,0,0,0
70,5,1,0,0,0,0,0,0,1,2,0,0,0,0,0,0,0,0
70,13,1,0,0,0,0,0,0,1,4,0,0,0,0,0,0,0,0
70,15,118,147,50,2068,245,41,1043,49,372,1469,361,18908,2493,416,9535,2118,19269
70,18,254,226,550,3869,720,127,689,74,706,1535,3811,30976,7171,794,5916,4419,34787
70,19,1,0,0,0,0,0,0,1,2,0,0,0,0,0,0,0,0
70,23,2,0,0,0,0,0,0,2,11,0,0,0,0,0,0,0,0
70,27,6,0,0,0,0,0,0,3,19,0,0,0,0,0,0,0,0
70,31,260,182,493,4984,1217,261,677,134,769,1419,3593,42062,12768,2185,5338,5477,45655
70,34,350,358,377,8523,2031,421,2534,37,1015,2102,2759,52193,10488,1673,20834,8900,54952
70,46,146,43,1658,3103,225,1493,125,14,301,104,4282,4695,338,1758,433,4761,8977
70,52,27,39,425,737,92,147,24,6,64,57,1171,1624,139,331,31,1162,2795
70,63,3,2,2,395,28,44,3,3,10,4,2,650,44,59,30,397,652
70,76,10,3,25,256,50,36,0,6,30,11,65,832,296,67,0,281,897
70,88,2,0,0,0,0,0,0,1,4,0,0,0,0,0,0,0,0
70,94,10,0,0,0,0,0,0,8,28,0,0,0,0,0,0,0,0
70,95,2,0,0,0,0,0,0,1,4,0,0,0,0,0,0,0,0
70,96,4,0,0,0,0,0,0,1,7,0,0,0,0,0,0,0,0
70,97,32,0,0,0,0,0,0,2,73,0,0,0,0,0,0,0,0
70,103,5,0,0,0,0,0,0,2,14,0,0,0,0,0,0,0,0
70,105,13,0,0,0,0,0,0,2,26,0,0,0,0,0,0,0,0
70,106,1,0,0,0,0,0,0,1,3,0,0,0,0,0,0,0,0
70,107,2,0,0,0,0,0,0,1,4,0,0,0,0,0,0,0,0
71,12,3,15,0,54,2,10,9,3,12,182,0,542,14,119,81,54,542
71,14,98,59,185,1653,140,30,965,51,292,411,1462,15231,1648,303,9132,1838,16693
71,15,12,13,46,304,59,4,175,6,43,111,318,2629,640,42,1441,350,2947
71,18,77,53,32,743,346,25,19,18,173,342,174,6525,3560,178,148,775,6699
71,19,26,64,22,465,191,2,8,11,72,450,164,3863,1835,14,56,487,4027
71,22,14,0,0,0,0,0,0,7,32,0,0,0,0,0,0,0,0
71,25,5,0,0,0,0,0,0,4,24,0,0,0,0,0,0,0,0
71,27,12,0,0,0,0,0,0,5,32,0,0,0,0,0,0,0,0
71,29,2,0,0,0,0,0,0,1,6,0,0,0,0,0,0,0,0
71,30,6,0,0,0,0,0,0,4,20,0,0,0,0,0,0,0,0
71,34,1,0,0,0,0,0,0,1,6,0,0,0,0,0,0,0,0
71,49,8,0,0,0,0,0,0,2,17,0,0,0,0,0,0,0,0
71,63,8,0,0,0,0,0,0,2,15,0,0,0,0,0,0,0,0
71,71,2,0,0,0,0,0,0,1,4,0,0,0,0,0,0,0,0
71,83,2500,0,0,0,0,0,0,1,5000,0,0,0,0,0,0,0,0
71,95,111,0,0,0,0,0,0,8,324,0,0,0,0,0,0,0,0
71,97,39,0,0,0,0,0,0,4,78,0,0,0,0,0,0,0,0
71,106,3,0,0,0,0,0,0,1,6,0,0,0,0,0,0,0,0
72,2,3,0,0,0,0,0,0,1,6,0,0,0,0,0,0,0,0
72,12,1,0,0,0,0,0,0,1,2,0,0,0,0,0,0,0,0
72,13,218,212,483,2595,223,99,1598,67,637,1743,5836,24149,2261,957,14790,3078,29985
72,14,28,4,14,98,2,9,66,7,83,16,142,849,34,116,543,112,991
72,15,16,17,26,232,11,5,4,6,46,114,122,1712,113,27,28,258,1834
72,16,506,338,840,7194,862,162,1895,147,1343,2898,5372,59919,8968,898,17075,8034,65291
72,17,15,16,20,222,92,12,6,6,32,148,51,1644,729,88,38,242,1695
72,18,9,0,0,0,0,0,0,3,20,0,0,0,0,0,0,0,0
72,20,29,55,11,540,162,21,4,12,83,310,77,3752,1572,145,16,551,3829
72,26,8,0,0,0,0,0,0,3,26,0,0,0,0,0,0,0,0
72,33,2,0,0,0,0,0,0,1,6,0,0,0,0,0,0,0,0
72,34,10,0,0,0,0,0,0,4,32,0,0,0,0,0,0,0,0
72,63,3,0,0,0,0,0,0,1,6,0,0,0,0,0,0,0,0
72,71,10,3,20,707,42,54,3,6,31,7,34,1301,88,80,5,727,1335
72,101,4,0,0,0,0,0,0,1,8,0,0,0,0,0,0,0,0
72,102,2,0,0,0,0,0,0,2,7,0,0,0,0,0,0,0,0
72,103,6,0,0,0,0,0,0,2,14,0,0,0,0,0,0,0,0
73,12,297,189,537,4516,326,183,2804,96,852,1628,4316,40429,3695,1243,25052,5053,44745
73,13,28,43,52,374,46,14,174,11,93,302,367,3251,336,56,1539,426,3618
73,14,457,471,939,6881,646,115,2242,151,1272,4052,7700,57209,7304,1502,18974,7820,64909
73,15,10,0,0,0,0,0,0,4,22,0,0,0,0,0,0,0,0
73,17,4,0,0,0,0,0,0,3,21,0,0,0,0,0,0,0,0
73,18,13,0,0,0,0,0,0,3,26,0,0,0,0,0,0,0,0
73,24,16,61,15,544,166,22,1,8,46,426,43,4075,1645,96,1,559,4118
73,26,1,0,0,0,0,0,0,1,7,0,0,0,0,0,0,0,0
73,29,26,22,25,495,161,26,6,13,69,83,63,3144,1573,108,52,520,3207
73,32,1484,3271,3360,48082,10133,1410,3951,290,3885,15927,13771,270750,57273,5388,19549,51442,284521
73,33,116,142,111,2454,811,66,170,9,343,688,491,11389,3972,173,1016,2565,11880
73,63,15,0,0,0,0,0,0,4,31,0,0,0,0,0,0,0,0
73,64,1,0,0,0,0,0,0,1,2,0,0,0,0,0,0,0,0
73,70,15,12,53,1260,129,149,16,9,49,20,128,2145,255,264,16,1313,2273
73,93,1,0,0,0,0,0,0,1,2,0,0,0,0,0,0,0,0
73,95,1,0,0,0,0,0,0,1,4,0,0,0,0,0,0,0,0
73,96,1,0,0,0,0,0,0,1,2,0,0,0,0,0,0,0,0
73,98,260,391,1942,10183,1079,325,182,29,683,477,3912,13520,1682,464,331,12125,17432
73,99,28,77,178,785,127,31,19,6,62,90,299,1033,149,34,25,963,1332
73,100,35,0,0,0,0,0,0,1,64,0,0,0,0,0,0,0,0
73,115,1,0,0,0,0,0,0,1,2,0,0,0,0,0,0,0,0
73,118,17,0,0,0,0,0,0,1,34,0,0,0,0,0,0,0,0
74,11,68,56,161,970,74,5,451,25,202,588,1221,8458,872,26,3960,1131,9679
74,12,213,367,590,3433,509,87,1108,111,662,3108,4088,30292,5122,699,10293,4023,34380
74,13,2,0,0,0,0,0,0,1,8,0,0,0,0,0,0,0,0
74,14,1318,821,10229,30947,2768,236,8038,252,3457,6530,64056,230743,27457,1645,60189,41176,294799
74,16,5,0,0,0,0,0,0,3,16,0,0,0,0,0,0,0,0
74,18,7,0,0,0,0,0,0,2,18,0,0,0,0,0,0,0,0
74,20,9,0,0,0,0,0,0,2,18,0,0,0,0,0,0,0,0
74,27,2,0,0,0,0,0,0,2,6,0,0,0,0,0,0,0,0
74,28,4,0,0,0,0,0,0,1,8,0,0,0,0,0,0,0,0
74,30,94,108,156,2326,418,97,159,37,250,595,720,14104,3109,538,978,2482,14824
74,32,124,276,173,2487,454,55,227,37,321,1848,1041,17037,4412,254,1496,2660,18078
74,63,4,0,0,0,0,0,0,1,8,0,0,0,0,0,0,0,0
74,79,5,0,0,0,0,0,0,1,12,0,0,0,0,0,0,0,0
74,86,2,0,0,0,0,0,0,2,7,0,0,0,0,0,0,0,0
74,95,1,0,0,0,0,0,0,1,5,0,0,0,0,0,0,0,0
74,96,13,0,0,0,0,0,0,2,29,0,0,0,0,0,0,0,0
74,97,8,0,0,0,0,0,0,3,18,0,0,0,0,0,0,0,0
74,99,4,0,0,0,0,0,0,1,8,0,0,0,0,0,0,0,0
74,102,17,0,0,0,0,0,0,4,35,0,0,0,0,0,0,0,0
74,113,5,0,0,0,0,0,0,1,32,0,0,0,0,0,0,0,0
75,9,1,0,0,0,0,0,0,1,4,0,0,0,0,0,0,0,0
75,11,61,0,0,0,0,0,0,2,184,0,0,0,0,0,0,0,0
75,12,1079,4102,9146,45726,5103,2177,5198,135,2520,16545,34881,186162,24951,6341,31550,54872,221043
75,13,3207,4248,17623,83610,9436,1890,17940,600,8931,26429,91429,563618,76901,11390,129642,101233,655047
75,14,1,0,0,0,0,0,0,1,5,0,0,0,0,0,0,0,0
75,16,1,0,0,0,0,0,0,1,6,0,0,0,0,0,0,0,0
75,17,5,0,0,0,0,0,0,1,10,0,0,0,0,0,0,0,0
75,21,2,0,0,0,0,0,0,1,8,0,0,0,0,0,0,0,0
75,26,1,0,0,0,0,0,0,1,4,0,0,0,0,0,0,0,0
75,27,10,0,0,68,32,5,4,6,35,0,0,663,401,55,20,68,663
75,28,267,376,1050,8416,2504,280,706,99,721,1993,5925,41426,18478,913,4930,9466,47351
75,30,13,0,0,0,0,0,0,8,36,0,0,0,0,0,0,0,0
75,31,283,494,310,7345,2531,314,519,56,766,2599,1861,39626,14404,1026,2676,7655,41487
75,32,248,424,454,4871,913,94,267,74,661,2983,2468,33135,8125,450,1703,5325,35603
75,63,3,0,0,0,0,0,0,1,6,0,0,0,0,0,0,0,0
75,78,2,0,0,0,0,0,0,2,6,0,0,0,0,0,0,0,0
75,79,20,32,132,1975,91,85,5,8,46,50,217,3163,149,270,5,2107,3380
75,80,63,0,0,0,0,0,0,3,127,0,0,0,0,0,0,0,0
75,82,1,0,0,0,0,0,0,1,3,0,0,0,0,0,0,0,0
75,85,4,0,0,0,0,0,0,1,8,0,0,0,0,0,0,0,0
75,93,2,0,0,0,0,0,0,1,3,0,0,0,0,0,0,0,0
75,96,2,0,0,0,0,0,0,1,4,0,0,0,0,0,0,0,0
75,110,15,0,0,0,0,0,0,1,34,0,0,0,0,0,0,0,0
75,112,2,0,0,0,0,0,0,1,4,0,0,0,0,0,0,0,0
75,116,4,0,0,0,0,0,0,1,8,0,0,0,0,0,0,0,0
76,12,220,40,349,928,98,13,142,25,670,230,2463,6359,887,79,940,1277,8822
76,13,29,4,161,303,61,11,21,11,75,16,1135,2346,692,109,144,464,3481
76,16,10,6,0,199,72,0,0,3,22,84,0,2023,791,0,0,199,2023
76,18,3,0,0,0,0,0,0,2,8,0,0,0,0,0,0,0,0
76,20,17,0,0,0,0,0,0,4,35,0,0,0,0,0,0,0,0
76,22,11,0,0,0,0,0,0,1,19,0,0,0,0,0,0,0,0
76,26,2,0,0,0,0,0,0,1,5,0,0,0,0,0,0,0,0
76,28,32,49,35,556,163,4,173,12,71,310,215,4664,1546,34,1362,591,4879
76,29,3,0,0,0,0,0,0,2,6,0,0,0,0,0,0,0,0
76,31,6,7,0,97,47,0,12,4,16,69,0,954,579,0,94,97,954
76,32,2,0,0,0,0,0,0,2,6,0,0,0,0,0,0,0,0
76,35,1,0,0,0,0,0,0,1,6,0,0,0,0,0,0,0,0
76,67,1,0,0,0,0,0,0,1,2,0,0,0,0,0,0,0,0
76,77,1,0,0,0,0,0,0,1,2,0,0,0,0,0,0,0,0
76,78,145,273,1409,15699,664,786,96,70,397,471,2134,22665,1174,1218,128,17108,24799
76,79,29,0,0,0,0,0,0,12,74,0,0,0,0,0,0,0,0
76,80,1,0,0,0,0,0,0,1,4,0,0,0,0,0,0,0,0
76,93,7,0,0,0,0,0,0,1,25,0,0,0,0,0,0,0,0
76,94,9,0,95,248,8,41,0,4,22,0,171,295,8,52,0,343,466
76,95,11,0,0,0,0,0,0,2,28,0,0,0,0,0,0,0,0
76,108,105,0,0,0,0,0,0,3,210,0,0,0,0,0,0,0,0
76,111,6,0,0,0,0,0,0,1,12,0,0,0,0,0,0,0,0
76,112,10,0,0,0,0,0,0,1,20,0,0,0,0,0,0,0,0
76,115,6,0,0,0,0,0,0,2,42,0,0,0,0,0,0,0,0
77,8,6,11,24,103,12,10,29,4,18,35,142,801,135,54,195,127,943
77,11,2422,3733,5753,50893,9779,2122,13102,342,6877,28080,42616,389035,85603,15605,97494,56646,431651
77,12,25,0,0,0,0,0,0,4,88,0,0,0,0,0,0,0,0
77,15,9,0,0,0,0,0,0,2,22,0,0,0,0,0,0,0,0
77,16,38,49,155,462,145,11,17,15,104,288,1110,4114,1618,79,202,617,5224
77,17,12,0,23,27,1,0,0,4,26,0,163,78,2,0,0,50,241
77,18,6,0,0,0,0,0,0,2,18,0,0,0,0,0,0,0,0
77,23,11,0,0,0,0,0,0,5,30,0,0,0,0,0,0,0,0
77,25,2,0,0,0,0,0,0,1,4,0,0,0,0,0,0,0,0
77,28,2,0,0,0,0,0,0,1,8,0,0,0,0,0,0,0,0
77,63,3,0,0,0,0,0,0,2,6,0,0,0,0,0,0,0,0
77,66,90,228,400,9506,531,351,52,21,188,405,627,14896,1075,627,86,9906,15523
77,67,29,84,35,3901,377,370,23,15,73,137,52,6176,754,544,26,3936,6228
77,68,30,61,42,3185,326,391,12,12,77,114,60,5515,667,742,18,3227,5575
77,72,10,29,65,598,63,56,0,4,22,73,111,1270,205,93,0,663,1381
77,75,2,0,0,0,0,0,0,2,5,0,0,0,0,0,0,0,0
77,78,1,0,0,0,0,0,0,1,4,0,0,0,0,0,0,0,0
77,117,5,0,0,0,0,0,0,2,10,0,0,0,0,0,0,0,0
77,118,1,0,0,0,0,0,0,1,2,0,0,0,0,0,0,0,0
77,122,2,0,0,0,0,0,0,1,4,0,0,0,0,0,0,0,0
78,11,147,85,361,2921,328,11,353,58,379,598,2566,22741,3019,117,2419,3282,25307
78,14,24,33,101,389,122,60,21,5,52,147,227,2118,1142,222,68,490,2345
78,23,4,0,0,0,0,0,0,1,9,0,0,0,0,0,0,0,0
78,25,1,0,0,0,0,0,0,1,4,0,0,0,0,0,0,0,0
78,26,8,5,10,139,45,0,4,7,29,20,49,870,332,0,28,149,919
78,27,207,370,493,5195,1530,167,489,54,591,1743,2176,26472,10081,566,2297,5688,28648
78,28,335,376,539,7166,2612,106,498,155,1005,2834,3429,59354,27613,650,3636,7705,62783
78,31,194,0,0,0,0,0,0,73,567,0,0,0,0,0,0,0,0
78,39,2,0,0,0,0,0,0,1,4,0,0,0,0,0,0,0,0
78,40,2,0,0,0,0,0,0,1,4,0,0,0,0,0,0,0,0
78,65,3,0,0,0,0,0,0,2,8,0,0,0,0,0,0,0,0
78,66,42,0,0,0,0,0,0,7,87,0,0,0,0,0,0,0,0
78,67,85,357,156,13894,1117,881,59,27,192,618,226,20509,2068,1318,75,14050,20735
78,68,47,29,23,1919,202,140,4,19,118,51,47,3981,493,253,4,1942,4028
78,69,129,438,698,18488,1149,1401,93,38,330,771,1240,28066,2321,2304,110,19186,29306
78,71,3,0,0,0,0,0,0,3,11,0,0,0,0,0,0,0,0
78,73,1,0,0,0,0,0,0,1,4,0,0,0,0,0,0,0,0
78,74,5,0,0,0,0,0,0,2,15,0,0,0,0,0,0,0,0
78,75,1,0,0,0,0,0,0,1,2,0,0,0,0,0,0,0,0
78,77,1,0,0,0,0,0,0,1,2,0,0,0,0,0,0,0,0
78,78,2,0,0,0,0,0,0,1,4,0,0,0,0,0,0,0,0
78,79,1,0,0,0,0,0,0,1,5,0,0,0,0,0,0,0,0
78,111,2,0,0,0,0,0,0,1,4,0,0,0,0,0,0,0,0
78,113,1,0,0,0,0,0,0,1,3,0,0,0,0,0,0,0,0
78,114,6,0,0,0,0,0,0,2,16,0,0,0,0,0,0,0,0
78,115,5,0,0,0,0,0,0,2,8,0,0,0,0,0,0,0,0
78,116,63,0,0,0,0,0,0,14,145,0,0,0,0,0,0,0,0
78,117,27,0,0,0,0,0,0,3,52,0,0,0,0,0,0,0,0
78,121,7,0,0,0,0,0,0,2,15,0,0,0,0,0,0,0,0
79,10,905,1679,1463,15150,3682,443,1577,204,2422,13246,10655,118986,33302,3048,12091,16613,129641
79,17,6,0,0,0,0,0,0,1,12,0,0,0,0,0,0,0,0
79,21,2,0,0,0,0,0,0,1,3,0,0,0,0,0,0,0,0
79,24,4,0,0,0,0,0,0,1,8,0,0,0,0,0,0,0,0
79,26,5,0,0,0,0,0,0,2,10,0,0,0,0,0,0,0,0
79,44,32,0,0,0,0,0,0,1,64,0,0,0,0,0,0,0,0
79,53,3,0,0,0,0,0,0,1,6,0,0,0,0,0,0,0,0
79,64,93,346,88,8057,896,862,36,26,201,643,130,12903,1589,1428,46,8145,13033
79,65,632,3795,5280,131448,7460,7064,972,73,1410,6088,7660,167740,12722,10003,1091,136728,175400
79,68,22,32,27,995,87,58,14,6,46,72,44,1849,196,135,22,1022,1893
79,69,726,119,88,4917,444,516,34,46,2076,237,277,8997,1022,897,44,5005,9274
79,70,485,2378,1526,58241,10854,5009,324,72,1205,4168,1988,99894,20771,8769,502,59767,101882
79,71,30,60,104,3672,336,440,25,10,76,81,189,5972,682,742,33,3776,6161
79,72,70,169,259,6082,597,472,21,25,180,346,529,10625,1297,866,25,6341,11154
79,73,64,209,350,8468,707,766,58,16,159,347,644,13235,1366,1257,91,8818,13879
79,74,2,0,0,0,0,0,0,2,6,0,0,0,0,0,0,0,0
79,90,16,0,0,0,0,0,0,2,40,0,0,0,0,0,0,0,0
79,115,7,0,0,0,0,0,0,3,11,0,0,0,0,0,0,0,0
79,117,4,0,0,0,0,0,0,1,12,0,0,0,0,0,0,0,0
80,23,3,0,2,76,6,6,0,3,8,0,10,369,66,24,0,78,379
80,24,11,9,0,91,47,0,13,6,34,62,0,830,535,0,81,91,830
80,25,90,104,288,1587,652,17,143,58,275,757,2197,13822,6700,123,1185,1875,16019
80,26,1,0,0,0,0,0,0,1,5,0,0,0,0,0,0,0,0
80,27,1,0,0,0,0,0,0,1,2,0,0,0,0,0,0,0,0
80,49,2,0,0,0,0,0,0,1,4,0,0,0,0,0,0,0,0
80,62,12,0,0,0,0,0,0,4,29,0,0,0,0,0,0,0,0
80,63,21,68,17,1383,193,153,3,7,52,132,20,2312,390,279,3,1400,2332
80,64,31,123,118,5019,508,536,59,12,87,235,154,7674,879,826,78,5137,7828
80,68,7,0,0,0,0,0,0,3,18,0,0,0,0,0,0,0,0
80,69,39,46,16,1777,148,174,1,16,113,72,24,2702,241,287,1,1793,2726
80,70,13,48,85,1991,144,179,32,8,33,60,138,3419,378,318,65,2076,3557
80,73,1,0,0,0,0,0,0,1,4,0,0,0,0,0,0,0,0
80,77,2,0,0,0,0,0,0,1,2,0,0,0,0,0,0,0,0
80,109,3,0,0,0,0,0,0,1,8,0,0,0,0,0,0,0,0
80,111,2,0,0,0,0,0,0,1,4,0,0,0,0,0,0,0,0
80,116,2,0,0,0,0,0,0,1,4,0,0,0,0,0,0,0,0
80,120,61,0,0,0,0,0,0,2,111,0,0,0,0,0,0,0,0
81,6,1610,2710,7612,29572,4658,2023,6646,517,4516,20603,48975,232187,44100,14416,54595,37184,281162
81,7,124,312,321,2440,323,222,761,42,339,1754,2015,16196,2899,1677,5782,2761,18211
81,13,1,0,0,0,0,0,0,1,4,0,0,0,0,0,0,0,0
81,17,4,0,0,0,0,0,0,1,8,0,0,0,0,0,0,0,0
81,18,10,0,0,0,0,0,0,3,19,0,0,0,0,0,0,0,0
81,23,2,0,0,0,0,0,0,1,4,0,0,0,0,0,0,0,0
81,24,136,86,435,1235,371,15,211,48,346,566,2770,9191,3136,156,1618,1670,11961
81,25,268,305,673,5630,1524,62,1287,151,972,2081,4129,44425,15054,380,10144,6303,48554
81,27,1,0,0,0,0,0,0,1,4,0,0,0,0,0,0,0,0
81,53,2,0,0,0,0,0,0,1,5,0,0,0,0,0,0,0,0
81,59,98,138,217,8359,675,1036,35,25,231,240,350,12592,1213,1668,39,8576,12942
81,60,91,185,104,6927,547,904,35,29,214,327,203,12470,1124,1559,50,7031,12673
81,62,14,0,0,0,0,0,0,3,28,0,0,0,0,0,0,0,0
81,66,2,0,0,0,0,0,0,1,6,0,0,0,0,0,0,0,0
81,69,5,0,0,0,0,0,0,2,10,0,0,0,0,0,0,0,0
81,70,3,0,0,0,0,0,0,2,7,0,0,0,0,0,0,0,0
81,71,4,0,0,0,0,0,0,2,13,0,0,0,0,0,0,0,0
81,73,3,0,0,0,0,0,0,2,13,0,0,0,0,0,0,0,0
81,114,6,0,0,0,0,0,0,1,10,0,0,0,0,0,0,0,0
81,115,2,0,0,0,0,0,0,1,3,0,0,0,0,0,0,0,0
81,116,13,0,0,0,0,0,0,2,23,0,0,0,0,0,0,0,0
81,117,28,0,0,0,0,0,0,3,48,0,0,0,0,0,0,0,0
81,120,11,0,0,0,0,0,0,4,21,0,0,0,0,0,0,0,0
82,5,10,0,0,0,0,0,0,1,30,0,0,0,0,0,0,0,0
82,6,157,67,104,670,137,75,171,23,477,677,858,6662,1597,793,1480,774,7520
82,7,833,1651,1071,15107,4839,1438,2303,170,2398,15412,8564,133460,52534,9852,18262,16178,142024
82,8,49,42,20,762,248,44,45,5,153,260,148,4745,1888,218,190,782,4893
82,15,1,0,0,0,0,0,0,1,2,0,0,0,0,0,0,0,0
82,17,3,0,0,0,0,0,0,1,6,0,0,0,0,0,0,0,0
82,24,121,121,499,2668,417,45,352,85,415,863,3395,20387,4053,288,2626,3167,23782
82,27,7,0,0,0,0,0,0,3,20,0,0,0,0,0,0,0,0
82,37,12,0,0,0,0,0,0,2,53,0,0,0,0,0,0,0,0
82,38,3,0,0,0,0,0,0,1,6,0,0,0,0,0,0,0,0
82,58,447,0,0,0,0,0,0,74,1139,0,0,0,0,0,0,0,0
82,59,44,142,241,5165,310,359,124,12,116,246,349,7043,496,573,142,5406,7392
82,65,18,0,0,0,0,0,0,5,76,0,0,0,0,0,0,0,0
82,66,44,0,0,0,0,0,0,4,132,0,0,0,0,0,0,0,0
82,67,6,0,0,0,0,0,0,4,20,0,0,0,0,0,0,0,0
82,115,1,0,0,0,0,0,0,1,3,0,0,0,0,0,0,0,0
82,116,55,0,0,0,0,0,0,1,160,0,0,0,0,0,0,0,0
82,126,1,0,0,0,0,0,0,1,2,0,0,0,0,0,0,0,0
83,4,25,30,63,467,113,24,71,13,77,251,467,3944,1134,173,609,530,4411
83,5,1021,2015,2785,23693,5308,1492,4712,222,2910,17343,18336,195032,56378,11591,35958,26478,213368
83,6,1382,1543,2211,18941,3461,868,1541,228,3898,12098,14022,123702,32836,5186,11289,21152,137724
83,7,5,0,0,0,0,0,0,2,14,0,0,0,0,0,0,0,0
83,12,4,0,0,0,0,0,0,1,8,0,0,0,0,0,0,0,0
83,28,1,0,0,0,0,0,0,1,4,0,0,0,0,0,0,0,0
83,29,5,0,0,0,0,0,0,2,9,0,0,0,0,0,0,0,0
83,38,9,0,0,0,0,0,0,5,26,0,0,0,0,0,0,0,0
83,57,3,0,0,0,0,0,0,2,9,0,0,0,0,0,0,0,0
83,106,31,0,0,0,0,0,0,15,90,0,0,0,0,0,0,0,0
83,118,1,0,0,0,0,0,0,1,4,0,0,0,0,0,0,0,0
83,120,27,0,0,0,0,0,0,2,59,0,0,0,0,0,0,0,0
84,5,208,410,306,3217,745,243,477,57,525,3702,2466,28753,9035,2698,3864,3523,31219
84,6,134,120,243,2075,165,78,70,59,372,1000,1744,14180,1672,562,547,2318,15924
84,7,1233,1360,5412,19279,2476,342,5978,310,3464,9416,39627,135337,23610,1932,43810,24691,174964
84,10,4,0,0,0,0,0,0,2,8,0,0,0,0,0,0,0,0
84,11,5,0,0,0,0,0,0,2,11,0,0,0,0,0,0,0,0
84,13,7,0,0,0,0,0,0,2,14,0,0,0,0,0,0,0,0
84,18,5,0,0,0,0,0,0,2,11,0,0,0,0,0,0,0,0
84,19,4,0,0,0,0,0,0,1,8,0,0,0,0,0,0,0,0
84,20,1,0,0,0,0,0,0,1,4,0,0,0,0,0,0,0,0
84,36,8,0,0,0,0,0,0,2,24,0,0,0,0,0,0,0,0
84,56,8,0,0,0,0,0,0,1,17,0,0,0,0,0,0,0,0
84,71,1,0,0,0,0,0,0,1,2,0,0,0,0,0,0,0,0
84,111,2,0,0,0,0,0,0,1,6,0,0,0,0,0,0,0,0
84,117,1,0,0,0,0,0,0,1,2,0,0,0,0,0,0,0,0
84,118,6,10,88,190,18,6,4,4,12,12,159,352,35,10,6,278,511
84,126,2,0,0,0,0,0,0,1,4,0,0,0,0,0,0,0,0
85,5,25,12,7,94,56,0,0,6,60,90,44,754,477,0,0,101,798
85,6,28,39,62,490,89,1,92,9,73,427,501,4545,1066,10,745,552,5046
85,7,141,57,714,1997,417,40,369,61,377,368,5139,15389,4389,170,2956,2711,20528
85,9,1,0,0,0,0,0,0,1,2,0,0,0,0,0,0,0,0
85,10,1,0,0,0,0,0,0,1,4,0,0,0,0,0,0,0,0
85,11,2,0,0,0,0,0,0,1,7,0,0,0,0,0,0,0,0
85,12,6,0,0,0,0,0,0,3,16,0,0,0,0,0,0,0,0
85,16,13,0,0,0,0,0,0,4,26,0,0,0,0,0,0,0,0
85,27,5,0,0,0,0,0,0,1,10,0,0,0,0,0,0,0,0
85,46,5,0,0,0,0,0,0,2,10,0,0,0,0,0,0,0,0
85,105,10,0,0,0,0,0,0,3,22,0,0,0,0,0,0,0,0
85,110,3,0,0,0,0,0,0,2,10,0,0,0,0,0,0,0,0
85,115,118,0,0,0,0,0,0,4,308,0,0,0,0,0,0,0,0
85,116,4,0,0,0,0,0,0,2,12,0,0,0,0,0,0,0,0
85,117,288,0,0,0,0,0,0,13,561,0,0,0,0,0,0,0,0
85,118,44,80,544,1830,94,550,57,7,96,183,739,2575,198,641,70,2374,3314
85,119,1,0,0,0,0,0,0,1,2,0,0,0,0,0,0,0,0
85,126,3,0,0,0,0,0,0,1,8,0,0,0,0,0,0,0,0
86,11,4,0,0,0,0,0,0,1,7,0,0,0,0,0,0,0,0
86,12,3,0,0,0,0,0,0,1,6,0,0,0,0,0,0,0,0
86,35,4,0,0,0,0,0,0,2,8,0,0,0,0,0,0,0,0
86,113,3,0,0,0,0,0,0,1,6,0,0,0,0,0,0,0,0
86,116,7,22,101,214,16,5,18,5,18,51,867,811,56,18,36,315,1678
86,117,70,6,208,240,14,5,28,10,144,26,418,854,30,13,44,448,1272
86,118,3,0,0,0,0,0,0,3,9,0,0,0,0,0,0,0,0
86,119,4,0,0,0,0,0,0,3,17,0,0,0,0,0,0,0,0
86,120,1,0,0,0,0,0,0,1,3,0,0,0,0,0,0,0,0
86,127,251,0,0,0,0,0,0,6,416,0,0,0,0,0,0,0,0
87,0,76,126,195,955,114,106,233,38,212,1000,1410,7584,1048,841,1804,1150,8994
87,4,52,23,89,863,133,15,47,25,142,165,731,6985,1362,100,351,952,7716
87,6,4,0,0,0,0,0,0,1,7,0,0,0,0,0,0,0,0
87,8,2,0,0,0,0,0,0,2,8,0,0,0,0,0,0,0,0
87,15,3,0,0,0,0,0,0,1,7,0,0,0,0,0,0,0,0
87,28,21,0,0,0,0,0,0,3,64,0,0,0,0,0,0,0,0
87,55,2,0,0,0,0,0,0,1,4,0,0,0,0,0,0,0,0
87,88,3,0,0,0,0,0,0,1,6,0,0,0,0,0,0,0,0
87,114,4,0,0,0,0,0,0,1,12,0,0,0,0,0,0,0,0
87,115,7,12,132,157,2,5,26,4,16,28,202,289,2,26,33,289,491
87,116,128,25,192,587,78,14,37,11,292,43,391,1475,211,49,70,779,1866
87,117,329,20,206,1093,66,55,41,17,691,43,466,2358,159,110,61,1299,2824
87,118,78,74,1438,2500,153,180,88,40,197,183,4335,6818,446,482,164,3938,11153
87,119,7,1,0,55,0,0,0,6,22,3,0,283,0,0,0,55,283
87,120,1,0,0,0,0,0,0,1,4,0,0,0,0,0,0,0,0
87,123,59,0,0,0,0,0,0,2,111,0,0,0,0,0,0,0,0
87,127,54,0,0,0,0,0,0,4,117,0,0,0,0,0,0,0,0
88,3,1091,1789,3135,21393,3006,470,1774,425,3046,11785,20257,167767,29124,3376,13378,24528,188024
88,4,184,268,470,3945,637,63,302,76,537,1787,2753,30630,6200,520,2140,4415,33383
88,5,1,0,0,0,0,0,0,1,5,0,0,0,0,0,0,0,0
88,6,1,0,0,0,0,0,0,1,2,0,0,0,0,0,0,0,0
88,9,4,0,0,0,0,0,0,1,8,0,0,0,0,0,0,0,0
88,10,1,0,0,0,0,0,0,1,2,0,0,0,0,0,0,0,0
88,11,5,0,0,0,0,0,0,3,16,0,0,0,0,0,0,0,0
88,45,3,0,0,0,0,0,0,1,6,0,0,0,0,0,0,0,0
88,116,32,41,1077,1364,83,48,186,16,83,81,1809,2467,168,66,343,2441,4276
88,117,59,79,1709,2967,186,163,225,16,103,142,2823,5989,338,382,404,4676,8812
88,118,9169,26402,140372,834336,48966,48138,19983,1595,18957,43515,248312,1497443,93333,94061,32164,974708,1745755
88,119,44,12,199,550,34,64,42,20,106,26,546,2417,102,168,96,749,2963
88,120,36,0,0,0,0,0,0,3,74,0,0,0,0,0,0,0,0
89,2,53,93,169,661,58,52,127,35,139,820,1542,5774,540,610,957,830,7316
89,3,177,241,445,4580,578,85,536,57,453,1643,2982,30799,4463,527,3445,5025,33781
89,4,4920,10463,34704,140108,16427,3530,12525,1255,12240,53811,131546,760095,117208,15424,68385,174812,891641
89,8,1,0,0,0,0,0,0,1,6,0,0,0,0,0,0,0,0
89,12,1,0,0,0,0,0,0,1,4,0,0,0,0,0,0,0,0
89,28,1,0,0,0,0,0,0,1,4,0,0,0,0,0,0,0,0
89,39,4,0,0,0,0,0,0,1,13,0,0,0,0,0,0,0,0
89,96,2,0,0,0,0,0,0,1,4,0,0,0,0,0,0,0,0
89,109,2,0,0,0,0,0,0,1,3,0,0,0,0,0,0,0,0
89,113,12,0,0,0,0,0,0,2,22,0,0,0,0,0,0,0,0
89,114,150,0,0,0,0,0,0,1,295,0,0,0,0,0,0,0,0
89,116,6,1,37,25,0,6,3,5,12,3,113,159,0,20,6,62,272
89,117,110,648,4085,11669,783,483,508,37,225,1089,7083,22511,1432,844,794,15754,29594
89,118,118,113,718,2817,234,245,83,46,246,197,2051,7264,517,581,132,3535,9315
89,119,33,39,666,1086,91,108,39,23,89,83,2300,4143,331,417,79,1752,6443
89,120,11,9,95,305,24,17,4,6,26,20,150,612,65,27,4,400,762
89,121,1,0,0,0,0,0,0,1,2,0,0,0,0,0,0,0,0
89,127,14,0,0,0,0,0,0,2,26,0,0,0,0,0,0,0,0
90,2,143,50,589,640,159,31,50,40,421,350,5158,5410,1398,304,427,1229,10568
90,3,1138,1217,2604,27311,2657,257,3394,390,3127,8712,17310,201696,25484,2065,24996,29915,219006
90,4,60,38,315,1329,89,23,196,22,162,192,1671,8620,813,145,1182,1644,10291
90,5,1,0,0,0,0,0,0,1,2,0,0,0,0,0,0,0,0
90,6,1,0,0,0,0,0,0,1,2,0,0,0,0,0,0,0,0
90,11,4,0,0,0,0,0,0,1,12,0,0,0,0,0,0,0,0
90,12,1,0,0,0,0,0,0,1,4,0,0,0,0,0,0,0,0
90,35,25,7,119,373,41,76,16,11,61,13,484,748,80,266,20,492,1232
90,36,1,0,0,0,0,0,0,1,4,0,0,0,0,0,0,0,0
90,89,176,98,9627,7729,115,141,928,23,294,249,36577,13121,448,399,2473,17356,49698
90,100,1,0,0,0,0,0,0,1,1,0,0,0,0,0,0,0,0
90,101,1,0,0,0,0,0,0,1,2,0,0,0,0,0,0,0,0
90,114,62,0,0,0,0,0,0,6,118,0,0,0,0,0,0,0,0
90,116,1,0,0,0,0,0,0,1,3,0,0,0,0,0,0,0,0
90,117,6,0,0,0,0,0,0,2,30,0,0,0,0,0,0,0,0
90,118,16,6,134,189,14,8,11,6,39,29,428,878,30,38,25,323,1306
90,119,3,0,0,0,0,0,0,3,12,0,0,0,0,0,0,0,0
90,120,10,0,0,0,0,0,0,3,19,0,0,0,0,0,0,0,0
90,121,1,0,0,0,0,0,0,1,2,0,0,0,0,0,0,0,0
90,127,1,0,0,0,0,0,0,1,2,0,0,0,0,0,0,0,0
91,0,6,0,16,28,6,5,7,3,14,0,125,251,69,67,49,44,376
91,1,4,0,20,33,0,0,4,4,13,0,159,257,0,0,48,53,416
91,2,18,0,0,0,0,0,0,2,46,0,0,0,0,0,0,0,0
91,4,2,0,0,0,0,0,0,2,4,0,0,0,0,0,0,0,0
91,5,70,116,213,1777,368,85,69,33,190,687,993,9768,3229,350,419,1990,10761
91,6,1,0,0,0,0,0,0,1,2,0,0,0,0,0,0,0,0
91,90,3,0,0,0,0,0,0,1,7,0,0,0,0,0,0,0,0
91,100,1,0,0,0,0,0,0,1,4,0,0,0,0,0,0,0,0
91,118,7,0,0,0,0,0,0,3,12,0,0,0,0,0,0,0,0
91,119,7,0,0,0,0,0,0,2,14,0,0,0,0,0,0,0,0
91,120,29,0,0,0,0,0,0,3,229,0,0,0,0,0,0,0,0
92,0,244,136,817,7924,778,254,130,35,703,901,4917,31373,3581,1239,739,8741,36290
92,1,11,4,29,28,0,7,6,6,26,26,282,350,0,86,44,57,632
92,2,29,54,35,689,246,6,80,22,94,512,357,7134,3142,35,671,724,7491
92,4,41,0,0,0,0,0,0,2,70,0,0,0,0,0,0,0,0
92,6,61,42,93,950,483,25,57,34,182,388,664,8546,5451,123,526,1043,9210
92,7,14,25,17,171,67,3,11,6,36,529,111,1721,674,12,72,188,1832
92,9,3,0,0,0,0,0,0,2,10,0,0,0,0,0,0,0,0
92,39,2,0,0,0,0,0,0,1,6,0,0,0,0,0,0,0,0
92,107,6,0,0,0,0,0,0,2,11,0,0,0,0,0,0,0,0
92,112,5,0,0,0,0,0,0,1,9,0,0,0,0,0,0,0,0
92,113,14,4,3,20,2,0,0,7,33,4,3,31,2,0,0,23,34
92,114,141,118,2146,9690,419,230,287,24,269,139,2842,13248,574,299,486,11836,16090
92,115,1,0,0,0,0,0,0,1,2,0,0,0,0,0,0,0,0
92,116,4,0,0,0,0,0,0,1,8,0,0,0,0,0,0,0,0
92,118,5,0,0,0,0,0,0,1,10,0,0,0,0,0,0,0,0
92,119,4,0,0,0,0,0,0,1,16,0,0,0,0,0,0,0,0
92,120,2,0,0,0,0,0,0,2,9,0,0,0,0,0,0,0,0
93,1,33,0,40,385,35,9,39,9,69,0,263,2665,193,32,350,425,2928
93,3,87,98,366,3808,363,327,112,64,215,357,1299,11758,1334,998,415,4174,13057
93,4,37,65,114,1477,170,85,45,26,106,296,293,5855,868,299,156,1591,6148
93,5,16,3,27,178,35,0,33,8,34,9,180,1048,203,0,239,205,1228
93,6,63,70,140,1054,331,33,97,32,161,478,906,7986,3425,169,763,1194,8892
93,9,7,0,0,0,0,0,0,4,20,0,0,0,0,0,0,0,0
93,14,2,0,0,0,0,0,0,1,4,0,0,0,0,0,0,0,0
93,48,1,0,0,0,0,0,0,1,2,0,0,0,0,0,0,0,0
93,49,13,0,0,0,0,0,0,4,34,0,0,0,0,0,0,0,0
93,104,4,0,0,0,0,0,0,1,8,0,0,0,0,0,0,0,0
93,113,53,0,0,0,0,0,0,5,93,0,0,0,0,0,0,0,0
93,114,7,0,0,0,0,0,0,2,16,0,0,0,0,0,0,0,0
93,118,29,0,0,0,0,0,0,2,55,0,0,0,0,0,0,0,0
93,119,138,947,4857,7203,674,680,228,11,280,1717,7807,11757,1423,1298,342,12060,19564
93,121,25,0,0,0,0,0,0,3,38,0,0,0,0,0,0,0,0
94,1,95,78,238,1601,269,66,126,25,230,438,981,9602,2139,320,528,1839,10583
94,2,38,34,128,1113,109,117,4,30,104,114,834,4106,547,425,15,1241,4940
94,3,3668,13058,34031,178334,28267,7185,6465,586,8989,69660,99568,872697,184109,27349,31454,212365,972265
94,4,40,45,117,1295,202,77,28,22,109,231,782,5268,1388,131,80,1412,6050
94,5,25,2,18,504,76,8,9,12,76,7,58,2995,558,46,55,522,3053
94,6,61,123,189,2366,474,120,99,36,158,662,928,10443,3312,482,526,2555,11371
94,8,54,97,107,2994,508,298,70,15,151,153,185,4724,782,461,114,3101,4909
94,98,3,0,0,0,0,0,0,1,6,0,0,0,0,0,0,0,0
94,112,13,0,0,0,0,0,0,2,27,0,0,0,0,0,0,0,0
94,119,55,0,0,0,0,0,0,1,91,0,0,0,0,0,0,0,0
94,121,2,0,0,0,0,0,0,1,4,0,0,0,0,0,0,0,0
95,1,13,7,25,206,22,26,0,8,36,33,58,815,173,68,0,231,873
95,2,3,2,8,123,13,15,7,3,10,2,34,448,27,116,49,131,482
95,3,3,0,0,0,0,0,0,2,16,0,0,0,0,0,0,0,0
95,4,3,0,0,0,0,0,0,2,12,0,0,0,0,0,0,0,0
95,5,2,0,0,0,0,0,0,2,8,0,0,0,0,0,0,0,0
95,6,32,0,0,0,0,0,0,2,94,0,0,0,0,0,0,0,0
95,7,192,819,1885,12730,1684,711,308,53,502,1516,5547,25147,3580,1401,679,14615,30694
95,8,11,52,35,1093,150,80,18,5,24,88,50,2024,382,113,30,1128,2074
95,9,7,0,0,0,0,0,0,3,16,0,0,0,0,0,0,0,0
95,13,4,0,0,0,0,0,0,1,12,0,0,0,0,0,0,0,0
95,92,8,0,0,0,0,0,0,1,16,0,0,0,0,0,0,0,0
95,119,11,0,0,0,0,0,0,1,25,0,0,0,0,0,0,0,0
95,121,22,0,0,0,0,0,0,3,43,0,0,0,0,0,0,0,0
96,0,570,304,921,11302,1390,288,733,241,1610,2326,7041,91428,13996,2364,6010,12223,98469
96,3,12,54,30,409,192,13,0,12,60,434,209,3825,2025,65,0,439,4034
96,5,112,418,1021,17989,2249,575,113,26,263,678,1649,27551,5004,907,247,19010,29200
96,6,9,10,13,230,34,19,1,5,22,22,14,440,138,21,1,243,454
96,9,1,0,0,0,0,0,0,1,4,0,0,0,0,0,0,0,0
96,115,9,1,12,48,1,5,4,4,21,1,22,71,4,5,5,60,93
97,2,1,0,0,0,0,0,0,1,4,0,0,0,0,0,0,0,0
97,5,12,18,27,329,48,25,6,5,31,31,57,957,165,51,17,356,1014
97,11,1,0,0,0,0,0,0,1,3,0,0,0,0,0,0,0,0
97,12,20,0,0,0,0,0,0,4,39,0,0,0,0,0,0,0,0
97,125,1,0,0,0,0,0,0,1,2,0,0,0,0,0,0,0,0
98,0,11,29,34,288,88,38,2,8,35,155,66,1622,683,130,2,322,1688
98,6,6,0,0,0,0,0,0,4,21,0,0,0,0,0,0,0,0
98,7,3,0,0,0,0,0,0,2,10,0,0,0,0,0,0,0,0
98,9,1,0,0,0,0,0,0,1,6,0,0,0,0,0,0,0,0
98,10,16,14,55,312,75,28,0,5,43,36,69,942,319,85,0,367,1011
98,11,7,0,0,0,0,0,0,2,15,0,0,0,0,0,0,0,0
98,15,3,0,0,0,0,0,0,3,17,0,0,0,0,0,0,0,0
98,16,1,0,0,0,0,0,0,1,4,0,0,0,0,0,0,0,0
98,106,1,0,0,0,0,0,0,1,5,0,0,0,0,0,0,0,0
98,118,31,0,0,0,0,0,0,2,66,0,0,0,0,0,0,0,0
98,126,2,0,0,0,0,0,0,1,3,0,0,0,0,0,0,0,0
99,0,7,0,39,93,5,4,0,4,18,0,259,573,21,36,0,132,832
99,1,1,0,0,0,0,0,0,1,6,0,0,0,0,0,0,0,0
99,5,10,0,0,0,0,0,0,1,20,0,0,0,0,0,0,0,0
99,6,3,0,0,0,0,0,0,2,10,0,0,0,0,0,0,0,0
99,8,1,0,0,0,0,0,0,1,4,0,0,0,0,0,0,0,0
99,10,2,0,0,0,0,0,0,1,8,0,0,0,0,0,0,0,0
99,11,3,0,0,0,0,0,0,1,6,0,0,0,0,0,0,0,0
99,15,2,0,0,0,0,0,0,1,8,0,0,0,0,0,0,0,0
99,17,5,7,0,114,16,4,9,3,14,20,0,654,78,18,46,114,654
99,44,2,0,0,0,0,0,0,1,4,0,0,0,0,0,0,0,0
99,100,2,0,0,0,0,0,0,1,4,0,0,0,0,0,0,0,0
99,102,1,0,0,0,0,0,0,1,2,0,0,0,0,0,0,0,0
100,6,3,0,0,0,0,0,0,1,6,0,0,0,0,0,0,0,0
100,10,1,0,0,0,0,0,0,1,5,0,0,0,0,0,0,0,0
100,11,1,0,0,0,0,0,0,1,4,0,0,0,0,0,0,0,0
100,17,1,0,0,0,0,0,0,1,4,0,0,0,0,0,0,0,0
100,119,14,0,0,0,0,0,0,2,35,0,0,0,0,0,0,0,0
101,7,1,0,0,0,0,0,0,1,6,0,0,0,0,0,0,0,0
101,16,1,0,0,0,0,0,0,1,6,0,0,0,0,0,0,0,0
101,98,2,0,0,0,0,0,0,1,6,0,0,0,0,0,0,0,0
101,99,12,0,0,0,0,0,0,4,29,0,0,0,0,0,0,0,0
102,0,1,0,0,0,0,0,0,1,4,0,0,0,0,0,0,0,0
102,1,4,0,0,0,0,0,0,1,8,0,0,0,0,0,0,0,0
102,8,1,0,0,0,0,0,0,1,4,0,0,0,0,0,0,0,0
102,12,11,0,0,0,0,0,0,5,26,0,0,0,0,0,0,0,0
102,98,20,30,290,234,26,41,46,5,42,45,624,518,52,110,111,524,1142
102,99,4,0,0,0,0,0,0,1,8,0,0,0,0,0,0,0,0
103,1,1,0,0,0,0,0,0,1,2,0,0,0,0,0,0,0,0
103,96,2,0,0,0,0,0,0,1,4,0,0,0,0,0,0,0,0
104,4,1,0,0,0,0,0,0,1,6,0,0,0,0,0,0,0,0
104,5,5,0,0,0,0,0,0,1,10,0,0,0,0,0,0,0,0
104,11,27,16,156,251,26,31,4,8,57,39,402,1060,135,138,6,407,1462
104,107,2,0,0,0,0,0,0,1,8,0,0,0,0,0,0,0,0
105,3,3,0,0,0,0,0,0,1,6,0,0,0,0,0,0,0,0
105,6,2,0,0,0,0,0,0,1,4,0,0,0,0,0,0,0,0
105,9,1,0,0,0,0,0,0,1,4,0,0,0,0,0,0,0,0
105,11,3,0,0,0,0,0,0,3,12,0,0,0,0,0,0,0,0
105,21,32,0,0,0,0,0,0,5,69,0,0,0,0,0,0,0,0
105,100,108,0,0,0,0,0,0,12,215,0,0,0,0,0,0,0,0
105,107,1,0,0,0,0,0,0,1,2,0,0,0,0,0,0,0,0
105,113,73,0,0,0,0,0,0,3,159,0,0,0,0,0,0,0,0
105,114,23,0,0,0,0,0,0,1,46,0,0,0,0,0,0,0,0
105,123,74,0,0,0,0,0,0,2,128,0,0,0,0,0,0,0,0
106,5,1,0,0,0,0,0,0,1,6,0,0,0,0,0,0,0,0
106,21,8,0,0,0,0,0,0,2,14,0,0,0,0,0,0,0,0
106,23,30,0,0,0,0,0,0,1,46,0,0,0,0,0,0,0,0
106,103,3,0,0,0,0,0,0,1,6,0,0,0,0,0,0,0,0
107,9,1,0,0,0,0,0,0,1,3,0,0,0,0,0,0,0,0
107,115,3,0,0,0,0,0,0,1,5,0,0,0,0,0,0,0,0
108,9,2,0,0,0,0,0,0,1,8,0,0,0,0,0,0,0,0
108,10,2,0,0,0,0,0,0,1,4,0,0,0,0,0,0,0,0
108,102,1,0,0,0,0,0,0,1,2,0,0,0,0,0,0,0,0
109,114,10,0,0,0,0,0,0,1,22,0,0,0,0,0,0,0,0
110,111,6,0,0,0,0,0,0,1,12,0,0,0,0,0,0,0,0
110,116,1,0,0,0,0,0,0,1,2,0,0,0,0,0,0,0,0
111,18,3,0,0,0,0,0,0,3,15,0,0,0,0,0,0,0,0
112,127,1,0,0,0,0,0,0,1,3,0,0,0,0,0,0,0,0
113,14,1,0,0,0,0,0,0,1,6,0,0,0,0,0,0,0,0
113,87,35,0,0,0,0,0,0,5,70,0,0,0,0,0,0,0,0
113,95,3,0,0,0,0,0,0,1,6,0,0,0,0,0,0,0,0
113,105,5,0,0,0,0,0,0,1,10,0,0,0,0,0,0,0,0
113,109,19,0,0,0,0,0,0,2,37,0,0,0,0,0,0,0,0
114,1,3,0,0,0,0,0,0,1,6,0,0,0,0,0,0,0,0
114,18,6,0,0,0,0,0,0,2,12,0,0,0,0,0,0,0,0
114,105,17,0,0,0,0,0,0,1,36,0,0,0,0,0,0,0,0
114,116,13,0,0,0,0,0,0,3,27,0,0,0,0,0,0,0,0
115,0,6,0,0,84,24,0,0,4,18,0,0,776,239,0,0,84,776
115,14,3,0,0,0,0,0,0,1,12,0,0,0,0,0,0,0,0
115,116,3,0,0,0,0,0,0,2,6,0,0,0,0,0,0,0,0
115,120,2,0,0,0,0,0,0,1,4,0,0,0,0,0,0,0,0
116,5,1,0,0,0,0,0,0,1,4,0,0,0,0,0,0,0,0
116,14,8,0,0,0,0,0,0,3,16,0,0,0,0,0,0,0,0
116,98,19,113,65,700,151,64,49,5,53,223,116,1255,314,97,111,765,1371
116,106,7,0,0,0,0,0,0,1,18,0,0,0,0,0,0,0,0
117,0,1,0,0,0,0,0,0,1,6,0,0,0,0,0,0,0,0
117,97,2,0,0,0,0,0,0,1,6,0,0,0,0,0,0,0,0
118,97,2,0,0,0,0,0,0,1,6,0,0,0,0,0,0,0,0
118,104,3,0,0,0,0,0,0,1,6,0,0,0,0,0,0,0,0
119,1,1,0,0,0,0,0,0,1,4,0,0,0,0,0,0,0,0
119,2,1,0,0,0,0,0,0,1,4,0,0,0,0,0,0,0,0
119,5,3,0,0,0,0,0,0,1,10,0,0,0,0,0,0,0,0
119,96,22,0,0,0,0,0,0,5,53,0,0,0,0,0,0,0,0
119,104,4,0,0,0,0,0,0,1,8,0,0,0,0,0,0,0,0
119,122,4,0,0,0,0,0,0,1,8,0,0,0,0,0,0,0,0
119,126,15,0,0,0,0,0,0,1,23,0,0,0,0,0,0,0,0
120,2,3,0,0,0,0,0,0,1,8,0,0,0,0,0,0,0,0
120,3,2,0,0,0,0,0,0,2,7,0,0,0,0,0,0,0,0
120,10,1,0,0,0,0,0,0,1,6,0,0,0,0,0,0,0,0
120,111,20,0,0,0,0,0,0,1,40,0,0,0,0,0,0,0,0
120,117,2,0,0,0,0,0,0,1,4,0,0,0,0,0,0,0,0
121,7,1,0,0,0,0,0,0,1,6,0,0,0,0,0,0,0,0
121,102,61,0,0,0,0,0,0,5,127,0,0,0,0,0,0,0,0
121,125,6,0,0,0,0,0,0,2,17,0,0,0,0,0,0,0,0
121,126,82,100,1716,1316,196,131,121,8,218,172,3107,3298,492,302,230,3032,6405
122,0,13,15,0,231,33,0,8,4,34,171,0,2045,349,0,9,231,2045
122,1,9,0,29,128,53,0,0,3,18,0,48,1175,511,0,0,157,1223
122,7,2,0,0,0,0,0,0,2,11,0,0,0,0,0,0,0,0
122,93,1,0,0,0,0,0,0,1,2,0,0,0,0,0,0,0,0
122,105,4,0,0,0,0,0,0,1,9,0,0,0,0,0,0,0,0
122,125,2,0,0,0,0,0,0,1,9,0,0,0,0,0,0,0,0
122,126,72,0,81,31,7,6,0,4,253,0,137,53,13,9,0,112,190
123,3,10,0,0,0,0,0,0,3,20,0,0,0,0,0,0,0,0
123,5,3,0,0,0,0,0,0,1,6,0,0,0,0,0,0,0,0
123,6,6,0,0,0,0,0,0,2,13,0,0,0,0,0,0,0,0
123,8,6,0,0,0,0,0,0,1,12,0,0,0,0,0,0,0,0
123,90,5,0,0,0,0,0,0,1,15,0,0,0,0,0,0,0,0
123,125,16,0,0,0,0,0,0,2,32,0,0,0,0,0,0,0,0
123,127,12,0,0,0,0,0,0,3,29,0,0,0,0,0,0,0,0
124,2,8,0,0,0,0,0,0,2,15,0,0,0,0,0,0,0,0
124,3,70,69,3821,6930,843,117,128,10,124,124,7068,7785,961,288,268,10751,14853
124,5,6,0,0,0,0,0,0,1,10,0,0,0,0,0,0,0,0
124,7,3,0,0,0,0,0,0,1,6,0,0,0,0,0,0,0,0
124,8,5,0,0,0,0,0,0,2,14,0,0,0,0,0,0,0,0
124,93,10,0,0,0,0,0,0,3,26,0,0,0,0,0,0,0,0
125,4,3,0,0,0,0,0,0,1,8,0,0,0,0,0,0,0,0
125,127,12,0,0,0,0,0,0,2,23,0,0,0,0,0,0,0,0
126,0,4,0,0,0,0,0,0,2,8,0,0,0,0,0,0,0,0
126,99,2,0,0,0,0,0,0,1,3,0,0,0,0,0,0,0,0
127,0,13,17,12,162,81,0,0,5,31,98,48,1472,887,0,0,174,1520
127,91,12,0,0,0,0,0,0,1,27,0,0,0,0,0,0,0,0
127,108,45,0,0,0,0,0,0,2,58,0,0,0,0,0,0,0,0
