x,y,ACCOMMODATION UNITS (ROOMS APARTMENTS CAMPING SITES) - TOTAL,A_AUSTRIAN TOURISTS,A_DOMESTIC TOURISTS - TOTAL,A_FOREIGN TOURISTS - TOTAL,A_GERMAN TOURISTS,A_ITALIAN TOURISTS,A_SLOVENIAN TOURISTS,ESTABLISHMENTS - TOTAL,NUMBER OF PERMANENT BEDS,N_AUSTRIAN TOURISTS,N_DOMESTIC TOURISTS - TOTAL,N_FOREIGN TOURISTS - TOTAL,N_GERMAN TOURISTS,N_ITALIAN TOURISTS,N_SLOVENIAN TOURISTS,TOTAL ARRIVALS,TOTAL NIGHTS
16,97,3,0,0,0,0,0,0,1,6,0,0,0,0,0,0,0,0
16,98,699,2913,446,27106,5480,2969,8862,168,1960,14712,1582,146712,34352,15054,47852,27552,148294
16,99,6268,66916,24519,298640,49004,41100,61023,756,16184,305750,72384,1581006,382205,156998,235682,323159,1653390
16,100,1960,12388,4483,91644,14981,8591,33134,172,5698,53967,14940,472058,99292,32089,165284,96127,486998
17,94,6291,35719,4217,204435,61980,24424,32078,249,17667,233426,16029,1556399,603207,135330,179902,208652,1572428
17,95,7346,24464,9527,239313,61888,25391,35548,409,20433,154565,35403,1769620,586544,129473,181216,248840,1805023
17,96,9080,95019,30056,415764,94474,51303,37859,1318,22132,436261,78791,2271108,668278,195737,146512,445820,2349899
17,97,11119,75473,10691,320811,75564,29015,72764,903,31746,400912,33035,1904661,587020,135915,352788,331502,1937696
17,98,1938,1375,558,6359,1746,794,513,169,6284,7732,1463,37750,14014,3635,1797,6917,39213
17,99,245,662,339,5345,1263,1104,467,102,610,3058,1088,27287,10387,3859,1323,5684,28375
17,100,426,0,0,0,0,0,0,2,1256,0,0,0,0,0,0,0,0
18,93,12859,94527,43479,531675,123785,70805,43512,2074,34165,509219,125036,3215677,1069013,340259,160763,575154,3340713
18,94,92,93,15,633,290,38,2,41,233,607,56,5162,2862,327,56,648,5218
18,95,675,1320,516,13681,5626,1896,596,350,2027,7914,1850,100323,52963,9242,2179,14197,102173
18,96,480,793,382,8431,3693,1125,369,230,1394,4837,1469,64331,35357,5874,1188,8813,65800
18,97,432,82,25,567,318,34,35,184,1073,554,89,4243,2863,162,92,592,4332
18,98,235,786,720,4619,963,755,308,86,607,2612,2124,21566,7570,1725,807,5339,23690
18,99,313,530,369,8177,1851,4269,303,81,720,2585,834,37560,17604,10302,627,8546,38394
19,91,5,0,0,0,0,0,0,2,16,0,0,0,0,0,0,0,0
19,92,145,338,99,3286,1433,295,269,68,419,2380,540,26556,14412,1834,1466,3385,27096
19,93,867,5741,1908,45735,12572,7749,11574,115,2396,34420,5962,289513,107716,38437,69171,47643,295475
19,94,542,990,604,9688,3392,1472,220,224,1332,6115,2246,64780,30223,6899,708,10292,67026
19,95,545,804,162,5756,2837,201,76,214,1290,5455,488,48887,27188,1188,290,5918,49375
19,96,379,564,238,3931,1537,178,170,135,853,3609,688,28334,13645,786,470,4169,29022
19,97,300,176,213,2303,804,136,87,124,728,1057,503,16438,7378,290,157,2516,16941
19,98,78,74,11,335,144,0,2,30,169,494,69,2717,1302,0,8,346,2786
19,99,13,27,23,190,31,36,15,7,26,83,33,763,279,73,29,213,796
20,89,1991,3930,3157,42403,12571,3473,5839,405,5618,23360,11218,292323,105822,20257,41497,45560,303541
20,90,8349,25826,37328,339241,64793,40199,21868,2369,22683,124732,96585,1747616,439925,187150,95042,376569,1844201
20,91,4935,9726,9485,157422,46572,16424,26537,1218,14448,64240,52285,1170256,417987,104300,154934,166907,1222541
20,92,159,475,64,2993,1941,43,19,57,376,3523,199,28287,20053,336,34,3057,28486
20,93,310,378,138,3549,2150,55,52,107,658,2791,401,32202,21643,330,187,3687,32603
20,94,280,245,140,3546,1846,162,80,111,651,1942,546,29877,18487,848,464,3686,30423
20,95,332,560,157,5650,3119,70,42,129,802,4658,769,53765,32190,284,234,5807,54534
20,96,109,176,274,2289,1092,118,38,53,329,1253,643,17325,10180,431,60,2563,17968
20,97,564,452,305,4806,1489,341,213,78,1492,1308,652,16070,6551,506,408,5111,16722
20,98,380,108,71,626,189,14,58,43,663,345,119,3529,1672,18,87,697,3648
21,89,10190,51698,7837,316022,83189,43976,42153,1827,28263,307808,33888,2099149,706961,246289,228699,323859,2133037
21,90,446,1027,583,11005,4714,1353,268,236,1173,6902,1792,83488,44985,7188,1180,11588,85280
21,91,361,676,121,7233,4083,454,55,174,923,4968,592,64461,41908,2888,159,7354,65053
21,92,355,622,127,5275,3057,147,82,125,790,4330,765,48714,31997,843,483,5402,49479
21,93,275,461,279,3862,2166,91,92,107,626,3205,475,35946,22626,653,277,4141,36421
21,94,287,357,117,3397,1866,142,77,99,671,2602,542,30190,18602,643,268,3514,30732
21,95,85,102,28,950,571,11,7,39,226,738,82,8842,5844,77,23,978,8924
21,96,142,188,2593,2857,614,533,123,49,339,793,5410,14332,4417,1361,192,5450,19742
21,97,15,0,0,0,0,0,0,8,32,0,0,0,0,0,0,0,0
21,98,64,0,0,0,0,0,0,27,137,0,0,0,0,0,0,0,0
21,99,147,705,1763,6194,838,589,338,36,304,2018,3542,19197,3991,1067,451,7957,22739
22,89,604,1294,323,13978,6487,1455,557,296,1654,8785,1715,114980,62168,9950,2907,14301,116695
22,90,10,0,0,0,0,0,0,3,28,0,0,0,0,0,0,0,0
22,91,445,832,234,7916,4488,376,155,182,1053,5911,1520,71386,46014,2452,1003,8150,72906
22,92,933,1430,3503,17988,6587,1436,2539,268,2461,9159,19294,136315,64238,8345,15216,21491,155609
22,93,207,408,66,3876,2342,104,48,92,475,2776,215,34987,24654,490,175,3942,35202
22,94,188,215,56,2504,1422,129,64,89,482,1485,284,22089,14633,615,237,2560,22373
22,95,104,162,70,1324,813,13,8,50,268,834,270,11473,8058,71,38,1394,11743
22,96,52,140,97,1105,334,107,60,23,128,627,227,6206,2943,321,102,1202,6433
22,97,29,0,0,0,0,0,0,14,79,0,0,0,0,0,0,0,0
22,98,106,122,160,1393,225,271,63,63,232,410,331,4145,1121,491,132,1553,4476
22,99,16,0,0,0,0,0,0,7,36,0,0,0,0,0,0,0,0
23,92,347,269,88,2116,875,189,19,83,960,1801,435,16995,8346,1411,116,2204,17430
23,93,439,837,209,9312,5435,536,137,217,1146,5908,858,83075,56173,3251,629,9521,83933
23,94,659,1346,1136,15506,7277,1840,326,356,1857,7900,4192,115735,71158,7133,979,16642,119927
23,95,237,312,106,2820,1508,77,91,104,624,2193,348,25502,15336,539,339,2926,25850
23,96,50,31,17,382,227,24,0,24,120,289,303,3759,2556,141,0,399,4062
23,97,41,0,0,0,0,0,0,15,90,0,0,0,0,0,0,0,0
23,98,17,0,0,0,0,0,0,8,48,0,0,0,0,0,0,0,0
23,99,12,0,0,0,0,0,0,4,25,0,0,0,0,0,0,0,0
24,92,281,953,125,6386,2827,408,190,120,688,6008,565,48971,26887,2124,1026,6511,49536
24,93,3133,27462,6898,139599,34952,12120,13346,154,7585,139252,19719,852574,263189,54615,49298,146497,872293
24,94,1092,7616,1240,43188,14069,3619,1849,408,2701,39387,3934,286742,121805,18513,8119,44428,290676
24,95,248,523,177,5095,1567,662,115,100,624,2652,758,33103,13820,2833,485,5272,33861
24,96,133,337,92,2853,942,286,87,62,336,1776,406,19693,8678,1667,492,2945,20099
24,97,13,0,0,0,0,0,0,3,28,0,0,0,0,0,0,0,0
24,100,10,0,0,0,0,0,0,7,23,0,0,0,0,0,0,0,0
25,87,70,0,0,0,0,0,0,34,190,0,0,0,0,0,0,0,0
25,94,20,54,23,387,124,35,26,15,60,355,181,3186,1185,285,247,410,3367
25,96,911,9485,1649,42988,8698,5835,4220,221,2196,42166,5397,196083,51759,23972,17359,44637,201480
25,97,3096,16629,15745,127020,25672,12071,9702,722,7658,68779,43279,520647,145072,42909,30845,142765,563926
25,98,3713,54741,53731,296771,36025,34096,19155,862,8048,196591,122602,963672,180611,86266,42200,350502,1086274
25,99,59,156,137,1065,270,172,35,28,142,503,315,5585,2143,465,90,1202,5900
25,100,25,0,0,0,0,0,0,9,62,0,0,0,0,0,0,0,0
26,85,58,493,225,1196,127,114,220,36,177,4445,1290,9835,1204,867,1528,1421,11125
26,89,254,662,238,5281,670,1298,1888,125,696,5482,1679,41935,6215,9778,14972,5519,43614
26,90,654,0,0,0,0,0,0,60,1936,0,0,0,0,0,0,0,0
26,91,194,1445,126,5606,1498,1158,352,56,531,9295,519,36715,11094,7727,2372,5732,37234
26,92,11,8,1,101,15,7,43,11,24,50,10,1048,161,34,495,102,1058
26,94,81,0,0,0,0,0,0,11,225,0,0,0,0,0,0,0,0
26,98,616,735,2073,15671,2448,3096,359,294,1590,2836,7095,62443,16583,8919,904,17744,69538
26,99,49,56,355,885,362,137,31,23,123,361,752,6471,3505,1168,73,1240,7223
27,85,94,177,276,1399,229,246,476,20,244,861,1831,9779,2081,1624,3774,1675,11610
27,86,249,498,411,5392,927,1566,1165,121,708,4110,3063,45393,9606,12425,9613,5803,48456
27,87,1240,1982,1335,40672,6929,3682,22914,141,3895,13755,7166,313238,59552,26243,182076,42007,320404
27,88,531,1356,384,14709,5422,1623,2860,37,1586,9281,2376,101800,40247,11490,23565,15093,104176
27,89,10,6,1,90,21,26,9,5,26,38,8,602,221,135,80,91,610
27,90,4,9,19,168,14,69,12,3,10,21,52,503,68,248,34,187,555
27,91,33,77,83,785,59,351,71,20,77,496,410,4368,436,1919,388,868,4778
27,92,2404,7973,4225,79031,22187,16166,17081,340,6651,56195,23595,581355,209744,98054,128101,83256,604950
27,93,321,562,399,9026,2410,1250,1651,137,965,3867,2307,60396,22214,7442,8539,9425,62703
27,94,1229,3636,963,23272,6558,3054,2883,360,3362,21506,5050,160215,58637,19460,17458,24235,165265
27,97,267,574,4748,6141,1335,911,190,107,700,2884,13815,34725,10617,3331,460,10889,48540
27,98,995,4682,23605,97589,10468,16318,2211,401,2470,9184,42904,204382,25819,30551,5535,121194,247286
27,99,36,19,42,240,49,68,2,16,92,59,134,944,326,197,4,282,1078
28,84,4,0,0,0,0,0,0,3,10,0,0,0,0,0,0,0,0
28,85,5248,29305,37430,166090,40115,25748,30425,800,13562,177419,172025,1144783,335433,156988,204806,203520,1316808
28,86,21,30,18,316,48,89,97,12,58,394,106,3102,464,924,862,334,3208
28,87,487,0,0,0,0,0,0,18,1442,0,0,0,0,0,0,0,0
28,93,3361,18898,6015,138514,39198,18775,14991,859,9037,93744,24890,770673,269338,93705,73980,144529,795563
28,94,2298,10827,9869,71894,20062,8084,7416,926,6060,54082,38432,426673,147965,46699,34351,81763,465105
28,95,2554,11367,6793,104638,34536,7394,22217,586,6694,59567,29979,613994,246667,37911,110953,111431,643973
28,96,689,736,4871,23834,3253,1218,3044,146,1644,3727,23260,119425,20754,5711,14952,28705,142685
28,97,1207,946,3977,34711,4170,1458,11502,190,2976,4291,17138,143371,21626,4168,48241,38688,160509
28,98,7,5,46,154,11,29,8,6,15,23,153,474,112,67,23,200,627
28,99,11,0,0,0,0,0,0,2,39,0,0,0,0,0,0,0,0
28,102,28,0,251,45,2,6,9,14,114,0,605,97,3,14,20,296,702
28,103,1,0,0,0,0,0,0,1,3,0,0,0,0,0,0,0,0
29,82,22,36,65,237,23,61,75,14,70,323,453,1862,127,443,710,302,2315
29,84,20,0,0,0,0,0,0,11,64,0,0,0,0,0,0,0,0
29,93,3210,10900,4066,79468,19215,9142,19286,536,9215,61668,20385,478706,139381,48669,114752,83534,499091
29,94,532,2347,834,17273,6209,1598,1384,258,1443,12492,2866,108553,52850,8098,4388,18107,111419
29,95,3275,15987,11219,106238,29853,6508,13538,1010,8781,77136,45159,626773,230550,31593,65163,117457,671932
29,96,3066,10374,15636,83931,18382,2576,6872,854,7724,51014,82631,515737,156904,13300,33175,99567,598368
29,97,29,3,55,216,130,8,6,19,80,6,103,1747,1405,28,14,271,1850
29,98,7,0,0,0,0,0,0,5,15,0,0,0,0,0,0,0,0
29,99,40,10,756,662,117,85,13,23,101,14,1698,1531,361,135,29,1418,3229
29,101,27,0,0,0,0,0,0,7,68,0,0,0,0,0,0,0,0
29,102,1,0,0,0,0,0,0,1,4,0,0,0,0,0,0,0,0
30,83,168,387,1003,2008,217,291,651,106,496,4174,7823,18480,2158,2375,6470,3011,26303
30,88,340,1270,2294,9638,1340,1321,1680,75,856,7072,7885,59197,10944,8635,10249,11932,67082
30,89,1885,4787,2135,38999,12811,3677,3251,509,5312,34608,13355,311811,128432,27673,22918,41134,325166
30,90,3565,14069,3604,95962,36133,4730,6227,570,10428,95660,21600,750272,336857,33969,46156,99566,771872
30,92,4208,28593,8608,162583,34032,17453,19221,936,11481,150683,33011,958068,247439,94770,91179,171191,991079
30,93,27,44,18,531,84,130,32,15,62,228,62,2957,693,665,129,549,3019
30,95,4710,15160,30065,147948,35127,6563,21683,1243,13495,63984,138961,785081,233668,24772,98910,178013,924042
30,96,173,395,110,3577,2251,85,7,95,545,2711,708,31515,21953,562,18,3687,32223
30,97,114,69,3675,1844,313,186,102,44,288,223,10201,8704,2415,497,242,5519,18905
30,98,80,75,1813,3499,212,168,38,30,188,137,3427,5005,624,216,61,5312,8432
30,99,61,81,2588,3724,153,328,74,18,161,119,5444,5193,233,483,105,6312,10637
30,101,1,0,0,0,0,0,0,1,6,0,0,0,0,0,0,0,0
31,81,38,27,64,415,46,60,168,22,118,210,531,3620,463,508,1674,479,4151
31,83,25,13,42,151,8,26,69,16,71,175,474,1584,36,319,656,193,2058
31,87,253,28,18,294,24,64,51,67,682,248,113,2259,217,464,376,312,2372
31,88,664,1911,631,12827,5726,1167,1042,250,1899,13576,4060,110457,59914,8962,7809,13458,114517
31,89,4028,15642,10183,102498,35776,11774,8795,1076,10947,91252,45607,706757,301981,77060,57688,112681,752364
31,90,4,0,0,0,0,0,0,1,12,0,0,0,0,0,0,0,0
31,92,83,549,57,2297,516,315,105,38,216,3640,319,15910,4299,2203,666,2354,16229
31,94,1008,1639,799,27024,7972,2490,2015,152,2934,8023,3499,134720,43016,10324,9203,27823,138219
31,95,2139,4485,13257,56193,13468,3145,3700,769,6202,21339,58945,361691,113271,16100,16179,69450,420636
31,96,3,0,0,0,0,0,0,2,8,0,0,0,0,0,0,0,0
31,97,12,0,0,0,0,0,0,1,43,0,0,0,0,0,0,0,0
31,98,44,10,700,156,9,8,43,22,112,36,1450,482,48,14,85,856,1932
31,99,35,32,658,584,54,93,64,12,110,119,1359,1096,72,102,169,1242,2455
31,100,47,0,100,60,11,4,0,22,113,0,328,437,75,19,0,160,765
32,79,176,698,845,6652,2130,930,897,48,538,4534,5499,45664,15216,6215,7793,7497,51163
32,80,27,37,44,304,29,25,131,17,79,358,348,2863,260,348,1378,348,3211
32,81,3,0,0,0,0,0,0,1,12,0,0,0,0,0,0,0,0
32,85,325,587,809,8167,687,1599,2430,219,829,2576,5646,49823,4019,9237,18939,8976,55469
32,86,5705,9854,4252,114191,25182,25343,5945,1438,16355,44796,20055,645427,149243,157258,37828,118443,665482
32,88,120,80,52,997,180,61,370,67,349,496,234,7474,1650,304,2680,1049,7708
32,89,2,0,0,0,0,0,0,1,6,0,0,0,0,0,0,0,0
32,90,148,419,79,2409,430,219,110,80,474,2823,330,16649,3427,1565,694,2488,16979
32,92,487,1003,664,18419,5435,1209,670,153,1443,4270,1575,83997,30523,4789,3109,19083,85572
32,93,1284,2951,1216,50005,12114,5132,1135,581,3736,10602,3913,221420,74121,17917,4592,51221,225333
32,94,7,8,0,73,44,0,0,5,20,53,0,706,500,0,0,73,706
32,96,13,0,0,0,0,0,0,5,25,0,0,0,0,0,0,0,0
32,97,3,0,0,0,0,0,0,2,8,0,0,0,0,0,0,0,0
32,98,25,7,410,106,17,16,6,9,57,8,1094,485,168,33,9,516,1579
32,99,80,77,1666,3113,219,576,41,23,187,116,3777,3774,320,694,92,4779,7551
32,100,22,0,0,0,0,0,0,12,79,0,0,0,0,0,0,0,0
32,101,7,0,0,0,0,0,0,3,14,0,0,0,0,0,0,0,0
33,79,272,892,2243,4931,763,398,1669,59,651,5703,14530,32058,5512,2506,11035,7174,46588
33,80,30,39,38,300,31,22,116,18,92,484,356,3213,516,210,1175,338,3569
33,84,2183,787,1217,17743,1823,2048,3613,321,6427,5677,8936,145366,18037,16544,30362,18960,154302
33,85,736,599,550,13085,1295,1453,4343,211,1902,3410,3391,89404,10173,8740,32393,13635,92795
33,86,202,122,165,2455,308,321,745,56,544,661,1030,16283,2766,1858,5683,2620,17313
33,87,38,76,10,916,273,52,35,14,116,472,61,7400,2908,383,420,926,7461
33,88,1,0,0,0,0,0,0,1,2,0,0,0,0,0,0,0,0
33,91,6,0,0,0,0,0,0,4,22,0,0,0,0,0,0,0,0
33,92,16,0,0,0,0,0,0,6,37,0,0,0,0,0,0,0,0
33,93,5,0,0,0,0,0,0,3,15,0,0,0,0,0,0,0,0
33,96,4,0,0,0,0,0,0,2,13,0,0,0,0,0,0,0,0
33,97,26,3,145,85,29,34,4,11,55,8,531,472,304,67,21,230,1003
33,99,33,0,0,0,0,0,0,9,159,0,0,0,0,0,0,0,0
33,100,6,0,0,0,0,0,0,2,12,0,0,0,0,0,0,0,0
33,101,6,0,0,0,0,0,0,3,16,0,0,0,0,0,0,0,0
34,78,59,49,91,616,64,102,115,33,193,424,539,5060,597,677,1078,707,5599
34,79,8,0,0,0,0,0,0,8,29,0,0,0,0,0,0,0,0
34,82,38,36,125,886,208,6,100,20,124,234,781,7056,2248,44,753,1011,7837
34,83,28,0,30,94,14,13,20,10,84,0,195,963,152,110,182,124,1158
34,84,2077,3918,4988,51265,4886,8342,5080,663,5695,22734,27982,338985,39215,52703,30505,56253,366967
34,85,778,210,160,4710,533,572,1848,190,1952,1435,1038,36357,4397,3992,14401,4870,37395
34,86,433,1067,210,9303,3678,235,255,160,1270,8276,1373,76564,36516,1406,1481,9513,77937
34,90,96,46,1589,1956,211,194,133,14,227,87,2924,3067,396,272,213,3545,5991
34,92,13,0,0,0,0,0,0,2,28,0,0,0,0,0,0,0,0
34,93,23,0,0,0,0,0,0,3,28,0,0,0,0,0,0,0,0
34,98,3,0,0,0,0,0,0,2,10,0,0,0,0,0,0,0,0
34,99,11,0,0,0,0,0,0,5,27,0,0,0,0,0,0,0,0
34,100,8,0,0,0,0,0,0,4,16,0,0,0,0,0,0,0,0
35,77,126,102,299,2455,152,186,1072,24,294,592,1484,20044,1199,1094,7642,2754,21528
35,78,136,44,81,478,82,33,185,30,367,313,644,4510,919,463,1785,559,5154
35,79,605,416,1636,9088,811,485,4037,186,1867,3278,13458,79374,7504,5159,37083,10724,92832
35,81,368,433,598,7261,2046,111,657,136,1079,3678,4345,65015,22920,763,5310,7859,69360
35,82,3375,3081,9969,66276,11388,829,9895,1534,10135,23322,66933,522498,115955,6600,76529,76245,589431
35,83,936,1014,2136,19432,2004,1075,3919,280,2697,7479,15270,145657,17895,6348,30655,21568,160927
35,85,6,0,0,0,0,0,0,3,14,0,0,0,0,0,0,0,0
35,86,2,0,0,0,0,0,0,2,56,0,0,0,0,0,0,0,0
35,87,8,0,0,0,0,0,0,2,15,0,0,0,0,0,0,0,0
35,90,5,0,0,0,0,0,0,4,17,0,0,0,0,0,0,0,0
35,91,1,0,0,0,0,0,0,1,3,0,0,0,0,0,0,0,0
35,92,1,0,0,0,0,0,0,1,4,0,0,0,0,0,0,0,0
35,93,2,0,0,0,0,0,0,1,4,0,0,0,0,0,0,0,0
35,96,7,18,121,593,77,66,1,7,28,100,190,1151,147,71,1,714,1341
35,97,101,142,1477,5567,282,443,32,24,266,195,2329,6256,393,632,37,7044,8585
35,98,4,0,0,0,0,0,0,3,12,0,0,0,0,0,0,0,0
35,100,15,0,0,0,0,0,0,6,40,0,0,0,0,0,0,0,0
36,76,294,367,1075,5113,826,1003,742,151,878,3097,6393,36304,7629,6969,5803,6188,42697
36,77,43,139,101,884,118,86,273,26,134,1169,570,7241,1044,607,2707,985,7811
36,78,410,796,1204,8925,1844,418,2057,219,1351,6602,9266,74138,17703,3165,17864,10129,83404
36,79,462,921,2218,15298,2555,751,1916,230,1407,4871,10596,80231,17116,2872,15740,17516,90827
36,80,2177,18363,13402,104330,20029,3502,6310,442,5641,100210,46944,525385,137502,17435,32077,117732,572329
36,81,6499,14242,17645,163939,46831,4552,9956,1206,19354,106386,108552,1334894,463495,32941,71406,181584,1443446
36,82,215,194,249,4815,353,159,833,62,591,1486,1372,34645,3957,1279,6865,5064,36017
36,83,62,65,326,1192,212,68,212,20,186,515,2789,8787,1751,368,1436,1518,11576
36,84,106,138,34,1353,456,59,93,41,290,983,202,9896,4168,366,632,1387,10098
36,85,12,22,942,656,154,50,36,3,69,40,1773,1397,299,90,72,1598,3170
36,86,9,0,0,0,0,0,0,4,21,0,0,0,0,0,0,0,0
36,89,1,0,0,0,0,0,0,1,3,0,0,0,0,0,0,0,0
36,91,226,290,1426,35525,1021,1251,154,44,514,367,1970,38358,1468,1783,174,36951,40328
36,93,3,0,0,0,0,0,0,1,5,0,0,0,0,0,0,0,0
36,95,1,0,0,0,0,0,0,1,3,0,0,0,0,0,0,0,0
36,96,47,0,0,0,0,0,0,8,109,0,0,0,0,0,0,0,0
36,97,35,0,0,0,0,0,0,12,112,0,0,0,0,0,0,0,0
36,98,5,0,0,0,0,0,0,4,17,0,0,0,0,0,0,0,0
36,100,16,0,0,0,0,0,0,7,42,0,0,0,0,0,0,0,0
36,103,2,0,0,0,0,0,0,1,4,0,0,0,0,0,0,0,0
36,104,2,0,0,0,0,0,0,1,4,0,0,0,0,0,0,0,0
37,75,77,57,83,801,104,167,291,37,197,517,930,7310,834,1408,3165,884,8240
37,76,6,0,0,0,0,0,0,3,21,0,0,0,0,0,0,0,0
37,77,256,144,667,3707,574,68,1538,131,762,1382,5257,32847,6200,519,13219,4374,38104
37,78,1711,1664,3829,35766,5129,976,7012,628,4915,12451,26594,267905,48924,6587,54526,39595,294499
37,79,5443,17283,49176,336402,34369,20812,11450,2479,14382,77578,126459,1013661,168111,58362,50921,385578,1140120
37,80,26,8,14,352,41,66,2,15,78,118,104,2217,437,327,6,366,2321
37,81,249,287,507,3846,1273,105,612,120,762,2422,3597,32757,13253,676,5163,4353,36354
37,82,356,849,692,7519,2608,151,1233,106,955,5822,4441,57536,22986,874,9267,8211,61977
37,83,105,64,43,1528,415,91,72,38,275,288,332,10204,3501,513,496,1571,10536
37,85,17,0,0,0,0,0,0,7,37,0,0,0,0,0,0,0,0
37,86,55,0,0,0,0,0,0,7,112,0,0,0,0,0,0,0,0
37,87,5,0,0,0,0,0,0,2,9,0,0,0,0,0,0,0,0
37,88,1,0,0,0,0,0,0,1,3,0,0,0,0,0,0,0,0
37,89,5,0,0,0,0,0,0,2,10,0,0,0,0,0,0,0,0
37,90,65,126,160,1941,359,255,12,22,153,686,316,4913,811,693,48,2101,5229
37,91,14,0,0,0,0,0,0,3,33,0,0,0,0,0,0,0,0
37,94,3,0,0,0,0,0,0,1,6,0,0,0,0,0,0,0,0
37,95,3,0,0,0,0,0,0,3,11,0,0,0,0,0,0,0,0
37,97,5,0,0,0,0,0,0,3,11,0,0,0,0,0,0,0,0
37,99,36,0,0,0,0,0,0,8,87,0,0,0,0,0,0,0,0
37,100,6,0,0,0,0,0,0,2,11,0,0,0,0,0,0,0,0
37,101,2,0,0,0,0,0,0,2,5,0,0,0,0,0,0,0,0
37,102,56,0,0,0,0,0,0,3,159,0,0,0,0,0,0,0,0
37,103,7,0,0,0,0,0,0,3,16,0,0,0,0,0,0,0,0
37,105,3,0,0,0,0,0,0,1,8,0,0,0,0,0,0,0,0
38,74,1,0,0,0,0,0,0,1,2,0,0,0,0,0,0,0,0
38,76,4,15,0,54,2,10,9,4,16,182,0,542,14,119,81,54,542
38,77,818,544,1217,11572,1317,232,4320,283,2286,4696,8345,100476,14122,1726,39672,12789,108821
38,78,1500,2396,5374,26458,5352,789,4284,469,3980,14098,30186,191427,49702,4474,33208,31832,221613
38,79,16,0,0,0,0,0,0,9,43,0,0,0,0,0,0,0,0
38,80,40,20,30,284,128,16,0,23,131,162,143,2250,1217,72,0,314,2393
38,81,27,4,18,74,28,3,3,16,82,16,124,605,294,14,30,92,729
38,82,289,199,686,5351,1248,276,769,147,858,1528,4813,44940,13096,2355,6012,6037,49753
38,83,393,427,395,9359,2189,464,2605,47,1118,2537,2827,57128,11577,1929,21239,9754,59955
38,86,146,43,1658,3103,225,1493,125,14,301,104,4282,4695,338,1758,433,4761,8977
38,87,11,0,0,0,0,0,0,4,24,0,0,0,0,0,0,0,0
38,88,27,39,425,737,92,147,24,6,64,57,1171,1624,139,331,31,1162,2795
38,90,5,0,0,0,0,0,0,1,10,0,0,0,0,0,0,0,0
38,91,14,2,2,395,28,44,3,6,31,4,2,650,44,59,30,397,652
38,93,6,0,0,0,0,0,0,3,14,0,0,0,0,0,0,0,0
38,94,15,3,25,256,50,36,0,7,40,11,65,832,296,67,0,281,897
38,96,2500,0,0,0,0,0,0,1,5000,0,0,0,0,0,0,0,0
38,97,3,0,0,0,0,0,0,1,18,0,0,0,0,0,0,0,0
38,98,2,0,0,0,0,0,0,1,4,0,0,0,0,0,0,0,0
38,99,21,0,0,0,0,0,0,5,41,0,0,0,0,0,0,0,0
38,100,206,0,0,0,0,0,0,27,532,0,0,0,0,0,0,0,0
38,101,39,0,0,0,0,0,0,2,95,0,0,0,0,0,0,0,0
38,102,16,0,0,0,0,0,0,6,42,0,0,0,0,0,0,0,0
38,103,28,0,0,0,0,0,0,8,57,0,0,0,0,0,0,0,0
38,104,6,0,0,0,0,0,0,2,28,0,0,0,0,0,0,0,0
38,105,2,0,0,0,0,0,0,1,8,0,0,0,0,0,0,0,0
39,73,3,0,0,0,0,0,0,1,6,0,0,0,0,0,0,0,0
39,75,1,0,0,0,0,0,0,1,4,0,0,0,0,0,0,0,0
39,76,4703,8720,27248,133251,14770,4297,26944,890,12733,46585,130886,790571,104753,19407,196686,160499,921457
39,77,2302,1862,12570,46497,4474,540,12703,586,6249,15002,83401,359359,45300,4673,100011,59067,442760
39,78,73,71,31,762,254,33,10,27,190,458,128,5396,2301,233,54,793,5524
39,79,11,0,0,0,0,0,0,3,26,0,0,0,0,0,0,0,0
39,80,33,61,15,612,198,27,5,18,113,426,43,4738,2046,151,21,627,4781
39,81,409,506,1231,11237,3083,403,871,161,1095,2671,6708,58674,23160,1559,5960,12468,65382
39,82,2262,4607,4408,65239,14842,1939,5134,469,5998,24045,19632,371937,88186,7291,26440,69647,391569
39,91,23,0,0,0,0,0,0,7,47,0,0,0,0,0,0,0,0
39,93,21,15,73,1967,171,203,19,13,70,27,162,3446,343,344,21,2040,3608
39,95,27,32,132,1975,91,85,5,11,64,50,217,3163,149,270,5,2107,3380
39,96,64,0,0,0,0,0,0,4,130,0,0,0,0,0,0,0,0
39,97,6,0,0,0,0,0,0,3,15,0,0,0,0,0,0,0,0
39,99,3,0,0,0,0,0,0,2,5,0,0,0,0,0,0,0,0
39,100,20,0,0,0,0,0,0,7,48,0,0,0,0,0,0,0,0
39,101,333,468,2120,10968,1206,356,201,39,831,567,4211,14553,1831,498,356,13088,18764
39,102,19,0,0,0,0,0,0,6,42,0,0,0,0,0,0,0,0
39,104,15,0,0,0,0,0,0,1,34,0,0,0,0,0,0,0,0
39,105,7,0,0,0,0,0,0,2,36,0,0,0,0,0,0,0,0
39,106,5,0,0,0,0,0,0,2,10,0,0,0,0,0,0,0,0
39,107,17,0,0,0,0,0,0,1,34,0,0,0,0,0,0,0,0
39,111,6,0,0,0,0,0,0,2,11,0,0,0,0,0,0,0,0
39,112,8,0,0,0,0,0,0,1,16,0,0,0,0,0,0,0,0
40,75,6,11,24,103,12,10,29,4,18,35,142,801,135,54,195,127,943
40,76,3697,5489,7871,69377,13830,2600,15098,621,10390,41806,57910,532856,122377,18958,112286,77248,590766
40,77,84,88,256,1050,339,71,38,26,206,519,1337,8255,3551,301,270,1306,9592
40,78,30,0,23,27,1,0,0,10,70,0,163,78,2,0,0,50,241
40,79,36,0,0,0,0,0,0,10,78,0,0,0,0,0,0,0,0
40,80,224,375,503,5334,1575,167,493,65,641,1763,2225,27342,10413,566,2325,5837,29567
40,81,372,425,574,7722,2775,110,671,170,1090,3144,3644,64018,29159,684,4998,8296,67662
40,82,202,7,0,97,47,0,12,79,589,69,0,954,579,0,94,97,954
40,83,1,0,0,0,0,0,0,1,6,0,0,0,0,0,0,0,0
40,84,4,0,0,0,0,0,0,2,8,0,0,0,0,0,0,0,0
40,85,32,0,0,0,0,0,0,1,64,0,0,0,0,0,0,0,0
40,91,638,3795,5280,131448,7460,7064,972,77,1424,6088,7660,167740,12722,10003,1091,136728,175400
40,92,460,1217,1379,50685,3691,3274,236,142,1074,2152,2288,79781,7416,5483,309,52064,82069
40,93,1181,2192,1727,59631,10720,5267,345,113,3191,3856,2446,102303,20915,9150,517,61358,104749
40,94,75,209,350,8468,707,766,58,24,191,347,644,13235,1366,1257,91,8818,13879
40,95,180,273,1409,15699,664,786,96,87,488,471,2134,22665,1174,1218,128,17108,24799
40,96,1,0,0,0,0,0,0,1,4,0,0,0,0,0,0,0,0
40,99,7,0,0,0,0,0,0,1,25,0,0,0,0,0,0,0,0
40,100,20,0,95,248,8,41,0,6,50,0,171,295,8,52,0,343,466
40,104,111,0,0,0,0,0,0,4,222,0,0,0,0,0,0,0,0
40,105,19,0,0,0,0,0,0,5,43,0,0,0,0,0,0,0,0
40,106,111,0,0,0,0,0,0,26,266,0,0,0,0,0,0,0,0
40,107,7,0,0,0,0,0,0,2,15,0,0,0,0,0,0,0,0
40,108,2,0,0,0,0,0,0,1,4,0,0,0,0,0,0,0,0
40,110,44,0,0,0,0,0,0,9,99,0,0,0,0,0,0,0,0
40,111,2,0,0,0,0,0,0,2,4,0,0,0,0,0,0,0,0
40,112,7,0,0,0,0,0,0,2,10,0,0,0,0,0,0,0,0
40,113,2,0,0,0,0,0,0,1,4,0,0,0,0,0,0,0,0
41,74,23,23,22,278,30,22,28,6,68,174,230,2483,314,301,216,300,2713
41,75,2760,4759,9106,48273,10175,3780,9898,752,7845,38532,60330,390767,102704,26655,80093,57379,451097
41,76,48,52,216,818,118,0,97,22,115,364,1525,6611,1126,0,802,1034,8136
41,77,2,0,0,0,0,0,0,2,6,0,0,0,0,0,0,0,0
41,78,23,0,0,0,0,0,0,6,45,0,0,0,0,0,0,0,0
41,79,5,0,2,76,6,6,0,4,12,0,10,369,66,24,0,78,379
41,80,641,625,1895,11211,3011,139,2006,356,2083,4329,12491,88655,29478,947,15654,13106,101146
41,83,12,0,0,0,0,0,0,2,53,0,0,0,0,0,0,0,0
41,84,3,0,0,0,0,0,0,1,6,0,0,0,0,0,0,0,0
41,87,2,0,0,0,0,0,0,1,4,0,0,0,0,0,0,0,0
41,88,5,0,0,0,0,0,0,2,11,0,0,0,0,0,0,0,0
41,89,447,0,0,0,0,0,0,74,1139,0,0,0,0,0,0,0,0
41,90,248,465,562,20451,1532,2299,194,70,593,813,902,32105,2833,3800,231,21013,33007
41,91,174,537,223,14459,1597,1551,98,53,441,1010,304,22889,2858,2533,127,14682,23193
41,92,96,45,13,2037,194,255,21,26,262,95,23,3680,497,418,31,2050,3703
41,93,185,624,405,16813,1770,1642,92,67,508,1102,795,28107,3342,2844,154,17218,28902
41,94,4,0,0,0,0,0,0,3,17,0,0,0,0,0,0,0,0
41,95,2,0,0,0,0,0,0,1,2,0,0,0,0,0,0,0,0
41,99,16,0,0,0,0,0,0,2,40,0,0,0,0,0,0,0,0
41,104,5,0,0,0,0,0,0,2,12,0,0,0,0,0,0,0,0
41,105,6,0,0,0,0,0,0,1,10,0,0,0,0,0,0,0,0
41,106,108,0,0,0,0,0,0,11,257,0,0,0,0,0,0,0,0
41,107,72,0,0,0,0,0,0,6,132,0,0,0,0,0,0,0,0
41,109,10,0,0,0,0,0,0,3,19,0,0,0,0,0,0,0,0
41,110,339,0,0,0,0,0,0,18,715,0,0,0,0,0,0,0,0
41,111,227,0,0,0,0,0,0,31,416,0,0,0,0,0,0,0,0
41,112,26,0,0,0,0,0,0,4,55,0,0,0,0,0,0,0,0
42,72,47,53,191,563,63,32,273,27,125,477,1474,5151,799,191,2578,754,6625
42,74,2791,4112,5613,48372,9824,2705,6863,581,7824,34360,37073,365344,101223,20210,52170,53985,402417
42,75,1412,1474,6190,21881,3006,383,6447,387,3948,10335,45273,156292,29374,2112,47608,28071,201565
42,76,32,0,0,0,0,0,0,13,74,0,0,0,0,0,0,0,0
42,77,13,0,0,0,0,0,0,4,26,0,0,0,0,0,0,0,0
42,78,9,0,0,0,0,0,0,3,19,0,0,0,0,0,0,0,0
42,79,1,0,0,0,0,0,0,1,4,0,0,0,0,0,0,0,0
42,81,11,0,0,0,0,0,0,4,23,0,0,0,0,0,0,0,0
42,83,8,0,0,0,0,0,0,2,24,0,0,0,0,0,0,0,0
42,84,9,0,0,0,0,0,0,5,26,0,0,0,0,0,0,0,0
42,86,5,0,0,0,0,0,0,2,10,0,0,0,0,0,0,0,0
42,89,11,0,0,0,0,0,0,3,26,0,0,0,0,0,0,0,0
42,93,1,0,0,0,0,0,0,1,2,0,0,0,0,0,0,0,0
42,103,41,0,0,0,0,0,0,18,112,0,0,0,0,0,0,0,0
42,104,5,0,0,0,0,0,0,3,16,0,0,0,0,0,0,0,0
42,106,484,96,840,2260,126,561,89,38,1048,221,1316,3781,263,664,120,3100,5097
42,107,31,0,0,0,0,0,0,6,71,0,0,0,0,0,0,0,0
42,109,308,0,0,0,0,0,0,9,549,0,0,0,0,0,0,0,0
42,110,46,0,0,0,0,0,0,6,88,0,0,0,0,0,0,0,0
42,111,29,0,0,0,0,0,0,7,56,0,0,0,0,0,0,0,0
42,112,34,18,254,808,77,11,20,11,105,22,790,980,86,15,24,1062,1770
42,113,137,0,0,0,0,0,0,5,263,0,0,0,0,0,0,0,0
42,114,4,0,0,0,0,0,0,1,8,0,0,0,0,0,0,0,0
43,73,129,219,364,1616,172,158,360,73,351,1820,2952,13358,1588,1451,2761,1980,16310
43,74,6426,12784,38843,170889,20781,4163,15184,1840,16425,69191,158269,996276,158357,19947,87699,209732,1154545
43,75,11,0,0,0,0,0,0,5,29,0,0,0,0,0,0,0,0
43,76,11,0,0,0,0,0,0,6,29,0,0,0,0,0,0,0,0
43,77,3,0,0,0,0,0,0,1,7,0,0,0,0,0,0,0,0
43,81,22,0,0,0,0,0,0,4,68,0,0,0,0,0,0,0,0
43,83,4,0,0,0,0,0,0,2,8,0,0,0,0,0,0,0,0
43,84,4,0,0,0,0,0,0,1,13,0,0,0,0,0,0,0,0
43,86,3,0,0,0,0,0,0,1,6,0,0,0,0,0,0,0,0
43,89,2,0,0,0,0,0,0,1,4,0,0,0,0,0,0,0,0
43,98,3,0,0,0,0,0,0,1,6,0,0,0,0,0,0,0,0
43,100,2,0,0,0,0,0,0,1,4,0,0,0,0,0,0,0,0
43,104,2,0,0,0,0,0,0,1,3,0,0,0,0,0,0,0,0
43,105,169,0,0,0,0,0,0,5,335,0,0,0,0,0,0,0,0
43,106,1040,1423,10574,39379,2526,1788,1510,262,2264,2645,21018,85914,5505,4071,2572,49953,106932
43,107,9189,26075,140453,820346,48190,47743,19773,1598,19009,42862,250430,1469125,91655,93180,31814,960799,1719555
43,108,59,0,0,0,0,0,0,2,111,0,0,0,0,0,0,0,0
43,109,89,0,0,0,0,0,0,13,187,0,0,0,0,0,0,0,0
43,110,10,0,0,0,0,0,0,2,20,0,0,0,0,0,0,0,0
43,111,2,0,0,0,0,0,0,1,4,0,0,0,0,0,0,0,0
43,112,1,0,0,0,0,0,0,1,2,0,0,0,0,0,0,0,0
43,113,8,0,0,0,0,0,0,2,17,0,0,0,0,0,0,0,0
43,114,1,0,0,0,0,0,0,1,3,0,0,0,0,0,0,0,0
44,73,487,244,1546,9727,1224,312,316,120,1384,1789,11261,47440,8383,1763,2328,11273,58701
44,74,1373,1435,3287,31427,3397,395,3731,481,3704,9993,20994,226958,32152,2691,27079,34714,247952
44,75,78,67,110,1121,550,28,68,42,228,917,775,10267,6125,135,598,1231,11042
44,76,5,0,0,0,0,0,0,2,16,0,0,0,0,0,0,0,0
44,83,26,7,119,373,41,76,16,12,65,13,484,748,80,266,20,492,1232
44,84,2,0,0,0,0,0,0,1,6,0,0,0,0,0,0,0,0
44,87,1,0,0,0,0,0,0,1,2,0,0,0,0,0,0,0,0
44,98,179,98,9627,7729,115,141,928,24,301,249,36577,13121,448,399,2473,17356,49698
44,101,2,0,0,0,0,0,0,2,5,0,0,0,0,0,0,0,0
44,102,1,0,0,0,0,0,0,1,2,0,0,0,0,0,0,0,0
44,103,10,0,0,0,0,0,0,3,19,0,0,0,0,0,0,0,0
44,105,282,122,2149,9710,421,230,287,45,538,143,2845,13279,576,299,486,11859,16124
44,106,28,0,46,45,2,0,7,11,79,0,139,263,3,0,10,91,402
44,107,69,6,88,144,12,8,4,20,331,29,289,615,27,38,15,232,904
44,109,1,0,0,0,0,0,0,1,2,0,0,0,0,0,0,0,0
44,110,93,0,0,0,0,0,0,10,184,0,0,0,0,0,0,0,0
44,111,4,0,0,0,0,0,0,1,8,0,0,0,0,0,0,0,0
44,114,22,0,0,0,0,0,0,2,54,0,0,0,0,0,0,0,0
44,115,3,0,0,0,0,0,0,3,6,0,0,0,0,0,0,0,0
45,71,2355,4710,3028,57438,10184,1821,3979,594,6714,31748,19309,397889,74272,9520,32578,60466,417198
45,72,665,830,757,15195,2122,472,961,239,2004,6297,4725,119561,20417,3404,7532,15952,124286
45,73,1628,1315,3946,34113,4560,1106,2310,710,4488,9281,22348,253876,42953,7349,16757,38059,276224
45,74,4071,13872,35898,206404,32076,8393,6929,802,10064,72410,104852,942552,199600,30315,33453,242302,1047404
45,75,312,978,2040,17047,2376,1108,397,87,831,1779,5796,32335,4882,1996,824,19087,38131
45,76,4,0,0,0,0,0,0,1,12,0,0,0,0,0,0,0,0
45,77,2,0,0,0,0,0,0,1,4,0,0,0,0,0,0,0,0
45,87,13,0,0,0,0,0,0,4,34,0,0,0,0,0,0,0,0
45,99,8,0,0,0,0,0,0,1,16,0,0,0,0,0,0,0,0
45,101,3,0,0,0,0,0,0,1,6,0,0,0,0,0,0,0,0
45,105,13,0,0,0,0,0,0,2,27,0,0,0,0,0,0,0,0
45,106,37,1,12,48,1,5,4,5,71,1,22,71,4,5,5,60,93
45,107,253,947,4857,7203,674,680,228,20,481,1717,7807,11757,1423,1298,342,12060,19564
45,110,5,0,0,0,0,0,0,4,14,0,0,0,0,0,0,0,0
45,111,1,0,0,0,0,0,0,1,2,0,0,0,0,0,0,0,0
45,112,2,0,0,0,0,0,0,1,4,0,0,0,0,0,0,0,0
45,114,59,0,0,0,0,0,0,3,139,0,0,0,0,0,0,0,0
45,115,11,0,0,0,0,0,0,1,18,0,0,0,0,0,0,0,0
45,117,1,0,0,0,0,0,0,1,2,0,0,0,0,0,0,0,0
46,70,2126,2493,3312,47767,5904,782,2551,839,6322,17540,22999,386665,57170,5412,21142,51079,409664
46,71,912,985,1199,21894,2310,339,1119,390,2866,7404,8327,175722,21915,2232,8850,23093,184049
46,72,772,622,1453,14896,1651,368,2108,309,2274,6058,11871,127271,17844,2933,19785,16349,139142
46,73,20,29,73,381,93,42,2,14,63,155,325,2195,704,166,2,454,2520
46,74,25,18,27,329,48,25,6,8,61,31,57,957,165,51,17,356,1014
46,75,11,0,0,0,0,0,0,8,41,0,0,0,0,0,0,0,0
46,76,50,14,55,312,75,28,0,15,118,36,69,942,319,85,0,367,1011
46,77,6,0,0,0,0,0,0,5,29,0,0,0,0,0,0,0,0
46,78,6,7,0,114,16,4,9,4,18,20,0,654,78,18,46,114,654
46,85,2,0,0,0,0,0,0,1,4,0,0,0,0,0,0,0,0
46,101,2,0,0,0,0,0,0,1,4,0,0,0,0,0,0,0,0
46,102,1,0,0,0,0,0,0,1,2,0,0,0,0,0,0,0,0
46,103,1,0,0,0,0,0,0,1,5,0,0,0,0,0,0,0,0
46,107,45,0,0,0,0,0,0,4,101,0,0,0,0,0,0,0,0
46,108,1,0,0,0,0,0,0,1,2,0,0,0,0,0,0,0,0
46,109,8,0,0,0,0,0,0,2,17,0,0,0,0,0,0,0,0
46,110,12,0,0,0,0,0,0,1,25,0,0,0,0,0,0,0,0
46,111,5,0,0,0,0,0,0,1,10,0,0,0,0,0,0,0,0
46,112,2,0,0,0,0,0,0,1,4,0,0,0,0,0,0,0,0
46,114,3,0,0,0,0,0,0,1,6,0,0,0,0,0,0,0,0
46,117,12,0,0,0,0,0,0,5,28,0,0,0,0,0,0,0,0
46,118,306,0,121,272,0,0,271,24,717,0,256,569,0,0,566,393,825
47,62,7,2,11,71,6,8,24,6,24,18,55,722,52,33,437,82,777
47,69,78,183,129,1311,226,31,151,40,217,1655,1093,11833,2122,333,1343,1440,12926
47,70,717,597,445,15031,1726,174,852,322,2246,4907,3049,132431,18317,1444,8050,15476,135480
47,71,19,7,4,99,60,0,0,11,52,37,20,885,640,0,0,103,905
47,72,4,0,0,0,0,0,0,2,12,0,0,0,0,0,0,0,0
47,73,6,0,0,0,0,0,0,3,14,0,0,0,0,0,0,0,0
47,74,3,0,0,0,0,0,0,1,6,0,0,0,0,0,0,0,0
47,75,2,0,0,0,0,0,0,2,10,0,0,0,0,0,0,0,0
47,76,12,0,0,0,0,0,0,6,31,0,0,0,0,0,0,0,0
47,77,1,0,0,0,0,0,0,1,6,0,0,0,0,0,0,0,0
47,100,2,0,0,0,0,0,0,1,4,0,0,0,0,0,0,0,0
47,101,38,30,290,234,26,41,46,11,85,45,624,518,52,110,111,524,1142
47,112,7,0,0,0,0,0,0,2,14,0,0,0,0,0,0,0,0
47,113,14,0,0,0,0,0,0,3,31,0,0,0,0,0,0,0,0
47,114,29,0,0,0,0,0,0,1,58,0,0,0,0,0,0,0,0
47,115,416,0,0,0,0,0,0,33,780,0,0,0,0,0,0,0,0
47,116,24,0,0,0,0,0,0,5,45,0,0,0,0,0,0,0,0
47,117,12,0,0,0,0,0,0,3,19,0,0,0,0,0,0,0,0
47,118,23,0,0,0,0,0,0,8,48,0,0,0,0,0,0,0,0
48,62,1,0,0,0,0,0,0,1,4,0,0,0,0,0,0,0,0
48,63,668,404,5577,11630,756,445,1764,203,1849,3195,30950,75363,5323,2895,12855,17207,106313
48,69,62,91,4,734,205,31,71,34,183,772,42,6750,2264,312,722,738,6792
48,70,2355,3067,1635,67866,14901,1760,2575,714,6890,23627,11829,530497,132163,10981,19018,69501,542326
48,71,19,0,12,258,53,15,0,13,60,0,56,2258,669,61,0,270,2314
48,72,19,12,0,78,17,0,0,11,58,98,0,679,146,0,0,78,679
48,74,12,0,0,0,0,0,0,5,32,0,0,0,0,0,0,0,0
48,75,2,0,0,0,0,0,0,2,7,0,0,0,0,0,0,0,0
48,76,30,16,156,251,26,31,4,11,69,39,402,1060,135,138,6,407,1462
48,79,70,0,0,0,0,0,0,8,129,0,0,0,0,0,0,0,0
48,101,108,0,0,0,0,0,0,12,215,0,0,0,0,0,0,0,0
48,102,3,0,0,0,0,0,0,1,6,0,0,0,0,0,0,0,0
48,103,3,0,0,0,0,0,0,2,10,0,0,0,0,0,0,0,0
48,105,96,0,0,0,0,0,0,4,205,0,0,0,0,0,0,0,0
48,106,3,0,0,0,0,0,0,1,5,0,0,0,0,0,0,0,0
48,108,74,0,0,0,0,0,0,2,128,0,0,0,0,0,0,0,0
48,112,12,0,0,0,0,0,0,2,39,0,0,0,0,0,0,0,0
48,113,548,0,0,0,0,0,0,19,965,0,0,0,0,0,0,0,0
48,116,196,386,3479,4726,301,232,509,11,452,659,6514,7996,903,397,991,8205,14510
49,63,862,404,6389,18774,994,1115,2761,367,2237,2959,32495,104113,6222,7080,21337,25163,136608
49,68,23,37,22,296,41,5,68,12,55,313,162,3025,418,35,679,318,3187
49,69,167,254,437,3456,601,115,337,88,505,2266,3490,27093,5567,1136,3107,3893,30583
49,70,7057,7587,23922,259476,32475,7665,7981,2365,19718,43643,90188,1304151,234282,27872,52206,283398,1394339
49,71,296,171,594,6840,1026,291,194,165,928,1138,1629,42483,9185,1270,1305,7434,44112
49,72,4,0,0,0,0,0,0,1,8,0,0,0,0,0,0,0,0
49,75,2,0,0,0,0,0,0,1,8,0,0,0,0,0,0,0,0
49,76,2,0,0,0,0,0,0,1,4,0,0,0,0,0,0,0,0
49,102,1,0,0,0,0,0,0,1,2,0,0,0,0,0,0,0,0
49,105,16,0,0,0,0,0,0,2,34,0,0,0,0,0,0,0,0
49,106,1,0,0,0,0,0,0,1,2,0,0,0,0,0,0,0,0
49,110,52,0,0,0,0,0,0,5,113,0,0,0,0,0,0,0,0
49,115,49,0,0,0,0,0,0,5,92,0,0,0,0,0,0,0,0
50,63,126,91,298,1909,154,123,445,44,377,853,3377,17164,1408,1314,4926,2207,20541
50,68,496,307,1318,6938,851,264,1503,202,1458,2522,10779,60841,8420,2381,14693,8256,71620
50,69,199,184,955,2952,453,110,432,81,739,1462,6154,25200,4605,1030,4184,3907,31354
50,70,1432,1253,1743,47109,4845,747,2165,535,4254,8708,8121,283284,39926,3202,16573,48852,291405
50,71,1916,1449,4474,55231,6343,1345,3001,811,5647,9066,17473,331364,51755,4961,21145,59705,348837
50,72,9,0,0,0,0,0,0,4,24,0,0,0,0,0,0,0,0
50,73,8,0,0,0,0,0,0,3,20,0,0,0,0,0,0,0,0
50,77,1,0,0,0,0,0,0,1,6,0,0,0,0,0,0,0,0
50,78,6,0,0,0,0,0,0,4,21,0,0,0,0,0,0,0,0
50,98,35,0,0,0,0,0,0,5,70,0,0,0,0,0,0,0,0
50,100,3,0,0,0,0,0,0,1,6,0,0,0,0,0,0,0,0
50,103,5,0,0,0,0,0,0,1,10,0,0,0,0,0,0,0,0
50,104,19,0,0,0,0,0,0,2,37,0,0,0,0,0,0,0,0
50,109,1,0,0,0,0,0,0,1,3,0,0,0,0,0,0,0,0
50,111,2,0,0,0,0,0,0,1,10,0,0,0,0,0,0,0,0
50,112,2,0,0,0,0,0,0,1,4,0,0,0,0,0,0,0,0
50,114,74,0,0,0,0,0,0,6,140,0,0,0,0,0,0,0,0
50,115,12,0,0,0,0,0,0,1,20,0,0,0,0,0,0,0,0
50,116,20,0,0,0,0,0,0,3,44,0,0,0,0,0,0,0,0
51,53,2,0,0,0,0,0,0,1,4,0,0,0,0,0,0,0,0
51,65,1,0,0,0,0,0,0,1,2,0,0,0,0,0,0,0,0
51,67,27,53,22,494,47,26,73,13,81,538,171,4165,460,174,699,516,4336
51,68,68,76,98,1403,156,59,185,27,199,767,706,11561,1680,395,1826,1501,12267
51,70,1329,1171,6015,99366,5178,2887,627,849,3289,3518,11912,287552,17618,7927,1654,105381,299464
51,71,6369,4952,39472,452341,22905,15608,4042,3492,16382,14600,80681,1227369,86970,40188,10776,491813,1308050
51,72,14,0,0,0,0,0,0,7,34,0,0,0,0,0,0,0,0
51,73,7,0,0,84,24,0,0,5,24,0,0,776,239,0,0,84,776
51,74,1,0,0,0,0,0,0,1,4,0,0,0,0,0,0,0,0
51,77,11,0,0,0,0,0,0,4,28,0,0,0,0,0,0,0,0
51,78,3,0,0,0,0,0,0,1,6,0,0,0,0,0,0,0,0
51,100,2,0,0,0,0,0,0,1,6,0,0,0,0,0,0,0,0
51,101,19,113,65,700,151,64,49,5,53,223,116,1255,314,97,111,765,1371
51,103,24,0,0,0,0,0,0,2,54,0,0,0,0,0,0,0,0
51,106,16,0,0,0,0,0,0,5,33,0,0,0,0,0,0,0,0
51,107,2,0,0,0,0,0,0,1,4,0,0,0,0,0,0,0,0
51,112,1,0,0,0,0,0,0,1,2,0,0,0,0,0,0,0,0
51,114,2,0,0,0,0,0,0,1,4,0,0,0,0,0,0,0,0
51,115,29,0,0,0,0,0,0,1,61,0,0,0,0,0,0,0,0
52,65,3650,2967,6895,182935,7347,6960,4455,829,8739,16812,23481,631468,41692,33319,31972,189830,654949
52,66,49,38,19,752,73,62,28,20,128,358,112,5118,628,362,263,771,5230
52,67,5,0,12,123,16,0,5,4,20,0,90,1110,197,0,63,135,1200
52,68,597,932,1126,12599,1304,421,1102,207,1623,6809,6390,90494,11953,2509,8297,13725,96884
52,69,815,1004,1337,15998,1441,423,1184,315,2334,7425,9684,129929,13942,3264,11785,17335,139613
52,70,2002,3374,9001,96309,14951,3680,2113,587,5339,16117,19167,419807,78264,11468,9069,105310,438974
52,71,1231,693,5753,46295,3672,2112,771,770,3642,3407,15919,193103,24987,7977,2604,52048,209022
52,72,24,0,0,0,0,0,0,10,66,0,0,0,0,0,0,0,0
52,73,9,0,0,0,0,0,0,4,24,0,0,0,0,0,0,0,0
52,74,5,0,0,0,0,0,0,3,17,0,0,0,0,0,0,0,0
52,76,1,0,0,0,0,0,0,1,6,0,0,0,0,0,0,0,0
52,100,24,0,0,0,0,0,0,6,59,0,0,0,0,0,0,0,0
52,102,68,0,0,0,0,0,0,7,141,0,0,0,0,0,0,0,0
52,105,20,0,0,0,0,0,0,1,40,0,0,0,0,0,0,0,0
52,106,2,0,0,0,0,0,0,1,4,0,0,0,0,0,0,0,0
52,108,4,0,0,0,0,0,0,1,8,0,0,0,0,0,0,0,0
52,109,20,0,0,0,0,0,0,2,38,0,0,0,0,0,0,0,0
52,112,14,0,0,0,0,0,0,3,34,0,0,0,0,0,0,0,0
52,113,107,0,0,0,0,0,0,7,205,0,0,0,0,0,0,0,0
52,115,7,0,0,0,0,0,0,1,15,0,0,0,0,0,0,0,0
53,59,2,0,0,0,0,0,0,1,4,0,0,0,0,0,0,0,0
53,65,186,127,78,2392,238,35,276,55,472,968,653,19768,2086,224,2601,2470,20421
53,66,54,21,92,1037,145,108,33,30,160,162,565,7342,1370,675,263,1129,7907
53,67,57,53,45,1123,153,61,139,26,152,391,405,8818,1537,419,1108,1168,9223
53,68,89,49,104,1309,202,106,14,38,245,315,528,8207,1875,621,99,1413,8735
53,69,2186,2622,6382,71383,9387,1856,5071,567,5726,16557,28597,517041,80291,11311,34969,77765,545638
53,70,2398,2575,8279,96753,8049,1551,1999,679,6182,13479,21188,481877,52368,6740,10499,105032,503065
53,71,36,15,11,715,151,14,0,24,122,133,55,5390,1550,77,0,726,5445
53,72,225,0,0,0,0,0,0,18,491,0,0,0,0,0,0,0,0
53,73,31,15,29,359,86,0,8,10,73,171,48,3220,860,0,9,388,3268
53,74,95,69,3821,6930,843,117,128,17,173,124,7068,7785,961,288,268,10751,14853
53,75,17,0,0,0,0,0,0,7,49,0,0,0,0,0,0,0,0
53,98,5,0,0,0,0,0,0,1,15,0,0,0,0,0,0,0,0
53,99,11,0,0,0,0,0,0,4,28,0,0,0,0,0,0,0,0
53,103,4,0,0,0,0,0,0,1,9,0,0,0,0,0,0,0,0
53,108,16,0,0,0,0,0,0,2,32,0,0,0,0,0,0,0,0
53,109,169,100,1797,1347,203,137,121,17,511,172,3244,3351,505,311,230,3144,6595
53,114,1,0,0,0,0,0,0,1,2,0,0,0,0,0,0,0,0
54,65,460,417,355,10652,1291,250,1417,147,1413,3409,3261,91764,10811,1760,14515,11007,95025
54,66,1872,1498,7357,46235,3719,2183,5797,389,4697,13206,45983,311824,36577,13947,44518,53592,357807
54,67,2901,10452,6739,94900,11372,5651,4027,574,7163,75136,30117,589316,86204,30907,30087,101639,619433
54,68,25,41,17,255,61,26,0,14,73,403,77,2187,638,236,0,272,2264
54,69,665,565,2291,15262,2255,542,1316,260,1890,4838,14793,115444,22023,3844,11747,17553,130237
54,70,4010,4494,5450,108733,16476,1619,4577,1162,11176,26266,21877,677059,124995,6971,25775,114183,698936
54,71,2,0,0,0,0,0,0,2,12,0,0,0,0,0,0,0,0
54,72,37,3,2,99,19,0,0,15,96,15,18,879,187,0,0,101,897
54,73,59,17,12,162,81,0,0,12,125,98,48,1472,887,0,0,174,1520
54,74,3,0,0,0,0,0,0,1,8,0,0,0,0,0,0,0,0
54,99,12,0,0,0,0,0,0,1,27,0,0,0,0,0,0,0,0
54,101,2,0,0,0,0,0,0,1,3,0,0,0,0,0,0,0,0
54,104,45,0,0,0,0,0,0,2,58,0,0,0,0,0,0,0,0
54,109,14,0,0,0,0,0,0,3,27,0,0,0,0,0,0,0,0
54,111,9,0,0,0,0,0,0,2,14,0,0,0,0,0,0,0,0
55,61,5,0,0,0,0,0,0,2,12,0,0,0,0,0,0,0,0
55,62,1007,1027,3476,24239,2794,1018,2332,290,2397,8609,13450,145867,24600,5413,18069,27715,159317
55,63,2,0,0,0,0,0,0,2,4,0,0,0,0,0,0,0,0
55,64,4,0,0,0,0,0,0,1,8,0,0,0,0,0,0,0,0
55,65,1809,1812,4269,41327,4990,2133,5883,365,4685,14157,25962,283120,40472,13389,50302,45596,309082
55,67,8,18,12,326,56,22,0,3,17,104,44,1779,483,119,0,338,1823
55,68,184,81,491,2848,378,181,299,102,516,608,3910,20890,3838,1107,2571,3339,24800
55,69,1902,1144,1096,39582,5169,372,1919,474,5082,8191,6503,282245,42449,2222,12708,40678,288748
55,70,58,40,100,985,411,30,8,40,210,341,208,8764,4392,221,12,1085,8972
55,71,7,0,0,0,0,0,0,6,30,0,0,0,0,0,0,0,0
55,72,9,0,0,0,0,0,0,4,30,0,0,0,0,0,0,0,0
55,73,44,0,0,0,0,0,0,9,108,0,0,0,0,0,0,0,0
55,100,7,0,0,0,0,0,0,2,18,0,0,0,0,0,0,0,0
55,107,8,0,0,0,0,0,0,2,52,0,0,0,0,0,0,0,0
55,108,8,0,0,0,0,0,0,1,15,0,0,0,0,0,0,0,0
55,109,2,0,0,0,0,0,0,2,4,0,0,0,0,0,0,0,0
55,110,5,0,0,0,0,0,0,2,12,0,0,0,0,0,0,0,0
55,112,96,0,0,0,0,0,0,3,195,0,0,0,0,0,0,0,0
55,113,6,0,0,0,0,0,0,1,14,0,0,0,0,0,0,0,0
56,61,56,30,47,778,40,21,217,22,192,157,438,7392,346,174,2500,825,7830
56,62,842,1107,1009,15696,2639,641,2162,321,2514,10687,7827,147678,30100,5689,22705,16705,155505
56,65,6,0,0,0,0,0,0,4,28,0,0,0,0,0,0,0,0
56,67,199,250,80,3823,573,126,108,80,570,2585,751,32601,5655,866,915,3903,33352
56,68,217,84,291,3308,379,108,299,98,628,660,2203,29617,3802,904,2851,3599,31820
56,69,1231,1030,656,24972,3646,239,652,385,3449,7729,4533,198424,34522,1759,5131,25628,202957
56,70,56,9,5,492,167,12,0,30,174,107,10,4214,1626,104,0,497,4224
56,71,11,0,0,0,0,0,0,5,30,0,0,0,0,0,0,0,0
56,73,4,0,0,0,0,0,0,1,9,0,0,0,0,0,0,0,0
56,106,3,0,0,0,0,0,0,1,7,0,0,0,0,0,0,0,0
56,110,6,0,0,0,0,0,0,1,13,0,0,0,0,0,0,0,0
57,59,321,117,667,2378,180,313,540,74,776,1060,4394,19673,1563,2717,5458,3045,24067
57,61,232,414,720,6971,1377,394,624,81,622,3191,3987,44078,11293,2833,5631,7691,48065
57,62,2,0,0,0,0,0,0,2,8,0,0,0,0,0,0,0,0
57,65,98,72,71,1337,127,68,427,30,261,704,583,11839,1125,636,4194,1408,12422
57,67,190,191,210,4092,329,215,252,76,521,1666,1435,31189,2681,1523,2048,4302,32624
57,69,7094,6413,12740,204944,25807,2194,7932,1251,17250,39664,60045,1397235,177751,11333,56619,217684,1457280
57,70,33,32,40,513,140,17,0,21,127,237,130,4053,1090,137,0,553,4183
57,71,25,0,0,0,0,0,0,13,83,0,0,0,0,0,0,0,0
57,72,11,0,0,0,0,0,0,4,25,0,0,0,0,0,0,0,0
57,99,9,0,0,0,0,0,0,1,15,0,0,0,0,0,0,0,0
57,100,8,0,0,0,0,0,0,1,16,0,0,0,0,0,0,0,0
57,101,13,0,0,0,0,0,0,4,28,0,0,0,0,0,0,0,0
57,102,17,0,0,0,0,0,0,3,41,0,0,0,0,0,0,0,0
57,104,228,200,8817,2544,241,126,464,14,420,396,39253,7321,661,281,1633,11361,46574
57,106,25,0,0,0,0,0,0,1,43,0,0,0,0,0,0,0,0
57,110,30,0,0,0,0,0,0,4,61,0,0,0,0,0,0,0,0
58,59,50,37,281,712,72,53,137,21,114,271,1552,4222,423,263,1024,993,5774
58,62,177,120,159,3053,428,156,233,73,565,998,1377,25285,4438,1198,2171,3212,26662
58,65,295,152,149,5117,331,141,707,115,862,1410,1205,44740,3165,776,7402,5266,45945
58,68,8546,9394,16522,258091,25231,6875,6991,2333,21141,48158,74116,1639870,182799,36996,41216,274613,1713986
58,69,90,28,3,1420,285,8,6,43,262,238,7,10409,2944,30,24,1423,10416
58,70,6,0,0,0,0,0,0,2,12,0,0,0,0,0,0,0,0
58,71,1,0,0,0,0,0,0,1,6,0,0,0,0,0,0,0,0
58,101,12,0,0,0,0,0,0,1,40,0,0,0,0,0,0,0,0
58,103,9,0,0,0,0,0,0,1,22,0,0,0,0,0,0,0,0
58,104,2,0,0,0,0,0,0,1,5,0,0,0,0,0,0,0,0
58,106,1,0,0,0,0,0,0,1,3,0,0,0,0,0,0,0,0
58,108,14,0,0,0,0,0,0,1,27,0,0,0,0,0,0,0,0
58,109,10,0,0,0,0,0,0,2,17,0,0,0,0,0,0,0,0
58,110,9,0,0,0,0,0,0,1,12,0,0,0,0,0,0,0,0
59,62,2,0,0,0,0,0,0,1,4,0,0,0,0,0,0,0,0
59,63,267,102,321,3512,374,192,845,106,750,989,2501,29574,3877,1429,8925,3833,32075
59,64,252,412,182,5596,1353,212,1384,45,608,3988,1390,49313,12103,1130,15038,5778,50703
59,65,27,4,6,358,0,0,30,8,75,24,62,3483,0,0,329,364,3545
59,67,5787,7069,9088,181075,25879,1531,3806,1141,14034,42751,43953,1226838,191149,7892,25655,190163,1270791
59,68,2,0,0,0,0,0,0,2,6,0,0,0,0,0,0,0,0
59,69,2,0,0,0,0,0,0,2,10,0,0,0,0,0,0,0,0
59,70,31,19,7,512,210,12,0,19,126,207,49,5095,2479,100,0,519,5144
59,71,8,0,0,0,0,0,0,5,32,0,0,0,0,0,0,0,0
59,100,5,0,0,0,0,0,0,1,10,0,0,0,0,0,0,0,0
59,107,21,0,0,0,0,0,0,2,39,0,0,0,0,0,0,0,0
59,108,25,33,932,244,41,7,24,6,46,48,2326,485,122,9,28,1176,2811
59,109,18,0,0,0,0,0,0,1,36,0,0,0,0,0,0,0,0
60,62,846,510,2340,17628,1657,937,1626,241,2173,4459,14022,119664,14393,6184,16229,19968,133686
60,63,2551,1752,8453,72365,4675,2155,5087,591,6440,11742,44060,349542,32573,10305,45696,80818,393602
60,64,38,0,0,0,0,0,0,11,107,0,0,0,0,0,0,0,0
60,65,262,331,397,5800,985,370,508,70,701,2802,2752,43655,7542,2270,5213,6197,46407
60,66,2275,2824,1212,59545,3417,379,1391,329,5663,11763,7835,428387,26607,1745,10548,60757,436222
60,68,9,0,0,0,0,0,0,7,28,0,0,0,0,0,0,0,0
60,69,15,0,0,0,0,0,0,6,35,0,0,0,0,0,0,0,0
60,70,186,24,801,708,271,20,15,66,517,249,1294,6908,3551,38,24,1509,8202
60,71,11,0,0,0,0,0,0,4,26,0,0,0,0,0,0,0,0
60,99,85,84,1529,1636,279,207,67,6,208,114,3036,3143,458,358,194,3165,6179
60,104,3,0,0,0,0,0,0,3,14,0,0,0,0,0,0,0,0
61,62,87,93,233,1880,203,104,218,39,226,817,1580,13366,1583,639,2278,2113,14946
61,63,3342,2972,6524,81005,11502,2161,5592,483,7970,20058,35898,583430,89946,11512,42503,87529,619328
61,64,18,0,5,231,27,0,6,6,35,0,48,2113,345,0,48,236,2161
61,65,4,0,0,0,0,0,0,1,8,0,0,0,0,0,0,0,0
61,66,1870,818,4829,56412,5053,419,1425,300,4536,5128,20478,370586,32863,1650,8858,61241,391064
61,67,14,0,0,0,0,0,0,5,34,0,0,0,0,0,0,0,0
61,69,1,0,0,0,0,0,0,1,5,0,0,0,0,0,0,0,0
61,70,28,25,36,394,134,14,7,12,75,157,99,2960,1541,30,11,430,3059
61,71,8,0,0,0,0,0,0,4,24,0,0,0,0,0,0,0,0
61,99,16,0,0,0,0,0,0,1,23,0,0,0,0,0,0,0,0
61,104,1,0,0,0,0,0,0,1,6,0,0,0,0,0,0,0,0
61,105,6,0,0,0,0,0,0,1,12,0,0,0,0,0,0,0,0
61,108,18,0,0,0,0,0,0,1,39,0,0,0,0,0,0,0,0
61,110,2,0,0,0,0,0,0,1,4,0,0,0,0,0,0,0,0
62,63,421,229,329,7607,767,125,300,131,966,1977,2585,61703,7042,809,2518,7936,64288
62,64,78,10,73,1667,54,22,14,24,199,133,258,11685,322,62,100,1740,11943
62,65,2865,1165,3614,76409,4382,741,3236,533,6818,6140,16061,498354,27312,3011,15319,80023,514415
62,66,55,0,0,0,0,0,0,16,130,0,0,0,0,0,0,0,0
62,67,31,7,274,701,61,41,9,8,68,7,468,1431,216,53,15,975,1899
62,98,5,0,0,0,0,0,0,1,13,0,0,0,0,0,0,0,0
62,101,21,0,0,0,0,0,0,1,49,0,0,0,0,0,0,0,0
62,102,87,0,0,0,0,0,0,5,208,0,0,0,0,0,0,0,0
62,107,27,92,425,481,8,136,46,6,49,188,1594,1581,27,324,144,906,3175
63,60,370,49,332,3893,191,229,156,66,804,285,1643,13592,966,824,1263,4225,15235
63,62,250,0,0,0,0,0,0,81,563,0,0,0,0,0,0,0,0
63,63,1,0,0,0,0,0,0,1,4,0,0,0,0,0,0,0,0
63,64,57,17,222,730,64,27,99,15,145,28,593,3255,305,113,317,952,3848
63,65,101,60,192,1698,397,107,61,41,264,269,615,7400,2429,274,242,1890,8015
63,66,18,0,0,0,0,0,0,5,45,0,0,0,0,0,0,0,0
63,98,12,0,0,0,0,0,0,2,27,0,0,0,0,0,0,0,0
63,99,11,0,0,0,0,0,0,5,26,0,0,0,0,0,0,0,0
63,101,79,75,3226,1208,156,109,178,7,165,169,6503,3859,559,163,295,4434,10362
63,104,13,0,0,0,0,0,0,1,56,0,0,0,0,0,0,0,0
64,60,80,52,266,1505,128,90,115,16,225,314,1722,6524,604,352,1038,1771,8246
64,62,488,238,604,8773,588,153,385,139,1289,1814,4031,66825,4792,1068,3311,9377,70856
64,63,214,107,139,3811,276,40,73,64,556,916,1345,30131,2992,231,652,3950,31476
64,64,182,71,97,2727,387,14,292,78,484,604,541,22947,4044,68,2028,2824,23488
64,65,4,0,0,0,0,0,0,1,8,0,0,0,0,0,0,0,0
64,98,15,0,0,0,0,0,0,1,23,0,0,0,0,0,0,0,0
64,100,10,0,0,0,0,0,0,3,26,0,0,0,0,0,0,0,0
64,102,18,0,0,0,0,0,0,3,38,0,0,0,0,0,0,0,0
64,104,1,0,0,0,0,0,0,1,6,0,0,0,0,0,0,0,0
64,105,6,0,0,0,0,0,0,1,12,0,0,0,0,0,0,0,0
64,108,6,0,0,0,0,0,0,1,34,0,0,0,0,0,0,0,0
65,59,7,0,3,53,13,0,0,5,22,0,19,441,146,0,0,56,460
65,60,64,0,0,0,0,0,0,8,183,0,0,0,0,0,0,0,0
65,62,243,20,144,3060,138,71,64,60,728,131,820,25627,1324,334,477,3204,26447
65,63,614,235,333,12913,880,248,308,156,1644,1427,2287,93235,7865,1582,2407,13246,95522
65,64,133,2,11,112,13,1,8,12,375,14,74,941,180,4,50,123,1015
65,102,35,0,0,0,0,0,0,2,65,0,0,0,0,0,0,0,0
65,104,100,0,0,0,0,0,0,4,310,0,0,0,0,0,0,0,0
66,60,131,85,547,4153,308,316,143,59,350,585,2834,17450,1872,1361,1173,4700,20284
66,61,3,0,0,0,0,0,0,2,6,0,0,0,0,0,0,0,0
66,62,5,7,11,146,8,8,0,4,15,14,57,709,32,46,0,157,766
66,65,108,0,0,0,0,0,0,9,258,0,0,0,0,0,0,0,0
66,98,1,0,0,0,0,0,0,1,4,0,0,0,0,0,0,0,0
66,99,33,0,0,0,0,0,0,3,68,0,0,0,0,0,0,0,0
66,101,6,0,0,0,0,0,0,1,15,0,0,0,0,0,0,0,0
66,103,1,0,0,0,0,0,0,1,4,0,0,0,0,0,0,0,0
66,104,7,0,0,0,0,0,0,1,17,0,0,0,0,0,0,0,0
66,106,3,0,0,0,0,0,0,1,8,0,0,0,0,0,0,0,0
67,59,128,115,261,2520,199,238,287,39,306,1046,1532,15990,1323,1321,2610,2781,17522
67,60,32,0,0,0,0,0,0,18,79,0,0,0,0,0,0,0,0
67,61,428,206,1110,6646,563,540,230,69,1173,513,2996,18556,2241,1381,766,7756,21552
67,62,59,30,52,873,80,40,7,24,126,168,275,4547,401,166,44,925,4822
67,98,271,480,7508,8887,1260,650,447,42,644,709,14886,16106,2188,837,753,16395,30992
67,99,6,0,0,0,0,0,0,1,11,0,0,0,0,0,0,0,0
67,103,65,86,2628,1246,104,84,157,6,109,99,4993,2833,271,169,216,3874,7826
67,104,5,0,0,0,0,0,0,2,11,0,0,0,0,0,0,0,0
67,108,11,48,403,291,27,89,22,3,17,76,593,791,38,391,24,694,1384
68,61,15,0,0,0,0,0,0,9,38,0,0,0,0,0,0,0,0
68,62,1,0,0,0,0,0,0,1,4,0,0,0,0,0,0,0,0
68,99,9,0,0,0,0,0,0,1,18,0,0,0,0,0,0,0,0
68,105,11,0,0,0,0,0,0,1,24,0,0,0,0,0,0,0,0
68,108,25,0,0,0,0,0,0,2,45,0,0,0,0,0,0,0,0
69,60,210,33,233,3386,271,50,28,40,454,173,1126,19519,2133,183,197,3619,20645
69,61,705,560,951,23799,3604,539,428,134,1692,3757,4072,123137,28530,2366,2440,24750,127209
69,98,6,0,0,0,0,0,0,2,10,0,0,0,0,0,0,0,0
69,99,8,0,0,0,0,0,0,1,32,0,0,0,0,0,0,0,0
69,107,3,0,0,0,0,0,0,1,5,0,0,0,0,0,0,0,0
70,59,392,252,474,12802,875,272,42,55,841,1658,1856,76645,6324,1433,265,13276,78501
70,60,128,110,60,2590,321,154,28,52,343,452,413,11986,1520,504,70,2650,12399
70,101,6,0,0,0,0,0,0,1,13,0,0,0,0,0,0,0,0
70,107,54,0,0,0,0,0,0,8,121,0,0,0,0,0,0,0,0
71,59,3927,7397,19058,326896,19042,8380,2109,648,8978,34368,54076,1256290,94061,27939,6156,345954,1310366
71,60,522,499,745,20326,3404,1182,325,154,1293,2613,2317,91571,17926,4363,1005,21071,93888
71,99,33,6,330,285,46,59,22,4,69,8,639,689,84,335,22,615,1328
71,101,22,0,0,0,0,0,0,3,43,0,0,0,0,0,0,0,0
71,102,89,255,4770,3025,324,166,223,11,179,479,10621,5345,850,330,284,7795,15966
71,104,5,0,0,0,0,0,0,1,13,0,0,0,0,0,0,0,0
71,105,118,0,0,0,0,0,0,2,232,0,0,0,0,0,0,0,0
71,106,10,0,0,0,0,0,0,5,20,0,0,0,0,0,0,0,0
71,107,1,0,0,0,0,0,0,1,5,0,0,0,0,0,0,0,0
71,108,6,0,0,0,0,0,0,1,12,0,0,0,0,0,0,0,0
72,59,7728,10494,34471,736541,37937,21231,3886,2699,18353,36534,83064,2211993,124459,57108,9809,771012,2295057
72,105,2,0,0,0,0,0,0,2,7,0,0,0,0,0,0,0,0
72,106,25,0,0,0,0,0,0,7,56,0,0,0,0,0,0,0,0
72,109,75,127,2655,1660,124,156,423,11,183,172,4262,2477,284,178,458,4315,6739
73,58,2540,2690,2424,95664,5659,2030,438,461,5693,16249,8450,538316,34795,8256,1870,98088,546766
73,59,1849,2461,10542,106631,11361,3801,943,346,4386,10214,27740,437964,50218,11919,3284,117173,465704
73,105,175,0,0,0,0,0,0,5,293,0,0,0,0,0,0,0,0
73,107,3,0,0,0,0,0,0,1,6,0,0,0,0,0,0,0,0
73,108,3,0,0,0,0,0,0,1,7,0,0,0,0,0,0,0,0
73,109,50,3,1170,2138,29,0,104,12,97,6,2133,2346,58,0,124,3308,4479
74,57,55,37,653,3922,212,89,63,26,132,144,1390,9835,617,175,111,4575,11225
74,58,96,46,73,3116,167,114,25,41,239,338,142,9499,763,354,196,3189,9641
74,101,3,0,0,0,0,0,0,3,7,0,0,0,0,0,0,0,0
74,105,414,699,17801,10575,1120,572,867,89,867,1399,31416,24380,3067,1945,1366,28376,55796
74,106,63,9,1116,427,62,19,24,22,132,24,2299,918,244,40,28,1543,3217
74,107,16,0,0,0,0,0,0,2,35,0,0,0,0,0,0,0,0
74,108,17,25,250,136,13,2,10,5,35,44,448,297,26,6,20,386,745
74,109,42,0,0,0,0,0,0,8,89,0,0,0,0,0,0,0,0
74,110,5,0,0,0,0,0,0,5,20,0,0,0,0,0,0,0,0
75,57,76,17,48,1134,91,37,5,35,190,96,456,6950,489,137,5,1182,7406
75,58,19,6,10,264,29,3,0,9,51,45,14,1826,388,14,0,274,1840
75,98,35,42,756,660,100,37,43,14,82,78,1454,1352,206,62,162,1416,2806
75,99,2,0,0,0,0,0,0,1,4,0,0,0,0,0,0,0,0
75,101,306,125,6516,2630,458,359,119,21,690,454,9341,4785,985,622,239,9146,14126
75,102,50,0,0,0,0,0,0,1,93,0,0,0,0,0,0,0,0
75,103,7,0,0,0,0,0,0,1,14,0,0,0,0,0,0,0,0
75,106,61,0,0,0,0,0,0,9,157,0,0,0,0,0,0,0,0
75,108,22,0,0,0,0,0,0,3,73,0,0,0,0,0,0,0,0
75,110,10,0,0,0,0,0,0,5,25,0,0,0,0,0,0,0,0
76,56,174,226,87,4457,928,201,177,58,429,1043,561,27733,4464,1105,1137,4544,28294
76,57,30,6,2,380,59,1,0,14,79,84,12,3150,496,3,0,382,3162
76,101,20,0,0,0,0,0,0,2,49,0,0,0,0,0,0,0,0
76,102,4,0,0,0,0,0,0,1,8,0,0,0,0,0,0,0,0
77,56,16,0,0,98,2,0,3,6,34,0,0,864,12,0,17,98,864
77,97,6,0,0,0,0,0,0,2,12,0,0,0,0,0,0,0,0
77,98,8,0,0,0,0,0,0,1,19,0,0,0,0,0,0,0,0
77,102,44,0,0,0,0,0,0,2,344,0,0,0,0,0,0,0,0
77,103,194,135,4537,1966,339,136,123,19,445,237,7836,4064,819,500,173,6503,11900
77,105,22,8,172,111,33,0,13,9,52,22,365,403,96,0,18,283,768
78,100,1,0,0,0,0,0,0,1,4,0,0,0,0,0,0,0,0
78,102,13,0,0,0,0,0,0,4,25,0,0,0,0,0,0,0,0
78,105,17,0,0,0,0,0,0,4,34,0,0,0,0,0,0,0,0
79,98,60,0,0,0,0,0,0,1,120,0,0,0,0,0,0,0,0
79,100,5,0,0,0,0,0,0,1,10,0,0,0,0,0,0,0,0
79,101,7,0,0,0,0,0,0,1,14,0,0,0,0,0,0,0,0
79,102,6,0,0,0,0,0,0,1,20,0,0,0,0,0,0,0,0
80,101,1,0,0,0,0,0,0,1,2,0,0,0,0,0,0,0,0
82,101,65,113,2740,918,146,36,81,8,126,161,3844,1228,234,41,83,3658,5072
